Mm, Mm, Mm, Hh, Hh, Hh, Hh, Hh, Hh^Es, Gg, Gs^Fms, Gg, Gs^Fms, Gg^Fmw, Gll, Gs, Gll, Gg, Gs^Fms, Gg, Re, Re, Gs, Gs, Gd, Gs, Gs, Gs, Gs^Fmw, Gs^Fmw, Gs^Fms, Gs^Fds, Gs^Fms, Gs^Fds
Mm, Mm, Mm, Hh^Fmw, Hh^Fmw, Hh^Es, Hh^Fmw, Hh, Hh^Fmw, Gs^Fms, Gs^Fds, Gs^Fms, Gs^Fms, Gs^Fds, Gs^Fms, Gg^Efm, Gg^Efm, Gg^Fmw, Gs^Fms, Gg^Fmw, Re^Es, Re^Es, Gd, Gd, Re^Gvs, Re^Gvs, Re^Wm, Gs, Gs^Fms, Gs^Fms, Gs^Fds, Gs^Fmw, Gs^Fms, Gs^Fds
Mm, Mm, Hh^Fmw, Hh, Hh, Hh^Es, Gs, Gll^Emf, Gg^Fmw, Gs^Fms, Gs^Fds, Gs^Fms, Gll^Emf, Gll^Em, Gs, Gs, Gg^Efm, Gs^Fms, Gs, Gg^Fmw, Re, Gs, Gd, Re^Gvs, Re^Gvs, Re^Gvs, Gs, Gs, Gll^Em, Gs^Fms, Gs^Fds, Gs^Fmw, Gs^Fds, Gs^Fds
Hh^Fds, Hh^Fds, Gs^Fms, Gll^Em, Gs^Fms, Gs, Gg^Fdw, Gs, Gs, Gll^Em, Gs, Gs^Fds, Gs^Fms, Gs^Fms, Gs^Fds, Gs^Fms, Gg, Gs, Re^Es, Re^Es, Ce, Ce, Gs, Gs, Gs, Gs, Gs^Fms, Gg, Gs^Fds, Gs^Fms, Gs^Fms, Gll^Emf, Hh, Hh
Gg^Fmw, Gs^Fms, Gs, Gs, Gs, Gg^Fmw, Gg, Gg^Efm, Re, Re, Re, Gs^Fms, Gll^Em, Gs^Fp, Gg^Fmw, Gs^Fms, Gg^Fmw, Gs, Re^Es, Ce, 1 Ke, Ce, Gg^Efm, Gg, Gs^Fmw, Gs, Gs^Fmw, Gs^Fms, Gs^Fp, Gs^Fds, Gs^Fms, Hh^Fmw, Hh, Hh
Re, Re^Es, Re^Es, Re^Es, Re, Re, Re, Re, Gs^Eff, Gs^Es, Gs, Re, Gs, Gs^Fms, Gg^Fmw, Gg^Efm, Re, Re, Gs^Eff, Gs^Vh, Gg, Gg, Gg, Gg, Gg, Gg^Efm, Gg^Efm, Gs, Gll^Em, Gll^Em, Gs^Fms, Gs^Fmw, Hh^Fmw, Hh
Gd, Gs, Gd, Gd, Gd, Gs^Vc, Gs^Eff, Gd^Eff, Re^Gvs, Re^Gvs, Gs, Re, Gg^Vh, Gg^Efm, Gg^Efm, Re^Es, Gs, Gs^Eff, Re^Gvs, Gs^Eff, Gs^Eff, Gg^Efm, Gs^Fms, Gs^Fmw, Gs^Fmw, Gg, Gs^Fms, Gs, Gs^Fp, Gs^Fds, Gs^Fp, Gs^Fms, Hh^Fds, Hh^Fds
Gs, Gd, Hh^Fdw, Re^Gvs, Hh, Re^Gvs, Hh, Gd^Eff, Gs^Vh, Gs, Gg^Efm, Re, Re^Es, Gg, Gg, Re, Gs, Re^Gvs, Re^Gvs, Re^Gvs, Gs^Eff, Gg^Eff, Gs^Fms, Gg^Fmw, Gs^Fms, Gg^Efm, Gs^Fms, Gs^Fds, Gs^Fms, Gs^Fms, Gll^Em, Gs^Fds, Gs^Fds, Gs^Fds
Gs^Fmw, Gs^Fdw, Hh^Fms, Hh^Fmw, Hh^Es, Hh^Es, Hh^Es, Gs, Gs, Gs, Ww, Ww^Ewl, Ww^Ewl, Re, Re^Es, Re, Gs^Vc, Gs, Gs, Gs^Eff, Gg, Gs^Fms, Gs^Fds, Gs^Fds, Gg^Vl, Gg^Efm, Gs^Fp, Gs^Fds, Gs^Fms, Gs^Fms, Hh^Fp, Hh^Fds, Hh^Fds, Hh
Gs^Fds, Gs^Fms, Gs^Fms, Hh, Ww, Ww, Ww, Gg^Efm, Wwf, Ww, Ds, Ds, Ww, Re^Es, Re^Es, Gg, Ww, Gs, Gs, Ww^Ewf, Ww, Ww, Ww, Ww^Ewf, Ww, Gs^Fds, Hh^Fmw, Hh^Fms, Hh^Fms, Hh, Hh, Hh^Fds, Mm, Mm
Gll^Emf, Gll^Emf, Ss^Em, Ww, Ss, Ss, Ww^Vm, Wwf, Ww^Ewf, Ww, Ds^Esd, Ds, Ww^Ewl, Ch, Wwf, Ww, Ds, Ww, Ww, Ww, Ww^Ewl, Ww^Ewl, Gs^Fms, Gs^Fmw, Ww^Ewf, Ww, Gg, Hh, Hh^Fmw, Hh, Mm, Mm, Mm, Mm
Gs^Fmw, Gs^Fmw, Ww, Ww, Sm, Ss, Gll^Fmw, Ss, Gll^Fmw, Gs, Gd^Es, Gd, Wwf, Ww, Re^Es, Gd^Es, Gd, Ds, Gs, Gs, Gs, Gs^Fms, Gs^Fds, Gs^Fp, Gs^Fmw, Ww, Gs^Fds, Gs^Fmw, Ww, Ww, Ww, Mm, Hh, Hh
Sm, Ss, Ww, Sm, Ss^Em, Sm^Em, Gll^Fp, Ss, Gll^Fmw, Gs, Gs, Gd^Es, Gs, Re^Es, Re, Gd^Vc, Gs, Gd, Gs, Gs, Gg^Efm, Gs^Fms, Gg^Vl, Gs^Fds, Gs^Fp, Ww, Ww, Ww, Ww, Hh, Mm, Ww, Ww, Ww
Ss, Ss, Ww, Ss, Sm^Em, Gll^Fmw, Gll^Emf, Gs^Fp, Gs, Gg^Efm, Re, Gs, Re, Re^Es, Re, Gs, Hh, Gs^Es, Gs^Fmw, Gg, Gg, Gg^Efm, Gg^Fmw, Gs^Fp, Gs^Fms, Gs^Fms, Gs, Ww, Gd^Edpp, Hh, Hh, Ww, Ww, Ww
Ww, Ww, Ss, Sm, Rb, Ss^Em, Re, Gs^Em, Re^Es, Re, Gs, Re^Es, Gg, Gg^Vh, Re^Es, Gs^Fmw, Hh, Hh, Gs, Gg, Gs, Gg^Efm, Gg, Gg^Fmw, Gll, Gs^Fmw, Gs, Ww^Ewf, Gs, Gs, Gd, Gd^Edpp, Mm, Ww
Gll^Em, Gll^Fmw, Gll^Fp, Gll^Fmw, Ss, Re, Ss, Re^Es, Gll^Em, Gll^Fp, Gll^Fmw, Gs, Gg, Gg^Efm, Re^Es, Hh^Es, Hh, Gs^Wm, Gg^Efm, Gg, Gs^Fmw, Gg, Gs, Gs, Hh^Fdw, Gs, Hh, Gs, Gs^Fdw, Gs, Gs, Gs, Gd, Mm
Gll^Fmw, Gs, Re, Ss, Re^Em, Ss^Vhs, Ss, Ss, Ss, Gll^Fdw, Gs^Efm, Gs, Gg^Fmw, Hh, Re, Gg, Gg^Em, Gg, Gg, Gg, Hh, Gs^Fms, Hh, Gs, Hh, Hh, Hh^Fdw, Gs, Gs, Gs^Fms, Hh^Fp, Hh, Mm, Gd
Re, Re, Gll^Em, Re, Gll^Fmw, Gll^Fmw, Ss^Em, Sm, Sm, Ss^Em, Gll^Fp, Gg, Gs^Efm, Gg, Hh^Fdw, Re, Gs, Gg^Efm, Gs^Fmw, Gs, Hh, Hh, Hh, Hh, Mm, Hh^Fdw, Mm, Hh, Hh^Fp, Gs^Fp, Gll, Hh^Fmw, Hh, Hh
Gll^Em, Gll^Fmw, Ss^Em, Sm, Sm, Sm, Ss^Em, Sm^Em, Ss^Em, Ss, Gll^Fp, Gg^Efm, Gs^Fmw, Gg, Gg, Re, Gs^Fmw, Gs, Gs^Fp, Gs^Fmw, Hh^Fp, Hh^Fmw, Hh^Fp, Mm, Mm, Mm, Mm, Hh, Hh, Hh^Fmw, Hh, Hh^Es, Hh^Es, Hh
Ss, Sm, Ss^Em, Ss^Em, Ss^Em, Ss, Gll^Emf, Sm, Gll^Fdw, Gll^Fmw, Gll^Fp, Gs^Fms, Gs^Fmw, Gs, Re^Es, Re, Hh^Fmw, Gs^Fp, Gs^Fms, Gs^Fms, Gs^Fp, Hh^Fp, Hh^Fds, Hh^Fp, Hh, Mm, Hh^Fdw, Mm, Mm, Mm, Mm, Hh, Hh^Fdw, Hh
Hh, Hh^Fdw, Hh, Gll^Emf, Gll^Fdw, Gll^Fdw, Gll^Fp, Gll^Fmw, Gll^Fp, Gs^Fmw, Gs^Fms, Gs^Fms, Gs, Re^Es, Gs^Fmw, Gs^Fp, Hh^Fdw, Hh^Fmw, Gs, Gs^Fms, Gs^Fms, Hh^Fds, Hh^Fp, Hh, Hh, Hh, Hh, Hh, Hh^Es, Hh^Fdw, Hh, Mm, Mm, Mm
Gs^Fms, Gs^Fms, Gll^Fmw, Gll^Fmw, Gll^Fmw, Gll^Fmw, Gs^Fp, Gs^Fp, Gs^Fp, Gs^Fms, Gs^Fmw, Gs^Fms, Gs^Em, Re, Gs^Em, Hh, Hh, Hh^Fdw, Gs^Fmw, Gs^Efm, Gs^Fms, Gs^Fp, Gs^Fdw, Gs^Fmw, Hh, Hh^Fdw, Hh^Fdw, Hh^Es, Hh^Fdw, Hh^Es, Hh^Fdw, Mm, Hh, Hh
Gg, Gs^Fp, Gs^Fmw, Gs^Fp, Gs^Fp, Gs^Fp, Hh, Hh, Gll^Fmw, Gs^Fms, Gs^Fms, Gg^Efm, Gs^Fms, Re, Re, Gs^Fp, Gs^Fp, Gs^Fds, Gs^Fms, Gs^Fmw, Gs^Fds, Gs^Fms, Gs^Fms, Gs^Fmw, Gs^Fp, Hh, Hh^Fmw, Hh^Fmw, Gs^Fmw, Hh^Fmw, Hh^Fds, Hh, Hh^Fdw, Hh
Hh, Hh^Fmw, Hh, Hh, Hh^Fms, Gs^Fms, Gs^Fds, Hh, Gll^Emf, Gs^Fmw, Gs^Fms, Gs^Fms, Gs^Fmw, Gs, Re, Gs^Fms, Gs^Fms, Gs^Vh, Gs^Es, Ce, 2 Ke, Ce, Gs^Fds, Gs^Fp, Gs^Fms, Hh^Fmw, Hh^Fms, Hh^Fp, Ww, Gll^Fp, Gll^Fp, Hh, Gll^Fmw, Gll^Fmw
Hh, Hh, Hh, Hh^Fmw, Hh^Fmw, Gs^Fms, Gll^Em, Gs, Hh, Gs^Fms, Gs^Fmw, Gs^Fmw, Gs, Re, Gs^Fmw, Re, Re^Es, Re^Es, Re^Es, Gs^Fds, Ce, Hh^Es, Re^Es, Gs^Fms, Gs^Fdw, Hh, Gll^Fms, Gll^Fp, Ww^Ewf, Ww, Gll^Fp, Gs^Fp, Gll^Em, Gs^Fp
Mm, Mm, Mm, Hh, Hh^Fmw, Hh^Fms, Hh, Gll^Em, Hh, Hh, Gs^Fms, Gg^Efm, Re^Es, Re^Es, Gs^Fp, Gs^Fmw, Gs^Fms, Gs^Fms, Gs^Fms, Gs^Fms, Gs^Fds, Re^Es, Gs^Es, Re, Re, Gs^Fms, Gll^Fp, Gll^Fp, Gll^Fp, Gll^Fmw, Gs^Fms, Gs^Efm, Gll^Em, Gs
Mm, Mm, Mm, Mm, Hh, Hh, Hh, Gll^Fmw, Gll^Em, Gs^Fms, Gs, Re, Gs^Fmw, Gs^Fp, Hh^Fp, Hh^Fms, Hh, Gs^Fds, Hh, Gs^Fms, Gs^Fms, Gs^Fmw, Gs^Fms, Gs, Gs^Fms, Gll^Em, Gll^Fms, Gll^Emf, Gs, Gll^Fmw, Gll^Fp, Re^Es, Gs, Gll^Fp
Mm, Mm, Mm, Mm, Hh^Fdw, Hh, Hh^Fds, Hh, Gs^Fms, Gs, Gs, Re, Gs^Fp, Hh^Fms, Hh^Fms, Hh^Fmw, Hh^Fdw, Hh, Hh, Gs^Fdw, Gs^Fms, Gs^Fms, Gs^Fms, Gll^Em, Gs^Fms, Hh^Fp, Hh^Fms, Gll^Fp, Gll^Fp, Re^Em, Gll^Fp, Gs^Fms, Gll^Fmw, Gs^Fms
Mm, Mm, Mm, Hh^Fds, Hh, Hh, Hh^Fds, Hh^Fds, Gs^Fms, Gs^Fp, Gs^Fmw, Re^Es, Gs, Gg^Efm, Gs^Fp, Hh^Fms, Hh^Fms, Hh, Gs^Fp, Gs^Fp, Gg^Efm, Gs^Fds, Hh^Fds, Gs^Fms, Gll^Fp, Hh^Fmw, Hh^Fmw, Hh^Fp, Hh, Hh^Fp, Hh^Fms, Gs^Fms, Gll^Fp, Gll^Fp
Gs^Fds, Mm, Mm, Mm, Hh^Fds, Hh, Gs^Fds, Gs^Fp, Hh^Es, Hh, Re, Re, Gs, Gg^Efm, Gs^Fms, Gs^Fms, Gs^Fms, Gs^Fms, Gs^Fds, Gs^Fmw, Gg^Efm, Ww, Hh^Fds, Hh^Fms, Mm, Mm, Mm, Mm, Mm, Hh^Fms, Hh^Fmw, Hh, Hh^Fdw, Mm
Mm, Mm, Mm, Hh^Fds, Hh, Hh, Gs^Fms, Gs^Fms, Hh^Es, Re, Gs^Fp, Gs^Fms, Hh^Fms, Hh^Fds, Gs^Fms, Gs^Fds, Hh^Fds, Hh, Gs^Fms, Gs^Fms, Ww^Ewl, Ww, Hh^Fms, Hh^Fms, Mm, Mm, Mm, Mm, Mm, Hh, Mm, Mm, Mm, Mm
Gs^Fds, Gs^Fds, Mm, Mm, Hh, Gs^Fds, Re, Re^Es, Re^Es, Re^Es, Hh, Gs^Fms, Gs^Fms, Hh^Fds, Gs^Efm, Gs^Fms, Hh^Fds, Gs, Gg^Efm, Gs^Fms, Gs^Fms, Ww^Ewf, Mm, Hh, Mm, Mm, Mm, Mm, Mm, Mm, Mm, Mm, Mm, Mm
Gs^Fds, Hh^Fds, Hh^Fds, Mm, Hh, Hh, Re^Es, Hh^Fms, Hh^Fds, Hh^Es, Gs^Fp, Gs^Fp, Gs^Fms, Hh^Fds, Gll^Em, Gll^Em, Gs^Fds, Hh^Fms, Gs^Fds, Hh^Fms, Gs^Fms, Hh^Fds, Mm, Mm, Hh^Fds, Mm, Mm, Mm, Ww^Ewl, Ww^Ewl, Hh, Mm, Mm, Mm
Gs^Fds, Hh^Fds, Hh^Fds, Hh^Fds, Hh, Hh, Re, Hh^Fms, Hh, Hh, Gs^Fds, Gs, Gs^Fds, Hh, Gs^Fms, Gs^Fms, Gs^Fds, Gs^Fds, Gs^Fds, Hh^Fds, Hh^Fds, Gs^Fms, Gs^Fds, Gs^Fds, Hh^Fds, Mm, Gs^Fds, Hh, Ww, Ww, Hh, Mm, Mm, Mm
