Mm, Mm, Mm, Mm, Mm, Mm, Mm, Mm, Hh, Hh^Fds, Hh^Fds, Gs^Fds, Gs^Fds, Re, Re, Gs^Fds, Gs^Fds, Gs^Fds, Gs^Fds, Gs^Fds, Gs^Fds, Gs^Fds, Gs^Fds, Gs^Fds, Gll^Fms, Gll^Fms, Gll^Fms, Gll^Fp, Gll^Fp, Gll^Fp, Gs^Fms, Gll^Fp, Gll^Fp, Gll^Fp, Gll^Fp, Gll^Fp, Gll^Fp, Gll^Fp, Re, Re, Gll^Fp, Gll^Fp
Mm, Mm, Mm, Mm, Mm, Mm, Mm, Mm, Hh, Hh^Fds, Hh, Gs^Fds, Gs^Fds, Re, Re, Gs^Fds, Gs^Fds, Gs^Fds, Gs^Fds, Gs^Fds, Gs^Fds, Gs^Fds, Gs^Fds, Gs^Fds, Gll^Fms, Gll^Fms, Gs^Fp, Gll^Fms, Gll^Fp, Gll^Fp, Gll^Fp, Gll^Fp, Gll^Fp, Gll^Fp, Gll^Fp, Gll^Fp, Gll^Fp, Gll^Fp, Re, Re, Gll^Fp, Gll^Fp
Mm, Mm, Mm, Mm, Mm, Mm, Mm, Mm, Mm, Hh, Hh, Hh, Gs^Fds, Gs^Fds, Re, Gs^Fds, Gs^Fds, Gs^Fds, Gs^Fds, Gs^Fds, Gs^Fds, Gs^Fds, Gs^Fds, Gg^Fet, Gs^Fds, Gll^Fms, Gll^Fms, Gll^Fms, Gll^Fp, Gs^Fms, Gll^Fp, Gll^Fp, Gg, Gll^Fp, Re, Gll^Fp, Gll^Fp, Gll^Fp, Re, Gll^Fp, Gll^Fp, Gll^Fp
Mm, Mm, Mm, Mm, Mm, Mm, Mm, Mm, Mm, Mm, Hh, Hh^Fds, Hh^Fds, Gs^Fds, Re, Gs^Fds, Gs^Fds, Gs^Fds, Gs^Fds, Gs^Fds, Gs^Fds, Gs^Fds, Gs^Fds, Gs^Fds, Gll^Fms, Gll^Fms, Gg, Gll^Fms, Re, Re, Re, Re, Re, Re, Gs^Fp, Re, Re, Re, Gg, Gg, Gg, Gg
Hh, Hh, Hh, Mm, Mm, Mm, Mm, Mm, Mm, Mm, Hh, Hh^Fds, Hh, Gs^Fds, Gs^Fds, Re, Re, Gs^Fds, Gs^Fds, Gg^Fet, Gs^Fds, Gs^Fds, Gs^Fds, Gs^Fds, Re, Re, Re, Re, Gs^Fms, Gg, Gg, Gg, Gs^Fms, Gg, Gg, Gg, Gg, Gg, Gll^Fp, Gll^Fp, Gll^Fp, Gll^Fp
Hh, Hh, Hh, Hh, Hh, Mm, Hh^Fds, Mm, Mm, Hh, Hh, Hh, Hh, Hh, Hh^Fds, Gs^Fds, Gs^Fds, Re, Re^Ve, Gs^Fds, Gs^Fds, Gs^Fds, Gs^Fds, Gs^Fds, Re, Gg^Ve, Gg, Gs^Fp, Hh^Fp, Hh^Fms, Hh, Hh, Hh^Fms, Gs^Fms, Gs^Fms, Gs^Fms, Gll^Fp, Gs^Fms, Gll^Fp, Gll^Fp, Gll^Fp, Gll^Fp
Gs^Fds, Gs^Fds, Gs^Fds, Gs^Fds, Hh, Hh, Hh, Hh^Fds, Gs^Fds, Hh^Fds, Hh, Hh, Hh, Hh^Fds, Hh^Fds, Gs^Fds, Gs^Fds, Re, Re, Gs^Fds, Re, Re, Re, Gs^Fds, Re, Gg, Gs^Fp, Gs^Fp, Hh, Hh^Fms, Hh, Hh^Fms, Hh^Fms, Hh^Fms, Gs^Fms, Gs^Fms, Gs^Fms, Gll^Fp, Gg, Gll^Fp, Gll^Fp, Gll^Fp
Gs^Fds, Gs^Fds, Gg, Gs^Fds, Gs^Fds, Hh, Gg, Gs^Fds, Gs^Fds, Gs^Fds, Gs^Fds, Hh, Gs^Fds, Hh, Gs^Fds, Gs^Fds, Gs^Fds, Gs^Fds, Gs^Fds, Re, Gg, Gg^Ve, Gg, Re, Gg^Ve, Rp, Re, Gs^Fp, Gs^Fms, Hh, Hh, Hh, Hh^Fms, Gs^Fms, Gs^Fms, Gg, Gs^Fms, Gs^Fms, Gll^Fp, Gll^Fp, Gll^Fp, Gll^Fp
Gs^Fms, Gs^Fds, Gs^Fds, Gs^Fds, Gs^Fds, Gs^Fds, Gs^Fds, Gg, Gs^Fds, Gs^Fds, Gs^Fds, Gs^Fds, Gs^Fds, Gs^Fds, Gs^Fds, Gs^Fds, Gs^Fds, Gs^Fds, Gs^Fds, Re, Gg, Gg, Gg, Gg^Fet, Gg^Efm, Gg, Gg^Ve, Rp, Rp, Gs^Fds, Gg, Hh, Gs^Fds, Gs^Fms, Gs^Fds, Gs^Fms, Gs^Fms, Gs^Fms, Gs^Fms, Gll^Fp, Gll^Fp, Gll^Fp
Hh^Fms, Gs^Fms, Gs^Fms, Gs^Fds, Gs^Fms, Gs^Fds, Hh, Gs^Fds, Gs^Fds, Gs^Fds, Gg, Gs^Fds, Gg, Gs^Fds, Gg, Gg, Gg, Gs^Fds, Gs^Fds, Re, Gg, Gs^Fds, Gs^Fds, Gg, Gg, Gg, Gg, Gg, Gg, Rp, Gg, Gg, Rp, Gg, Gg, Gs^Fds, Gs^Fds, Gs^Fms, Gg, Gs^Fms, Gll^Fp, Gll^Fp
Hh^Fms, Hh^Fms, Gs^Fms, Gg^Ve, Gs^Fp, Hh, Gg, Gs^Fds, Gg, Gs^Fds, Gs^Ve, Gg, Re, Gg, Gg, Gg, Re, Gg, Re, Re, Gg, Gg^Ve, Gg^Fet, Gs^Fds, Hh^Fds, Gg, Gg, Gs, Gg, Rp, Rp, Rp, Gg, Rp, Rp, Gg, Gs^Fds, Gs^Fds, Gs^Fds, Gg, Gg, Gg
Hh^Fp, Hh^Fms, Gll^Fp, Gs^Fms, Gs^Fms, Gs^Fms, Re, Re, Re, Re, Re, Re, Gg, Re, Re, Re, Hh, Re, Gg, Gg, Gg, Gs^Fds, Gs^Fds, Hh^Fds, Hh^Fds, Hh^Fds, Hh, Gg, Gg, Gg, Gg, Ss, Ss, Gg, Rp, Gg, Gg, Gs^Fds, Gg^Fet, Gs^Fds, Gs^Fds, Gs^Fds
Hh^Fp, Hh^Fp, Gll^Fp, Gs^Fms, Re, Re, Ce, Ce, Ce, Gs, Gg, Gg, Gs^Fds, Gg, Gg^Ve, Hh, Hh, Hh, Mm, Gg, Gg, Gs^Fds, Hh, Hh, Mm, Hh, Hh, Gg, Gg, Ss, Ss, Ss, Cv, Gg, Rp, Gg, Gg, Gs^Fds, Gs^Fds, Gs^Fds, Gs^Fds, Gs^Fds
Gll^Fp, Gll^Fp, Re, Re, Gs^Ve, Gs, Gg, 1 Ke, Ce, Gs, Gg, Gg, Gs^Fds, Gs^Fds, Hh, Gg, Hh, Mm, Mm, Mm, Hh, Hh, Hh, Mm, Mm, Mm, Hh, Hh, Hh, Ss, Ss, 2 Kvr, Cv, Rp, Gs^Fds, Gs^Fds, Gs^Fds, Gg, Gs^Fds, Gs^Fds, Gg, Gg
Re, Re, Gll^Fp, Gll^Fp, Gs^Fms, Gg, Gg, Ce, Gg, Gg, Gs^Fds, Gg, Mm, Mm, Mm, Hh, Mm, Mm, Mm, Mm, Hh, Hh, Hh^Fds, Hh^Fds, Gs^Fds, Mm, Hh^Fds, Hh, Hh, Gg, Gg, Cv, Rp, Rp, Gs^Fds, Hh^Fds, Hh^Fds, Gs^Fds, Gg, Gg^Efm, Gs^Fds, Gs^Fds
Gll^Fp, Gll^Fp, Gll^Fp, Gll^Fp, Gll^Fp, Gll^Fp, Gs^Fms, Gg, Gg^Ve, Gs^Fds, Hh^Fds, Hh, Mm, Mm, Mm, Mm, Mm, Mm, Mm, Gg^Ve, Gs^Fds, Gs^Fds, Gs^Fds, Gs^Fds, Gg^Fet, Hh^Fds, Hh^Fds, Hh, Gs^Fds, Gs^Fds, Rp, Cv, Rp, Gg, Gs^Fds, Hh^Fds, Hh, Hh, Hh^Fds, Gg, Gs^Fds, Gs^Fds
Gll^Fp, Gs^Fms, Gll^Fp, Gll^Fp, Gll^Fp, Gll^Fp, Gs^Fms, Gs^Fms, Hh^Fms, Gs^Fds, Hh, Hh, Mm, Mm, Mm, Mm, Hh, Hh, Mm, Hh, Hh, Gg, Gg, Gs^Fds, Gs^Fds, Gs^Fds, Gs^Fds, Gs^Fds, Rp, Rp, Gg, Rp, Gg, Gg^Efm, Gg, Gs^Fds, Gg, Gs^Fds, Gg, Hh^Fds, Gs^Fds, Gs^Fds
Gs^Fms, Gll^Fp, Gll^Fp, Gs^Fms, Gll^Fp, Gll^Fp, Hh, Hh^Fms, Hh, Hh, Hh, Mm, Mm, Mm, Hh, Mm, Hh, Mm, Mm, Mm, Hh^Fds, Gs^Fds, Gs^Fds, Gg, Gg, Gg, Gs^Ve, Rp, Gs^Fds, Gg, Gg, Gg, Gs^Fds, Gs^Fds, Gs^Fds, Gs^Fds, Gs^Fds, Gg, Hh, Gs^Fds, Gs^Fds, Gs^Fds
Gs^Fms, Gs^Fms, Gs^Fms, Gll^Fp, Gs^Fms, Gs^Fms, Hh^Fp, Hh, Hh, Hh, Hh, Mm, Mm, Mm, Hh, Hh, Hh, Mm, Mm, Mm, Hh, Gs^Fds, Rp, Rp, Rp, Rp, Rp, Rp, Gg^Fet, Gs^Fds, Gg, Gs^Fds, Gs^Fds, Gs^Fds, Gg, Gs^Fds, Gs^Fds, Hh^Fds, Hh, Hh^Fds, Gs^Fds, Gs^Fds
Gs^Fds, Gs^Fms, Gs^Fms, Gs^Fms, Gs^Fms, Hh^Fp, Hh, Hh^Fp, Hh, Hh, Hh, Hh, Hh, Hh, Hh^Fds, Hh, Hh, Gg^Ve, Hh, Hh, Re, Re, Gs^Fds, Gg, Gg, Gg, Gg, Gs^Fds, Gs^Fds, Gs^Fds, Hh, Hh, Hh, Gs^Fds, Gs^Fds, Gs^Fds, Mm, Hh^Fds, Hh, Hh, Hh, Hh^Fds
Gs^Fds, Gs^Fms, Gs^Fds, Gs^Fms, Gs^Fds, Hh^Fms, Hh, Hh, Hh, Hh, Hh^Fds, Hh^Fds, Gs^Fds, Gs^Fds, Gs^Fds, Hh^Fds, Gg, Gg, Re, Re, Gg^Ve, Gs^Fds, Gg^Ve, Gs^Fds, Gs^Fds, Gg, Gg^Ve, Gg, Gg^Efm, Gs^Fds, Hh, Hh, Hh, Hh, Hh, Gs^Fds, Hh^Fds, Mm, Mm, Mm, Hh, Hh
Gs^Fds, Gs^Fds, Gg, Gs^Fds, Gg, Gg, Hh^Fds, Hh, Hh, Hh^Fds, Mm, Gs^Fds, Gs^Fds, Gg^Fet, Gs^Fds, Gs^Fds, Gg^Ve, Re, Gs^Fds, Gs^Fds, Gs^Fds, Gs^Fds, Gs^Fds, Gs^Fet, Gs^Fds, Gg, Gs^Fds, Gg, Gg, Gg, Gg, Gs^Fds, Gs^Fds, Hh, Gs^Fds, Mm, Mm, Hh, Mm, Mm, Mm, Mm
Gg, Gg, Gg, Gs^Fds, Gg, Gs^Fds, Hh, Hh, Mm, Mm, Mm, Gs^Fds, Gs^Fds, Gs^Fds, Hh^Fds, Gs^Fds, Gs^Fds, Re, Re, Gs^Fds, Gs^Fds, Gg^Ve, Gs^Fds, Gs^Fds, Gs^Fds, Gs^Fds, Gs^Fds, Gs^Fds, Gg, Hh^Fds, Gs^Fds, Gs^Fds, Gs^Fds, Gs^Fds, Mm, Hh, Mm, Hh, Hh, Mm, Mm, Mm
Gg, Gg, Gs^Fds, Gs^Fds, Hh^Fds, Hh, Mm, Mm, Mm, Mm, Mm, Mm, Hh^Fds, Hh^Fds, Hh, Gs^Fds, Gg, Gg, Re, Gs^Fds, Gs^Fds, Gs^Fds, Gs^Fet, Gs^Fds, Gs^Fds, Gs^Fds, Gg^Fet, Gs^Fds, Gs^Fds, Hh, Hh^Fds, Gs^Fds, Mm, Hh, Mm, Mm, Mm, Mm, Mm, Mm, Mm, Mm
Gs^Fds, Gs^Fds, Gs^Fds, Gs^Fds, Hh^Fds, Hh^Fds, Mm, Mm, Mm, Mm, Mm, Mm, Hh, Hh, Hh, Hh, Hh, Re, Gs^Fds, Gg^Ve, Gs^Fds, Gs^Fds, Gs^Fds, Gs^Fds, Gs^Fds, Gs^Fds, Gs^Fds, Gs^Fds, Gs^Fds, Gs^Fds, Hh, Hh, Mm, Mm, Mm, Hh, Hh, Mm, Mm, Mm, Mm, Mm
Gg, Gg, Gg, Gs^Fds, Hh, Hh, Mm, Mm, Mm, Mm, Hh, Hh, Hh, Hh, Hh, Hh, Hh, Re, Gs^Fds, Gs^Fds, Gs^Fds, Gg^Fet, Gs^Fds, Gs^Fds, Gs^Fds, Gs^Fds, Ww, Ww, Ww, Gs^Fds, Ww, Ww, Ww, Mm, Mm, Mm, Hh, Hh, Mm, Mm, Mm, Mm
Ww, Ww, Ww, Gg, Hh, Hh, Mm, Mm, Mm, Mm, Hh, Hh^Fds, Gs^Fds, Gs^Fds, Hh, Hh, Re, Re, Gs^Fds, Gs^Fds, Gs^Fds, Gs^Fds, Gs^Fds, Gs^Fds, Gs^Fds, Ww, Ww, Ww, Ww, Ww, Wo, Wo, Ww, Ww, Hh^Fds, Mm, Hh, Hh, Mm, Mm, Mm, Mm
Gg, Gg, Gg, Ww, Hh^Fds, Hh, Hh, Mm, Mm, Mm, Hh, Hh, Gg^Fet, Gs^Fds, Gg, Gs^Fds, Re, Gg, Gg, Gg^Fet, Gs^Fds, Gs^Fds, Gs^Fds, Gs^Fds, Ww, Ww, Ww, Ww, Ww, Wo, Wo, Ww, Hh, Ww, Hh^Fds, Mm, Mm, Mm, Mm, Mm, Hh, Hh
Gs^Fds, Gs^Fds, Gs^Fds, Ww, Hh^Fds, Hh, Ww, Ww, Ww, Hh, Hh^Fds, Gs^Fds, Gs^Fds, Re, Re, Re, Hh, Hh, Hh^Fds, Hh^Fds, Mm, Mm, Mm, Ww, Ww, Ww, Wo, Ww, Ww, Ww, Ww, Ww, Ww, Hh^Fds, Mm, Mm, Mm, Mm, Mm, Hh, Hh, Hh
Gs^Fds, Gs^Fds, Gs^Fds, Ww, Ww, Gg, Ww, Gg, Gs^Fds, Ww, Gs^Fds, Gg^Fet, Gg, Gg, Re, Hh, Hh, Mm, Mm, Mm, Mm, Mm, Mm, Ww, Ww, Wo, Wo, Wo, Ww, Ww, Ww, Ww, Gs^Fds, Hh, Gg, Mm, Mm, Mm, Hh, Hh, Hh, Hh
Gs^Fds, Gs^Fds, Gg, Gs^Fds, Gg, Ww, Gg, Gs^Fds, Gs^Fds, Ww, Gg, Gg, Gg, Gg, Re, Gg, 3 Kud, Cud, Mm, Mm, Mm, Mm, Mm, Ww, Ww, Wo, Wo, Ww, Ww, Ww, Ww, Ww, Gs^Fds, Gs^Fds, Gg, Ww, Ww, Hh, Hh, Hh, Hh, Hh
Gg, Gg, Gs^Fds, Gs^Fds, Gs^Fds, Gs^Fds, Gs^Fds, Gg, Ww, Ww, Gg, Gs^Fds, Re, Re, Gs^Fds, Hh, Cud, Cud, Mm, Mm, Mm, Mm, Mm, Ww, Ww, Ww, Ww, Ww, Ww, Ww, Ww^Bw\, Gs^Fds, Gg^Fet, Gg, Ww, Ww, Ww, Hh, Hh, Hh, Hh, Hh
Gs^Fds, Gs^Fds, Gs^Fds, Gs^Fds, Gs^Fds, Gs^Fds, Gg, Gg, Ww, Gs^Fds, Hh, Gg^Ve, Re, Gs^Fds, Gg^Ve, Mm, Mm, Mm, Mm, Mm, Mm, Mm, Hh^Fds, Hh, Gs^Fds, Ww, Ww, Ww, Ww, Ww, Gg^Fet, Gg^Ve, Gg, Gg, Ww, Wo, Wo, Ww, Ww, Hh, Mm, Mm
Hh, Hh, Gs^Fds, Gs^Fds, Gg, Gg, Ww, Ww, Gs^Fds, Gs^Fds, Hh, Hh, Re, Gs^Fds, Gs^Fds, Hh^Fds, Gg, Mm, Mm, Mm, Mm, Mm, Hh^Fds, Hh^Fds, Gs^Fds, Ww, Ww, Ww, Ww, Gs^Fds, Gs^Fds, Gs^Fds, Gs^Fds, Gs^Fds, Ww, Wo, Ww, Ww, Ww, Mm, Mm, Mm
Hh, Hh^Fds, Hh^Fds, Gs^Fds, Gg, Ww, Gs^Fds, Gs^Fds, Hh^Fds, Hh, Gs^Fds, Hh, Gs^Fds, Re, Gs^Fds, Gg, Gs^Fds, Gg, Gg, Hh, Hh, Mm, Hh, Hh, Gs^Fds, Ww, Gg, Ww, Gs^Fds, Gg, Gs^Fds, Gg, Ww, Ww, Ww, Ww, Ww, Ww, Ww, Hh, Mm, Mm
Hh, Hh^Fds, Hh, Gs^Fds, Gs^Fds, Ww, Ww, Gs^Fds, Ww, Hh^Fds, Ww, Gg^Ve, Gs^Fds, Re, Gg^Ve, Gs^Fds, Gs^Fds, Gs^Fds, Ww, Hh^Fds, Ww, Hh, Ww, Ww, Ww, Ww, Gs^Fds, Gs^Fds, Gs^Fds, Ww, Ww, Ww, Wo, Wo, Ww, Ww, Ww, Ww, Hh, Hh, Mm, Mm
Mm, Mm, Mm, Gs^Fds, Gs^Fds, Gs^Fds, Gs^Fds, Ww, Gs^Fds, Ww, Gs^Fds, Ww, Ww, Ww^Bw|, Ww, Gg^Ve, Ww, Ww, Gg, Ww, Gg, Ww, Rb, Gg, Rb, Rb, Rb, Gs^Fds, Gs^Fds, Ww, Gs^Fds, Ww, Ww, Wo, Ww, Ww, Wo, Ww, Ww, Mm, Mm, Mm
Mm, Mm, Mm, Mm, Hh, Gs^Fds, Gg, Gs^Fds, Gg, Gs^Fds, Rb, Gg^Ve, Rb, Rb, Rb, Ww, Gg, Gg, Rb, Gg, Rb, Rb, Gg, Rb, Gg, Gs^Fds, Gg, Gg, Hh^Fds, Gs^Fds, Mm, Hh^Fds, Hh, Ww, Ww, Ww, Wo, Wo, Ww, Ww, Mm, Mm
Mm, Mm, Hh^Fds, Hh, Gs^Fds, Gg, Rb, Rb, Rb, Rb, Gs^Fds, Rb, Gg^Fet, Gs^Fds, Gs^Fds, Rb, Rb, Rb, Gs^Fds, Rb, Gg, Gs^Fds, Gs^Fds, Gg, Hh^Fds, Gs^Fds, Hh, Hh, Hh^Fds, Hh^Fds, Mm, Mm, Mm, Mm, Mm, Ww, Ww, Ww, Hh, Hh, Mm, Mm
Mm, Mm, Hh^Fds, Gg, Gs^Fds, Rb, Gs^Fds, Gs^Fds, Gs^Fds, Gs^Fds, Gs^Fds, Gg^Fet, Gs^Fds, Gs^Fds, Gs^Fds, Gg^Ve, Gs^Fds, Gg^Fet, Gs^Fds, Gs^Fds, Hh^Fds, Gs^Fds, Hh, Hh, Hh, Hh, Mm, Hh, Hh, Hh, Mm, Mm, Mm, Mm, Mm, Mm, Mm, Ww, Mm, Mm, Mm, Mm
Hh, Hh^Fds, Gs^Fds, Gs^Fds, Rb, Rb, Gs^Fds, Gg^Fet, Gs^Fds, Gs^Fds, Gs^Fds, Gs^Fds, Gs^Fds, Gs^Fds, Gs^Fds, Gs^Fds, Gs^Fds, Gs^Fds, Gs^Fds, Gs^Fds, Hh, Hh, Hh^Fds, Mm, Mm, Mm, Mm, Mm, Mm, Hh, Mm, Mm, Hh, Hh, Hh, Hh, Mm, Mm, Mm, Mm, Mm, Mm
Hh, Hh, Gs^Fds, Gs^Fds, Rb, Rb, Gs^Fds, Gs^Fds, Gs^Fds, Gs^Fds, Gs^Fds, Gs^Fds, Gs^Fds, Gs^Fds, Gs^Fds, Gs^Fds, Gs^Fds, Gs^Fds, Gs^Fds, Gs^Fds, Hh^Fds, Hh^Fds, Hh^Fds, Mm, Mm, Mm, Mm, Mm, Mm, Hh, Mm, Mm, Hh, Hh, Hh, Hh, Mm, Mm, Mm, Mm, Mm, Mm
