Rr^Es, Rr, Cud, Xu, Xu, Xu, Xu, Xu, Xu, Xu, Aa^Edb, Aa^Edb, Xu, Xu, Xu, Xu, Xu, Xu, Xu, Gg, Xu, Xu, Xu, Xu, Xu, Xu, Xu, Xu, Xu, Xu, Xu, Xu, Xu, Xu, Wo, Wo
Cud, Rr^Es, Rb^Es, Cud, Aa^Es, Xu, Xu, Xu, Xu, Xu, Aa^Edb, Aa^Edb, Xu, Xu, Wo, Xu, Xu, Xu, Xu, Xu, Xu, Xu, Xu, Xu, Xu, Xu, Xu, Xu, Xu, Xu, Xu, Xu, Xu, Xu, Wo, Wo^Edb
Cud, Ai, Aa, Rb^Es, Rb^Es, Cud, Cud, Xu, Xu, Aa, Ai, Xu, Ai, Ww, Wo, Xu, Xu, Xu, Wo, Xu, Xu, Xu, Xu, Xu, Xu, Xu, Xu, Xu, Wo^Edb, Xu, Wo^Edb, Xu, Xu, Xu, Wo, Wo^Edb
Xu, Ai^Edb, Ai^Br/, Aa^Es, Ai^Edb, Rb^Es, Ur^Ebn, Xu, Ww, Ai, Ww, Ai, Ww, Wo, Wo, Wo, Wo, Wo, Ww, Ww, Ww^Ewl, Ww^Vm, Wo, Xu, Xu, Xu, Xu, Xu, Wo^Edb, Wo, Wo^Edb, Wo, Wo^Edb, Wo^Edb, Wo^Edb, Wo^Edb
Xu, Cud, Aa^Edb, Ai^Br\, Rb^Br\, Rb^Es, Rb^Vct, Ur, Wwf, Ww, Ww, Ww, Ww^Ewl, Wo, Ww, Ww^Ewl, Ww^Ewl, Ww, Xu, Wwrt, Wwrt, Wwrt, Wwrt, Wo, Xu, Xu, Xu, Wo, Wo^Edb, Wo^Edb, Wo, Wo, Wo^Edb, Wo^Edb, Xu, Xu
Xu, Xu, Cud, Ai^Es, Re^Es, Ce, 1 Ke, Ur^Es, Ur^Es, Wwf, Wwf, Ww^Ewl, Wwf, Xu, Xu, Xu, Xu, Xu, Xu, Wwrt, Ww, Wwrt, Ww, Wo, Xu, Xu, Xu, Xu, Wo^Edb, Wo, Wo^Edb, Xu, Xu, Xu, Xu, Xu
Xu, Xu, Xu, Re^Em, Re^Es, Ce, Ce, Ce, Ur^Br\, Wwf, Rd^Edb, Wwf, Ds^Esd, Xu, Rd, Xu, Xu, Xu, Xu, Xu, Xu, Xu, Ww, Ww^Ewl, Wo, Wo, Wwrt, Wo, Wo, Wo, Xu, Xu, Xu, Xu, Xu, Xu
Xu, Xu, Xu, Xu, Xu, Re^Vct, Rd^Es, Rd^Es, Re^Es, Rd^Br|, Re^Es, Ds^Esd, Rd^Edb, Rd^Edb, Uu^Edb, Uu, Uh^Em, Xu, Uh^Emf, Xu, Xu, Ww^Ewl, Ww^Ewl, Ww, Wwrt, Ww^Vm, Wo, Wo, Ww, Xu, Xu, Xu, Xu, Xu, Xu, Xu
Xu, Xu, Xu, Xu, Qxu, Xu, Uh^Em, Xu, Uh^Br|, Uu^Br/, Uu^Em, Re^Es, Uu^Br/, Ur^Edb, Ur^Es, Uu^Em, Ur^Es, Uh^Em, Uu^Em, Uu^Vud, Ur^Es, Ww^Ewl, Ww, Wwrt, Wwrt, Wwrt, Wwrt, Ww, Ww^Ewl, Ww, Xu, Xu, Xu, Xu, Xu, Xu
Xu, Xu, Qxu, Qxu, Qxu, Qxu, Xu, Uh^Em, Xu, Uh^Emf, Uu^Em, Uu^Br|, Ur, Ur^Br\, Qxu, Ur^Es, Uu^Em, Ur, Re^Es, Xu, Ur, Ur^Es, Ur^Es, Ds, Ds^Esd, Ww^Ewl, Ww, Ww^Ewl, 3 Kud, Ww^Ewl, Xu, Xu, Xu, Xu, Xu, Xu
Xu, Xu, Qxu, Qxu, Qxu, Qxu, Qxu, Xu, Uu^Em, Uu^Em, Xu, Xu, Qxu, Qxu^Bs\, Uu^Em, Qxu, Xu, Uh^Emf, Xu, Re^Es, Uh^Em, Uu^Em, Xue, Rd^Es, Rd, Ds^Esd, Rd^Es, Cud, Cud, Cud, Xu, Xu, Xu, Xu, Xu, Xu
Xu, Xu, Xu, Qxu, Qxu, Qxu, Qxu, Qxu, Qxu^Bs|, Qxu, Qxu, Qxu, Xuc, Qxu, Uh^Emf, Uu^Vu, Xu, Uu^Em, Uu^Em, Uu^Em, Uh^Emf, Uh^Tf, Xue, Xu, Rd^Es, Rd^Es, Ur^Es, Ur^Es, Uu^Tf, Uu, Ss^Em, Xue, Xue, Xu, Xu, Xu
Xu, Xu, Xu, Xu, Xu, Uu^Vud, Uu^Emf, Qxu, Ur^Es, Qxu, Xuc, Xuc, Xuc, Qxu, Xu, Xu, Xu, Uh^Emf, Rd^Es, Uu^Em, Rd, Xue, Ss, Rd^Es, Ss^Em, Ds^Esd, Rd^Es, Uue^Vu, Uue, Xu, Ss^Em, Ss^Tf, Xue, Xu, Xu, Xu
Xu, Xu, Xu, Xu, Xuc, Xom, Uu^Em, Uu^Br\, Ur^Br\, Ur^Ebn, Xuc, Xuc, Qxu, Qxu, Xu, Xu, Uu^Vu, Uu^Em, Rd^Es, Rd^Es, Wwg, Ss, Sm, Sm^Em, Sm^Emf, Sm^Em, Uue^Em, Rd^Es, Uue, Ss^Em, Sm^Tf, Ss^Emf, Xue, Xue, Xu, Xu
Xu, Xu, Xuc, Xuc, Xuc, Xom, Xom, Ur^Es, Ur^Br/, Ur^Br/, Uu^Em, Xuc, Qxu, Qxu, Xu, Xu, Uu^Em, Uu^Es, Xu, Ds^Esd, Sm, Ww^Ewl, Ss^Em, Ss^Vhs, Ss^Tf, Uue^Em, Uue^Es, Rd^Es, Xu, Sm^Emf, Rb^Em, Ss^Em, Xue, Xu, Xu, Xu
Xu, Xuc, Xuc, Uu^Vu, Xom, Xom, Uu^Em, Ur^Br\, Ur^Es, Ur^Br|, Xu, Uh^Vud, Uh^Emf, Qxu, Qxu, Qxu, Uu, Uu^Es, Xu, Xu, Xu, Sm^Em, Sm^Em, Wwg, Ss^Em, Xu, Uue^Es, Ur^Es, Uue^Em, Xu, Sm^Em, Xue, Xue, Xu, Xu, Xu
Xu, Xom, Uh^Emf, Uu^Em, Uu^Es, Uu, Ur^Es, Ur^Es, Cud, Ur^Br|, Xu, Uh^Em, Cud, Qxu, Qxu^Bs/, Qxu^Bs/, Qxu, Qxu, Qxu, Xu, Xu, Sm^Emf, Ss^Em, Ww^Ewl, Ww^Ewl, Sm^Em, Uue^Em, Ur, Uue^Em, Ss^Em, Sm^Em, Sm^Emf, Ss^Edb, Xue, Xu, Xu
Xu, Xu, Uh^Tf, Uh, Uu^Ebn, Cud, Xuc, Cud, 5 Kud, Cud, Ur^Es, Ur, Uu, Ur^Es, Qxu, Qxu, Qxu, Qxu, Qxu, Xu, Xu, Ss^Em, Ww^Ewl, Wwg, Wwg, Wwg, Rd^Es, Rd^Es, Uh^Emf, Rb^Em, Xue, Xue, Ss^Edb, Xue, Xu, Xu
Xu, Xu, Xu, Uh^Em, Uu^Em, Xuc, Xuc, Xuc, Xuc, Xuc, Xuc, Uh^Em, Xu, Xu, Xu, Qxu, Qxu, Qxu, Qxu, Xu, Xu, Xu, Xu, Wo, Wo, Wwg, Xu, Rd^Es, Rd^Es, Uh^Tf, Xue, Ss^Em, Uue^Emf, Xue, Xu, Xu
Xu, Xu, Xu, Uh^Em, Uh^Emf, Uu^Vu, Xuc, Xu, Xu, Xuc, Xu, Xom, Xu, Xu, Xu, Qxu, Qxu, Qxu, Qxu, Qxu, Xu, Xu, Xu, Wo, Wog^Edb, Wwg^Vm, Ww^Ewl, Xu, Uu^Emf, Ur, Uue, Uue^Vud, Uue^Em, Uu^Em, Xu, Xu
Xu, Xu, Xu, Xu, Xu, Uh^Tf, Xu, Xu, Xu, Xu, Xu, Xu, Xu, Xu, Xu, Xu, Xu, Xu, Xu, Xu, Xu, Xu, Xu, Wo, Wwg, Wwg, Ww^Ewl, Xu, Uu^Tf, Ur, Uue^Emf, Uue^Tf, Uu^Edb, Uu^Edb, Xu, Xu
Xu, Xu, Xu, Xu, Xu, Xu, Xu, Xu, Xu, Xu, Xu, Xu, Xu, Xu, Xu, Xu, Xu, Xu, Xu, Xu, Wwg, Wog^Edb, Wog^Edb, Wog^Edb, Wwg^Edb, Wwg, Wwg^Edb, Cud, Cud, Ur^Edb, Ur, Cud, Cud, Xu, Xu, Xu
Xu, Xu, Xu, Xu, Xu, Xu, Xu, Xu, Xu, Xu, Xu, Xu, Xu, Xu, Xu, Xu, Xu, Xu, Xu, Xu, Sm^Em, Wwg^Edb, Wwg^Edb, Wwg, Sm^Edb, Wwg^Edb, Cud, 4 Kud, Cud, Ur^Edb, Ur^Edb, Cud, Xu, Xu, Xu, Xu
Xu, Xu, Xu, Xu, Xu, Xu, Xu, Xu, Xu, Xu, Xu, Xu, Xu, Xu, Xu, Xu, Xu, Xu, Xue, Xue, Sm^Em, Rb^Em, Ss, Sm, Wwg^Edb, Ww^Ewl, Cud, Cud, Uu^Es, Ur, Ur^Edb, Cud, Xu, Xu, Xu, Xu
Xu, Xu, Xu, Xu, Xu, Xu, Xu, Xu, Xu, Xu, Xu, Xu, Xu, Xu, Xu, Xue, Xue, Xue, Uh^Tf, Ss^Emf, Rb^Em, Uue^Vu, Ss, Sm^Em, Uue^Edb, Ww^Ewl, Uue^Es, Uu^Es, Ur^Edb, Ur^Edb, Uu, Xu, Xu, Xu, Xu, Xu
Xu, Xu, Xu, Xu, Xu, Xu, Xu, Xu, Xu, Xu, Xu, Xu, Xu, Xu, Xu, Xue, Xu, Uh^Ebn, Sm^Emf, Ss, Sm^Em, Ss^Bw|r, Cud, Uue^Edb, Uue^Es, Wwg, Wwg^Edb, Uue^Edb, Ur, Xu, Uu^Em, Xu, Xu, Xu, Xu, Xu
Xu, Xu, Xu, Xu, Xu, Xu, Xu, Xu, Xu, Xu, Xu, Xu, Xu, Xu, Xu, Xu, Xu, Cud, Cud, Cud, Urb, Uue^Edb, Urb^Edb, Urb, Urb^Edb, Uue^Es, Wwg^Edb, Ss^Edb, Ur, Uh^Em, Uh^Em, Uh^Emf, Xu, Xu, Xu, Xu
Xu, Xu, Xu, Xu, Xu, Xu, Xu, Xu, Xu, Xu, Xu, Xu, Xu, Xu, Xu, Xu, Xu, Xu, 2 Kud, Cud, Cud, Urb^Edb, Urb, Cud, Urb^Edb, Uue^Es, Ss^Bsb/, Ss^Bsb/, Ss^Edb, Uue^Em, Xu, Uu^Vu, Xu, Xu, Xu, Xu
Xu, Xu, Xu, Xu, Xu, Xu, Xu, Xu, Xu, Xu, Xu, Xu, Xu, Xu, Xu, Xu, Xu, Xu, Cud, Cud, Urb^Edb, Urb^Edb, Cud, Urb^Edb, Ss^Edb, Urb^Edb, Ss^Edb, Ss^Em, Sm, Uue^Em, Xu, Xu, Xu, Xu, Xu, Xu
Xu, Xu, Xu, Xu, Xu, Xu, Xu, Xu, Xu, Xu, Xu, Xu, Xu, Xu, Xu, Xu, Xu, Xu, Cud, Cud, Urb^Edb, Urb^Edb, Sm^Em, Ss^Edb, Sm, Ss^Vhs, Xu, Sm^Edb, Sm, Uue^Emf, Uu^Tf, Xu, Xu, Xu, Xu, Xu
Xu, Xu, Xu, Xu, Xu, Xu, Xu, Xu, Xu, Xu, Xu, Xu, Xu, Xu, Xu, Xu, Xu, Xu, Uu^Ebn, Urb, Uh^Emf, Urb, Sm, Rb^Em, Ss^Emf, Ss^Em, Xu, Xu, Uue^Edb, Ss^Bw/r, Xu, Uu^Vud, Sm^Emf, Xu, Xu, Xu
Xu, Xu, Xu, Xu, Xu, Xu, Xu, Xu, Xu, Xu, Xu, Xu, Xu, Xu, Xu, Uh^Tf, Uh^Emf, Uh^Em, Uh^Em, Uu^Em, Uh^Emf, Xue, Xue, Sm^Em, Uh^Vu, Uh^Tf, Uu^Emf, Uue, Ss^Em, Xu, Sm^Emf, Ss^Em, Xu, Xu, Xu, Xu
Xu, Xu, Xu, Xu, Xu, Xu, Xu, Xu, Xu, Xu, Xu, Xu, Xu, Xu, Xu, Uh^Vud, Uh^Tf, Xu, Xu, Xu, Xu, Xu, Xu, Xue, Xu, Xu, Xu, Xu, Xu, Ss^Em, Xu, Sm^Tf, Xu, Xu, Xu, Xu
Xu, Xu, Xu, Xu, Xu, Xu, Xu, Xu, Xu, Xu, Xu, Xu, Xu, Xu, Xu, Xu, Xu, Xu, Xu, Xu, Xu, Xu, Xu, Xu, Xu, Xu, Xu, Xu, Xu, Xu, Xu, Xu, Xu, Xu, Xu, Xu
