Gll^Fdw, Gll^Fdw, Aa, Gll^Fdw, Ha, Mm, Mm, Mm, Ha^Fda, Aa^Fda, Aa^Fda, Gll^Fdw, Gd, Gd, Gd, Gd, Gd, Rr, Gd, Gd, Gd, Gd, Gd, Gd, Gd, Gd, Gd, Ww, Aa, Aa, Aa, Aa, Ha, Ha, Gd, Re, Gd, Gd, Gd, Gd, Gd, Gd
Gll^Fdw, Gll^Fdw, Aa, Gll^Fdw, Ha^Fda, Mm, Mm, Mm, Ha^Fda, Ha^Fda, Aa^Fda, Gll^Fdw, Gd, Gd, Gd, Gd, Gd, Rr, Gd, Gd, Gd, Gd, Gd, Gd, Gd, Gd, Gd, Ww, Aa, Aa, Aa, Aa, Ha, Ha, Gd, Re, Gd, Gd, Gd, Gd, Gd, Gd
Gll^Fdw, Gll^Fdw, Aa^Fda, Aa^Fda, Mm, Mm, Mm, Ha, Aa^Fda, Aa, Gll^Fdw, Gd, Gd, Gd, Gd, Gd, Gd, Rr, Rr, Gd, Gd, Gd, Gd, Gd, Gd, Gd, Gd, Ww, Ai, Aa, Aa, Aa, Aa^Vha, Ha, Re, Re, Gd, Gd, Aa^Fda, Gd, Gd, Gd
Gll^Fdw, Gll^Fdw, Aa^Fda, Ha^Fda, Mm, Mm, Mm, Ha, Gll^Fdw, Gd, Gd, Aa, Gd, Gd, Gd, Gd, Gd, Re^Vh, Rr, Gd, Gd, Gd, Gd, Aa, Gd, Gd, Gd, Gd, Aa, Ww, Aa, Aa, Aa, Re, Gd, Gd, Gd, Aa^Fda, Ha^Fda, Gd, Gd, Gd
Aa, Aa, Ha, Mm, Mm, Mm, Ha, Ha^Fda, Gll^Fdw, Re^Vh, Gd, Gd, Gd, Gd, Gd, Gd, Gd, Gd, Rr, Gd, Gd, Gd, Gd, Aa, Aa, Gd, Gd, Gd, Gd, Ww, Ai, Aa, Ww, Re, Ww, Gd, Aa, Ha, Ha^Fda, Aa^Fda, Gd, Gd
Gll^Fdw, Gll^Fdw, Ha^Fda, Mm, Ha^Fda, Ha, Aa, Gll^Fdw, Gll^Fdw, Gd, Gd, Gd, Aa, Aa, Gd, Gd, Gd, Gd, Rr, Re^Vh, Gd, Gd, Gd, Gd, Gd, Gd, Gd, Gd, Gd, Aa, Aa, Ai, Ce, Ww^Bw|, Aa, Ww, Ai, Aa, Aa^Fda, Ha^Fda, Ha, Ha
Aa^Fda, Aa^Fda, Aa^Fda, Ha^Fda, Aa^Fda, Aa^Fda, Aa, Aa, Gd, Gd, Gd, Aa, Aa, Aa, Gd, Gd, Gd, Gd, Gd, Rr, Gd, Gd, Gd, Gd, Gd, Gd, Gd, Gd, Gd, Aa^Vha, Aa, Aa, Gd, Re, Gd, Aa, Ai, Aa, Aa^Fda, Ha, Gd, Gd
Gd, Gd, Aa, Ha^Fda, Aa^Fda, Gll^Fdw, Gll^Fdw, Aa, Gd, Gd, Gd, Gd, Gd, Gd, Re^Vh, Gd, Gd, Gd, Ce, Rr, Ce, Gd, Gd, Aa, Gd, Gd, Gd, Gd, Gd, Aa, Aa, Gd, Re, Re, Gd, Aa, Aa, Ai, Ww, Ww, Ww, Ww
Gd, Gd, Gd, Gd, Gd, Gd, Gd, Gd, Gd, Aa, Aa, Gd, Gd, Gd, Gd, Gd, Gd, Ce, Re^Vh, Rr, Re^Vh, Ce, Gd, Gd, Gd, Re^Vh, Gd, Gd, Gd, Gd, Gd, Gd, Re, Gd, Hhd, Gd, Hhd, Aa, Aa, Aa, Aa, Aa
Gd, Gd, Gd, Aa^Fda, Gd, Gd, Re, Gd, Gd, Aa, Gd, Gd, Gd, Gd, Gd, Gd, Gd, Ce, Ce, Rr, 1 Ce, Ce, Ha, Ha, Aa, Gd, Gd, Gd, Gd, Aa^Fda, Aa^Fda, Gd, Re, Gd, Gd, Hhd, Ha, Aa, Gd, Gd, Gd, Gd
Gd, Gd, Gd, Gd, Ce, Ce, Ce, Re, Re, Gd, Re, Aa, Aa, Gd, Gd, Gd, Gd, Gd, Re, Ke, Gd, Aa^Fda, Ha, Ha, Aa, Gd, Gd, Gd, Aa, Aa^Fda, Aa^Fda, Re, Aa, Ce, Ce, Ha, Ha, Ha, Hhd, Gd, Gd, Gd
Gd, Gd, Gd, Gd, Gd, Ce, Gll^Fdw, Gd, Gd, Re, Gd, Re, Re, Re, Re, Re, Re, Re, Gd, Re, Re, Gd, Gd, Aa, Re, Re, Re, Re, Re, Aa, Re, Re, Gd, Ce, Ce, Ce, Gd, Ha, Hhd, Gd, Gd, Gd
Gd, Gd, Gd, Gd, Gd, Gd, Gll^Fdw, Gd, Gd, Gd, Hhd, Gd, Aa, Ce, Ce, Gd, Gd, Aa, Aa, Hhd, Mm, Re, Re, Re, Ce, Gd, Gd, Gd, Gd, Re, Aa, Gd, Gd, Ha, Ha, Gd, Gd, Gd, Gd, Gd, Gd, Gd
Gd, Gd, Gd, Gd, Gd, Gll^Fdw, Gd, Gll^Fdw, Gd, Gd, Aa, Hhd, Aa, Ce, Gd, Gd, Gll^Fdw, Aa, Ha^Fda, Mm, Mm, Mm, Gd, Ce, Aa, Aa, Gd, Gd, Gd, Aa, Gd, Gd, Gd, Gd, Gd, Gd, Gd, Gd, Aa, Gd, Gd, Gd
Gll^Fdw, Gll^Fdw, Gll^Fdw, Gd, Gd, Gd, Gd, Gd, Gd, Aa, Aa, Hhd, Mm, Aa, Mm, Gd, Aa^Fda, Gll^Fdw, Gd, Hhd, Gd, Gd, Gd, Gd, Aa, Gd, Mm, Gd, Aa, Gd, Gd, Gd, Aa, Gd, Gd, Gd, Gd, Gd, Gd, Aa, Gd, Gd
Gll^Fdw, Gll^Fdw, Gd, Gd, Gll^Fdw, Gd, Gll^Fdw, Gd, Hhd, Mm, Mm, Mm, Mm, Mm, Mm, Gd, Gd, Aa, Gd, Aa, Gd, Gd, Gd, Gd, Gd, Hhd, Mm, Hhd, Gd, Gd, Gd, Gd, Gd, Gd, Gd, Gd, Gd, Gd, Gll^Fdw, Gd, Gd, Gd
Hhd^Fdw, Hhd^Fdw, Hhd^Fdw, Gd, Gll^Fdw, Gd, Gd, Gd, Gd, Mm, Mm, Mm, Hhd^Fdw, Mm, Gll^Fdw, Gd, Hhd, Gd, Gll^Fdw, Gd, Gd, Gd, Aa, Gd, Hhd, Mm, Mm, Mm, Gd, Gd, Gd, Gd, Gd, Gd, Aa^Fda, Gll^Fdw, Hhd^Fdw, Gll^Fdw, Aa^Fda, Gd, Gd, Gd
Mm, Mm, Mm, Gll^Fdw, Gll^Fdw, Gll^Fdw, Gd, Gd, Gd, Gd, Gd, Hhd, Gd, Gll^Fdw, Gd, Gll^Fdw, Hhd^Fdw, Hhd, Hhd^Fdw, Gll^Fdw, Gd, Gd, Gd, Gd, Gd, Mm, Hhd, Hhd, Gd, Gd, Gd, Gd, Gd, Aa^Fda, Aa^Fda, Ha^Fda, Ha, Ha^Fda, Hhd, Gd, Gd, Gd
Mm, Mm, Mm, Mm, Mm, Gll^Fdw, Gll^Fdw, Gll^Fdw, Gd, Gd, Gd, Gd, Gd, Gd, Gd, Aa^Fda, Aa^Fda, Hhd, Ha, Aa^Fda, Aa^Fda, Aa^Fda, Gd, Gd, Gd, Gd, Gd, Gd, Gd, Aa, Gd, Gd, Gll^Fdw, Aa^Fda, Gd, Gd, Gll^Fdw, Hhd^Fdw, Ha, Aa^Fda, Gd, Gd
Mm, Mm, Mm, Mm, Mm, Ha, Ha, Gd, Aa^Fda, Aa^Fda, Gd, Aa^Fda, Gd, Gd, Gd, Gd, Gd, Hhd, Hhd, Ha, Gd, Aa^Fda, Aa^Fda, Aa^Fda, Gd, Gd, Gd, Gd, Rb, Gd, Gd, Gd, Gd, Gll^Fdw, Gd, Gll^Fdw, Gll^Fdw, Ha, Hhd^Fdw, Ha^Fda, Aa^Fda, Aa^Fda
Mm, Mm, Mm, Mm, Mm, Ha^Fda, Ha^Fda, Aa^Fda, Aa, Aa, Aa^Fda, Aa^Fda, Gd, Rb, Gd, Rb, Gd, Aa^Fda, Aa^Fda, Aa^Fda, Aa^Fda, Gd, Gd, Gd, Gd, Gd, Rb, Gd, Gd, Gd, Hhd, Gd, Gll^Fdw, Gd, Gd, Gd, Gd, Gll^Fdw, Gd, Hhd, Ha^Fda, Ha
Mm, Mm, Mm, Mm, Mm, Mm, Ha^Fda, Ha^Fda, Aa^Fda, Aa^Fda, Aa^Fda, Aa^Fda, Aa, Gd, Rb, Gd, Gd, Rb, Aa^Fda, Aa^Fda, Gd, Gd, Gd, Gd, Aa^Fda, Gd, Aa^Fda, Rb, Rb, Rb, Hhd^Fdw, Gll^Fdw, Gll^Fdw, Aa, Aa, Gd, Gd, Gd, Gd, Gd, Gd, Gd
Mm, Mm, Mm, Mm, Ha, Mm, Ha^Fda, Ha^Fda, Ha, Aa, Aa^Fda, Aa, Aa, Aa, Rb, Rb, Gd, Gd, Gd, Gd, Gd, Gd, Gd, Gd, Hhd, Aa^Fda, Hhd, Rb, Rb, Mm, Mm, Hhd^Fdw, Hhd, Aa, Aa^Fda, Gd, Gd, Gd, Gd, Gd, Gd, Gd
Mm, Mm, Ha, Ha, Ha, Ha, Mm, Mm, Ha^Fda, Aa, Aa^Fda, Aa^Fda, Aa^Fda, Rb, Ch, Rb, Rb, Rb, Gd, Rb, Aa^Fda, Gd, Gll^Fdw, Hhd^Fdw, Ha^Fda, Aa^Fda, Mm, Rb, Cud, Cud, Cud, Mm, Mm, Ha^Fda, Aa^Fda, Gd, Gd, Gd, Aa, Gd, Gd, Gd
Mm, Mm, Ha, Ha, Mm, Mm, Mm, Mm, Mm, Mm, Ha^Fda, Aa^Fda, Aa, Ch, 3 Kh, Ch, Ch, Rb, Rb, Gd, Aa^Fda, Gll^Fdw, Hhd^Fdw, Hhd, Ha, Mm, Mm, Cud, 2 Kud, Cud, Mm, Mm, Mm, Ha^Fda, Aa^Fda, Aa^Fda, Aa, Aa, Gd, Gd, Gd, Gd
Mm, Mm, Ha, Ha, Mm, Mm, Mm, Mm, Mm, Ha, Ha^Fda, Aa^Fda, Rd, Ch, Ch, Ch, Rb, Rb, Gd, Gd, Gd, Hhd, Ha^Fda, Ha, Ha, Mm, Mm, Mm, Mm, Cud, Mm, Mm, Mm, Ha^Fda, Gd, Aa, Aa, Gd, Gd, Gd, Gd, Gd
Mm, Mm, Ha, Ha, Mm, Mm, Mm, Mm, Mm, Ha, Ha^Fda, Aa^Fda, Rd, Ch, Ch, Ch, Rb, Rb, Gd, Gd, Gd, Hhd^Fdw, Ha^Fda, Ha^Fda, Ha, Mm, Mm, Mm, Mm, Cud, Mm, Mm, Mm, Ha, Gd, Aa, Aa, Gd, Gd, Gd, Gd, Gd
