border_size=1
usage=map

Mm          , Mm          , Hh          , Hh          , Gs^Fds      , Gs^Fds      , Gs^Fds      , Gs^Fds      , Gs^Fds      , Re          , Gg          , Gg          , Gg          , Ww          , Ww          , Ds          , Ds          , Gg          , Gg          , Gg          , Gg          , Gg          , Gg          , Re          , Gg          , Gg          , Gg          , Gg          , Gg          , Gg          , Gs^Fds      , Hh          , Mm          , Mm          , Mm          , Hh          , Mm          , Hh          , Gs          , Gs^Fds      , Gs^Fds      , Gs^Fds      
Mm          , Mm          , Hh          , Hh          , Gs^Fds      , Gs^Fds      , Gs^Fds      , Gs^Fds      , Gs^Fds      , Re          , Gg          , Gg          , Gg          , Ww          , Ww          , Ds          , Ds          , Gg          , Gg          , Gg          , Gg          , Gg          , Gg          , Re          , Gg          , Gg          , Gg          , Gg          , Gg          , Gg          , Gs^Fds      , Hh          , Mm          , Mm          , Mm          , Hh          , Mm          , Hh          , Gs          , Gs^Fds      , Gs^Fds      , Gs^Fds      
Hh          , Hh          , Hh          , Gs^Fds      , Gs^Fms      , Gs^Fds      , Re          , Re          , Re          , Re          , Gg          , Gg          , Gg          , Ww          , Ww          , Ww          , Ww          , Gg          , Gg          , Gg          , Gg          , Gg          , Gg          , Re          , Re          , Gg          , Re          , Gg          , Gg          , Hh          , Hh          , Hh          , Hh          , Mm          , Mm          , Mm          , Hh          , Hh          , Gs          , Gs^Fds      , Gg          , Gg          
Gs^Fds      , Gs^Fds      , Gs^Fds      , Gs^Fds      , Gs^Fds      , Gs^Fds      , Re          , Gs^Fds      , Gg          , Gg          , Gg          , Gg          , Gg          , Gs^Fds      , Gg          , Ww          , Ww          , Ww          , Ww          , Gg          , Gg          , Gg          , Gg          , Gg          , Gg          , Re          , Gs^Vl       , Re          , Gg          , Gs^Fds      , Hh          , Gs^Fds      , Gs^Fds      , Hh          , Mm          , Gg          , Gg          , Hh          , Gs^Fds      , Gs^Fds      , Gg          , Gg          
Gs^Fds      , Gs^Fds      , Gs^Fds      , Gs^Fds      , Ss          , Ss          , Re          , Gs^Fds      , Gs^Fds      , Gg          , Gg          , Gs^Fds      , Gs^Fds      , Gg          , Gg          , Gs^Fds      , Ds          , Ww          , Ww          , Ds          , Gg          , Gg          , Gg          , Gs^Fds      , Gs^Fds      , Gg          , Gg          , Re          , Gg          , Gs^Fds      , Gg          , Gg          , Gg          , Gs^Fds      , Hh          , Hh          , Gg          , Hh          , Hh          , Gg          , Gg          , Gg          
Gs^Fds      , Gs^Fds      , Gs^Fds      , Ss          , Gs^Fds      , Ss          , Ss          , Re          , Re          , Re          , Re          , Gs^Vl       , Gg          , Gg          , Gg          , Gg          , Gg          , Ww          , Ww          , Ds          , Gg          , Gg          , Gg          , Gs^Fds      , Gs^Fds      , Hh          , Hh          , Re          , Re          , Gg          , Gg          , Gg          , Gg          , Gs^Fds      , Gs^Fds      , Gs^Fds      , Gg          , Gg          , Gg          , Gg          , Gg          , Gg          
Ss          , Ss          , Ss          , Ss          , Ss          , Gs^Fds      , Ss          , Ss          , Gs^Fds      , Gs^Fds      , Gg          , Re          , Gg          , Gg          , Gg          , Gg          , Gs^Fds      , Ww          , Ww          , Ds          , Gg          , Gg          , Gg^Vh       , Gg          , Gs^Fds      , Hh          , Gs^Fds      , Gg          , Gg          , Re          , Gg          , Gg          , Gg          , Gg          , Gg          , Gg          , Rr          , Rr          , Rr          , Gs^Vl       , Rr          , Rr          
Ss          , Ss          , Ww          , Ss          , Ww          , Ss          , Ss          , Gs^Fds      , Gs^Fds      , Gs          , Gs^Fds      , Re          , Gg          , Gs^Fds      , Gg          , Gg          , Gg          , Ww          , Ww          , Ww          , Ds          , Gg          , Gg          , Gg          , Gs^Fds      , Gs^Fds      , Gg          , Gg          , Re          , Re          , Gg          , Gg^Efm      , Gg          , Gg          , Rr          , Rr          , Ce          , Ce          , Ce          , Rr          , Gg          , Gg          
Ss          , Ss          , Ww          , Ww          , Ww          , Ww          , Ww          , Ss          , Ss          , Gs^Fds      , Gs^Fds      , Re          , Re          , Gg          , Gg          , Gs^Fds      , Gg          , Gg^Vh       , Ww          , Ww          , Ds          , Gg          , Gg          , Gg          , Gg          , Gg          , Gg          , Gg          , Re          , Gg          , Re          , Gg          , Gg          , Gg^Vh       , Rr          , Gg          , Gg          , 1 Ke        , Gg          , Gg          , Gg          , Gg          
Ss          , Ss          , Ss          , Ww          , Ss          , Ww          , Ss          , Ss          , Ss          , Hh          , Gs^Fds      , Gs^Fds      , Gg          , Re          , Gg          , Gg          , Ww          , Ww          , Ww          , Ww          , Gg          , Gg          , Re^Gvs      , Re^Gvs      , Re          , Gg          , Gg          , Gg^Efm      , Gg          , Re          , Gg          , Re          , Rr          , Rr          , Gg          , Gg          , Gg^Efm      , Gg          , Gg          , Gg          , Gg          , Gg          
Gs^Fds      , Gs^Fds      , Gs^Fds      , Ss          , Ss          , Ss          , Ss          , Ss          , Ss          , Gs^Fds      , Gs^Fds      , Gs^Vl       , Gs^Fds      , Re          , Re          , Gg          , Ww          , Ww          , Ww          , Ds          , Gg          , Re^Gvs      , Re          , Re          , Re^Gvs      , Re^Gvs      , Gg          , Gg          , Gg^Efm      , Gg^Efm      , Gg          , Gg          , Rr          , Gg          , Gs^Fds      , Gg          , Gg          , Gg          , Gg          , Gg          , Gg          , Gg          
Re          , Re          , Re          , Hh          , Gs^Fds      , Ss          , Hh          , Hh          , Hh          , Hh          , Hh          , Gs^Fds      , Gs^Fds      , Gs^Fds      , Re          , Gg          , Ds          , Ww          , Ww          , Ww          , Ds          , Gg          , Gg          , Re^Gvs      , Gg          , Gg          , Gg^Vh       , Gg          , Rr          , Gg          , Rr          , Rr          , Gs^Fds      , Gg          , Gg          , Gg          , Gg          , Gg          , Gg          , Gg          , Gg          , Gg          
Gs^Fds      , Gs^Fds      , Re          , Gs^Fds      , Gs^Fds      , Hh          , Gs^Fds      , Hh          , Hh          , Mm          , Hh          , Hh          , Gs^Fds      , Gg          , Re          , Gs^Fds      , Gg^Vh       , Ds          , Ww          , Ww          , Ww          , Gg          , Ce          , Gg          , Rr          , Rr          , Rr          , Rr          , Gg          , Rr          , Gs^Fds      , Gg          , Gs^Fds      , Gs^Fds      , Gs^Fds      , Gs^Fds      , Gg          , Gs^Fds      , Gg          , Gg          , Gg          , Gg          
Gs^Fds      , Gs^Fds      , Re          , Gs^Fds      , Gs^Fds      , Gs^Fds      , Gs^Fds      , Hh          , Gs^Fds      , Hh          , Gs^Fds      , Gs^Fds      , Gs^Fds      , Gs^Fds      , Gg          , Re          , Re          , Gg          , Gg          , Ww          , Ww          , Ww          , Ww^Bw/      , Rr          , Gg          , Gg          , Re^Gvs      , Gg          , Gs^Fds      , Gg          , Gs^Fds      , Gg          , Gs^Fds      , Gs^Fds      , Gs^Fds      , Gg          , Gs^Fds      , Gs^Fds      , Gs^Fds      , Gs^Fds      , Gg          , Gg          
Gs^Fds      , Gs^Fds      , Gs^Fds      , Re          , Re          , Gs^Fds      , Hh          , Hh          , Hh          , Gs^Fds      , Gs^Fds      , Gg          , Gg          , Gg          , Re^Gvs      , Gg^Efm      , Gg          , Rr          , Rr          , Ce          , Rr          , Ww^Bw/      , Ww          , Ww          , Gg          , Re^Gvs      , Re^Gvs      , Re^Gvs      , Gs^Fds      , Gg          , Gs^Fds      , Gg          , Gs          , Gs^Fds      , Gs^Fds      , Gs^Fds      , Gs^Fds      , Gs^Fds      , Gs^Fds      , Gg          , Gg          , Gg          
Gs^Fds      , Gs^Fds      , Gs^Fds      , Gs^Fds      , Re          , Gs^Fds      , Gs^Fds      , Gs^Fds      , Gs^Fds      , Gs^Fds      , Gs^Fds      , Gs^Fds      , Re          , Re^Gvs      , Re^Gvs      , Re^Gvs      , Gg          , Ce          , Gg^Vh       , Rr          , Rr          , Gg^Vh       , Ww          , Ww          , Ww          , Gg          , Gg          , Gg          , Gs^Fds      , Gs^Fds      , Gg          , Gs^Fds      , Gs^Fds      , Gs          , Gs^Fds      , Gs          , Gs          , Gs          , Gs^Fds      , Gg          , Gs^Fds      , Gs^Fds      
Gs^Fds      , Gs^Fds      , Gs^Fds      , Gs^Fds      , Re          , Gs^Fds      , Gs^Fds      , Gs^Fds      , Gs^Fds      , Gs^Fds      , Gs^Fds      , Gg^Efm      , Gg          , Re^Gvs      , Gg          , Gg          , Gg^Efm      , Ce          , Gg^Vh       , Rr          , Rr          , Chr         , Khr         , Ww          , Ww          , Ds          , Gg          , Gg          , Gg          , Gg          , Gs^Fds      , Gg^Vh       , Hh          , Hh          , Mm          , Gs          , Hh          , Gs^Fds      , Hh          , Gs          , Hh          , Hh          
Gs^Fds      , Gs^Fds      , Gs^Fds      , Gs^Fds      , Gs^Fds      , Re          , Gs^Fds      , Gs^Fds      , Gs^Fds      , Gs^Fds      , Gg          , Gs^Fds      , Gg          , Gg          , Re^Gvs      , Gg          , Gg          , Ce          , Rr          , Rr          , Rr          , Chr         , Chr         , Ww^Bw/      , Wo          , Ww          , Ds          , Gg          , Gs^Fds      , Gs^Fds      , Gs^Fds      , Gs^Fds      , Gs          , Mm          , Mm          , Mm          , Mm          , Hh          , Gs^Fds      , Hh          , Gs^Fds      , Gs^Fds      
Gs^Fds      , Gs^Fds      , Gs^Fds      , Gs^Fds      , Re          , Re          , Gs^Fds      , Gs^Fds      , Gs^Fds      , Gs^Fds      , Gs^Fds      , Gg^Efm      , Re^Gvs      , Re^Gvs      , Gg          , Gg          , Re          , Rr          , Ce          , Gg^Vh       , Gg^Vh       , Rr          , Gg^Vh       , Ww^Bw/      , Wo          , Ww          , Gg          , Gg          , Hh          , Gg          , Hh          , Hh          , Mm          , Mm          , Mm          , Mm          , Mm          , Hh          , Gs^Fds      , Gs^Fds      , Gs^Fds      , Gs^Fds      
Gs^Fds      , Gs^Fds      , Gs^Fds      , Re          , Gs^Fds      , Gs^Fds      , Gs^Fds      , Gg          , Gs^Fds      , Gs^Fds      , Gg^Efm      , Gg          , Gs^Fds      , Gg          , Gg          , Re          , Gg^Efm      , Gg          , Gg          , Ce          , Ce          , Rr          , Ww          , Ww          , Ww          , Ww          , Gg          , Hh          , Gg          , Hh          , Gg          , Mm          , Mm          , Mm          , Mm          , Mm          , Mm          , Gs^Fds      , Gs^Fds      , Gs^Fds      , Gs^Fds      , Gs^Fds      
Gs^Fds      , Gs^Fds      , Gs^Fds      , Re          , Gs^Fds      , Gs^Fds      , Gg          , Gs^Fds      , Gg          , Gg          , Gg          , Gg          , Gg^Vh       , Gg          , Re          , Re          , Gg^Vh       , Gg          , Re^Gvs      , Gg          , Gg          , Ww          , Ww          , Ww          , Ds          , Gg          , Gg          , Gg          , Gg          , Hh          , Gg          , Mm          , Hh          , Hh          , Gs^Fds      , Hh          , Hh          , Hh          , Ww          , Gs^Fds      , Gs^Fds      , Gs^Fds      
Gs^Fds      , Gs^Fds      , Gs^Fds      , Re          , Re          , Gs^Fds      , Re          , Gs^Vl       , Gs^Fds      , Gs^Fds      , Re          , Gs^Fds      , Re          , Gs^Fds      , Re          , Gg          , Gg          , Re^Gvs      , Re^Gvs      , Re^Gvs      , Gg          , Gg          , Ww          , Ds          , Ds          , Gg          , Ds          , Gg          , Gg          , Gg          , Gg          , Hh          , Gs^Fds      , Hh          , Hh          , Gs^Fds      , Ww          , Ww          , Gs^Fds      , Ww          , Ww          , Ww          
Gs^Fds      , Gs^Fds      , Gs^Fds      , Gs^Fds      , Gs^Fds      , Re          , Gs^Fds      , Re          , Re          , Re          , Gs^Fds      , Re          , Gs^Fds      , Re          , Gg^Efm      , Gs^Fds      , Gg          , Gg          , Gg          , Gg          , Ww          , Ww          , Ww          , Ds          , Ww          , Ds          , Wwf         , Ds          , Wwf         , Gg          , Hh          , Hh          , Gs^Fds      , Gs^Fds      , Hh          , Gs^Fds      , Ww          , Gs^Fds      , Gs^Fms      , Gs^Fds      , Gs^Fds      , Gs^Fds      
Gs^Fds      , Gs^Fds      , Gs^Fms      , Gs^Fds      , Gs^Fds      , Gs          , Gs^Fds      , Gg          , Gg          , Gg          , Ss          , Ss          , Ss          , Gg          , Ss          , Ss          , Ss          , Gg          , Gg          , Gg^Vh       , Ww^Bw\      , Wo          , Wo          , Ww          , Wo          , Ww          , Ds          , Wwf         , Ds          , Wwf         , Ww          , Gs^Fds      , Gs^Fds      , Gs^Fds      , Ww          , Ww          , Gs^Fds      , Gs^Fds      , Gs^Fds      , Gs^Fds      , Gs^Fds      , Gs^Fds      
Gs^Fds      , Gs^Fds      , Gs^Fds      , Gs^Fds      , Gs^Fds      , Gs^Fds      , Gg          , Gg          , Ss          , Ss          , Ss          , Gg          , Ww          , Ss          , Ss          , Ss          , Ww          , Ww          , Ww          , Ww          , Wo          , Wo          , Wo          , Wo          , Ww          , Ww          , Ds          , Ds          , Gs^Fds      , Gs^Fds      , Ww          , Gs^Fds      , Gs^Fds      , Gs^Fds      , Ww          , Gs^Fds      , Gs^Fds      , Gs^Fds      , Gs^Fdw      , Gs^Fds      , Gs^Fds      , Gs^Fds      
Gs^Fds      , Gs^Fds      , Gs^Fds      , Gs^Fds      , Ww          , Gs^Fds      , Ww          , Gs^Fds      , Ww          , Ss          , Ss          , Ww          , Ss^Vhs      , Ss          , Ww          , Ww          , Ww          , Ww          , Ww          , Ww          , Ww          , Ww          , Ww          , Ww          , Gs^Fds      , Re          , Gs^Fds      , Gs^Fds      , Gs^Fds      , Gs^Fds      , Gs^Fds      , Ww          , Ww          , Ww          , Gs^Fds      , Gs^Fds      , Gs^Fms      , Gs^Fds      , Gs^Fds      , Gs^Fds      , Gs^Fds      , Gs^Fds      
Gs^Fds      , Gs^Fds      , Ww          , Ww          , Ww          , Ww          , Ww          , Ww          , Ww          , Ww          , Ww          , Gs^Fdw      , Ss          , Ww          , Ww          , Ww          , Gs^Fds      , Gs^Fds      , Gs^Fds      , Gs^Fds      , Gs^Fds      , Gs^Fds      , Gs^Fds      , Gs^Fds      , Re          , Re          , Gs^Fds      , Gs^Fds      , Gs^Fds      , Hh          , Hh          , Gs^Fds      , Gs^Fds      , Gs^Fds      , Gs^Fds      , Gs^Fds      , Hh          , Gs^Fds      , Gs^Fds      , Gs^Fds      , Gs^Fms      , Gs^Fds      
Ww          , Ww          , Ww          , Ww          , Gs^Fds      , Ww          , Hh          , Ww          , Gs^Fds      , Ww          , Ww          , Ww          , Ww          , Ww          , Ww          , Gs^Fds      , Gs^Fds      , Gs^Fds      , Gs^Fds      , Gs^Fds      , Gs^Fds      , Gs^Fds      , Re          , Gg          , Gs^Fds      , Gs^Fds      , Gs^Fdw      , Gs^Fds      , Gs^Fds      , Hh          , Hh          , Gs^Fdw      , Gs^Fds      , Hh          , Gs^Fds      , Gs^Fds      , Hh          , Gs^Vl       , Gs^Fds      , Gs^Fds      , Gs^Fds      , Gs^Fds      
Ww          , Ww          , Gs^Fds      , Gs^Fds      , Gs^Fds      , Gs^Fds      , Hh          , Hh          , Hh          , Gs^Fds      , Hh          , Ww          , Ww          , Ww          , Gs^Fds      , Gs^Fds      , Gs^Fds      , 2 Ke        , Ce          , Gs          , Gs          , Re          , Gs^Fds      , Gs^Fds      , Gs^Fds      , Gs^Fds      , Gs^Fds      , Gs^Fds      , Hh          , Hh          , Wo          , Mm          , Mm          , Hh          , Hh          , Hh          , Ww          , Gs^Fds      , Hh          , Hh          , Gs^Fds      , Gs^Fds      
Gs^Fds      , Gs^Fds      , Gs^Fds      , Gs^Fds      , Gs^Fds      , Gg          , Gs^Fds      , Hh          , Hh          , Hh          , Gs^Fds      , Gs^Fds      , Ww          , Gs^Fds      , Gs^Fds      , Gs^Fds      , Gs^Fds      , Ce          , Ce          , Gs          , Gs          , Re          , Gs^Fds      , Gs^Fdw      , Gs^Fds      , Gs^Fds      , Gs^Fds      , Gs^Fds      , Hh          , Mm          , Mm          , Hh          , Mm          , Hh          , Mm          , Hh          , Hh          , Gs^Fds      , Hh          , Hh          , Hh          , Hh          
Hh          , Hh          , Gs^Fds      , Gs^Fms      , Gs^Fds      , Gs^Fds      , Gs^Fds      , Hh          , Gg          , Hh          , Hh          , Gs^Fds      , Ww          , Gg          , Gs^Fds      , Gg          , Gs^Fds      , Gs^Fds      , Gs          , Gs          , Gs^Fds      , Gs          , Gs^Fds      , Gs^Fds      , Gs^Fdw      , Gs^Fds      , Hh          , Hh          , Gs^Fds      , Mm          , Hh          , Mm          , Mm          , Mm          , Hh          , Mm          , Hh          , Hh          , Hh          , Mm          , Hh          , Hh          
Gs^Fds      , Gs^Fds      , Gs^Fds      , Gs^Fds      , Gs^Fds      , Gg          , Gs^Fds      , Gs^Fds      , Gs^Fds      , Gs^Fds      , Hh          , Gs^Fds      , Gs^Fds      , Ww          , Gg          , Gs^Fds      , Gs^Fds      , Gs^Fds      , Gs          , Gs^Fds      , Gs^Fds      , Re          , Gs^Fds      , Gs^Fds      , Gs^Fds      , Gs^Fds      , Hh          , Gs^Fds      , Ww          , Gs^Fds      , Gs^Fds      , Hh          , Mm          , Mm          , Mm          , Hh          , Hh          , Mm          , Hh          , Hh          , Gs^Fds      , Gs^Fds      
Gg          , Gg          , Gg          , Gs^Fds      , Gs^Fds      , Gs^Fds      , Gs^Fdw      , Gs^Fds      , Gs^Fds      , Gs^Fds      , Gs^Fds      , Gg          , Gs^Fds      , Ss          , Ss          , Gs^Fds      , Re          , Re          , Gs^Fds      , Gs^Fds      , Gs^Fds      , Gg          , Gg          , Gs^Fds      , Gs^Fds      , Gs^Fds      , Gs^Fds      , Ww          , Hh          , Hh          , Gs^Fds      , Hh          , Mm          , Wo          , Mm          , Mm          , Hh          , Hh          , Gs^Fds      , Hh          , Hh          , Hh          
Gs^Fds      , Gs^Fds      , Gs^Fds      , Re          , Re          , Gg          , Gg          , Gg          , Gg          , Gs^Fds      , Gs^Fds      , Gg          , Gs^Fds      , Gs^Fdw      , Gg          , Ss          , Gg          , Gs^Fds      , Gs^Fds      , Gs^Fds      , Gs^Fds      , Re          , Re          , Gs^Fds      , Hh          , Hh          , Hh          , Hh          , Hh          , Ww          , Mm          , Mm          , Mm          , Mm          , Hh          , Hh          , Hh          , Hh          , Hh          , Gs^Fds      , Gs^Fds      , Gs^Fds      
Gs^Fds      , Gs^Fds      , Gs^Fds      , Gs^Fds      , Gs^Fds      , Gs^Fds      , Gs^Fds      , Gs^Fds      , Gs^Fds      , Re          , Re          , Gs^Fds      , Gg          , Gs^Fds      , Ss          , Ss          , Gs^Fds      , Gs^Fds      , Gg          , Gs^Fds      , Gs^Fds      , Gs^Fds      , Re          , Gs^Fds      , Hh          , Gs^Fds      , Gs^Fds      , Hh          , Hh          , Hh          , Hh          , Mm          , Mm          , Hh          , Gs^Fds      , Gs^Fds      , Hh          , Gs^Fds      , Hh          , Ww          , Gs^Fds      , Gs^Fds      
Gs^Fds      , Gs^Fds      , Gs^Fms      , Gs^Fds      , Gs^Fds      , Gs^Fds      , Gs^Fds      , Gs^Fds      , Gs^Fds      , Gs^Fds      , Gs^Fds      , Re          , Gs^Fds      , Gs^Fds      , Ss          , Gs^Fdw      , Gs^Fds      , Gs^Fds      , Gs^Fds      , Gs^Fds      , Gs^Fds      , Gs^Fds      , Re          , Gs^Fds      , Gs^Fds      , Gs^Fds      , Hh          , Hh          , Hh          , Mm          , Mm          , Mm          , Mm          , Hh          , Hh          , Gs^Fds      , Gs^Fds      , Gs^Fds      , Gs^Fds      , Gg          , Gs^Fds      , Gs^Fds      
Gs^Fds      , Gs^Fds      , Gs^Fds      , Gs^Fds      , Gs^Fds      , Gs^Fds      , Gs^Fds      , Gs^Fds      , Gs^Fds      , Gs^Fds      , Gs^Fds      , Re          , Gs^Fds      , Gs^Fds      , Ss          , Gs^Fds      , Gs^Fds      , Gs^Fds      , Gs^Fds      , Gs^Fds      , Gs^Fds      , Gs^Fds      , Re          , Gs^Fds      , Gs^Fds      , Gs^Fds      , Hh          , Hh          , Hh          , Mm          , Mm          , Mm          , Mm          , Hh          , Hh          , Gs^Fds      , Gs^Fds      , Gs^Fds      , Gs^Fds      , Gg          , Gs^Fds      , Gs^Fds      
