border_size=1
usage=map

Gs^Fp       ,Gs^Fp       , Aa          , Gs^Fp       , Ha          , Mm          , Mm          , Mm          , Ha          , Aa^Fpa      , Aa^Fpa      , Gs^Fp       , Gs          , Gs          , Gs          , Gs          , Gs          , Rr          , Gs          , Gs          , Gs          , Gs          , Gs          , Gg          , Gg          , Gg          , Gg          , Ww          , Aa          , Aa          , Aa          , Aa          , Ha          , Ha          , Gs          , Re          , Gs          , Gs          , Gs          , Gs          , Gs          , Gs          
Gs^Fp       ,Gs^Fp       , Aa          , Gs^Fp       , Ha          , Mm          , Mm          , Mm          , Ha          , Aa^Fpa      , Aa^Fpa      , Gs^Fp       , Gs          , Gs          , Gs          , Gs          , Gs          , Rr          , Gs          , Gs          , Gs          , Gs          , Gs          , Gg          , Gg          , Gg          , Gg          , Ww          , Aa          , Aa          , Aa          , Aa          , Ha          , Ha          , Gs          , Re          , Gs          , Gs          , Gs          , Gs          , Gs          , Gs          
Gs^Fp       ,Gs^Fp       , Aa^Fpa      , Aa^Fpa      , Mm          , Mm          , Mm          , Ha          , Aa^Fpa      , Aa          , Gs^Fp       , Gs          , Gs          , Gs          , Gs          , Gs          , Gg          , Rr          , Rr          , Gs          , Gs          , Gs          , Gs          , Gs          , Gs          , Gg          , Gg          , Ww          , Ai          , Aa          , Aa          , Aa          , Aa^Vha      , Ha          , Re          , Re          , Gs          , Gs          , Aa^Fpa      , Gs          , Gs          , Gs          
Gs^Fp       ,Gs^Fp       , Aa^Fpa      , Ha          , Mm          , Mm          , Mm          , Ha          , Gs^Fp       , Gg          , Gg          , Aa          , Gs          , Gs          , Gs          , Gs          , Gs          , Gg^Vh       , Rr          , Gs          , Gs          , Gs          , Gs          , Aa          , Gs          , Gs          , Gg          , Gg          , Aa          , Ww          , Aa          , Aa          , Aa          , Re          , Gg          , Gg          , Gg          , Aa^Fpa      , Aa^Fpa      , Gs          , Gs          , Gs          
Aa          ,Aa          , Ha          , Mm          , Mm          , Mm          , Ha          , Aa^Fpa      , Gs^Fp       , Gg^Vh       , Gg          , Gs          , Gs          , Gs          , Gs          , Gs          , Gs          , Gs          , Rr          , Gs          , Gs          , Gs          , Gs          , Aa          , Aa          , Gs          , Gs          , Gs          , Gg          , Ww          , Ai          , Aa          , Ww          , Re          , Ww          , Gg          , Aa          , Ha          , Ha          , Aa^Fpa      , Gs          , Gs          
Gs^Fp       ,Gs^Fp       , Ha          , Mm          , Ha          , Ha          , Aa          , Gs^Fp       , Gs^Fp       , Gg          , Gs          , Gs          , Aa          , Aa          , Gs          , Gs          , Gs          , Gs          , Rr          , Gg^Vh       , Gs          , Gs          , Gs          , Gs          , Gs          , Gs          , Gs          , Gs          , Gs          , Aa          , Aa          , Ai          , Ce          , Ww^Bw|      , Aa          , Ww          , Ai          , Aa          , Aa^Fpa      , Ha          , Ha          , Ha          
Aa^Fpa      ,Aa^Fpa      , Aa^Fpa      , Ha          , Aa^Fpa      , Aa^Fpa      , Aa          , Aa          , Gs          , Gs          , Gs          , Aa          , Aa          , Aa          , Gs          , Gs          , Gs          , Gs          , Gs          , Rr          , Gs          , Gs          , Gs          , Gs          , Gs          , Gs          , Gs          , Gs          , Gs          , Aa^Vha      , Aa          , Aa          , Gs          , Re          , Gs          , Aa          , Ai          , Aa          , Aa^Fpa      , Ha          , Gg          , Gg          
Gs          ,Gs          , Aa          , Ha          , Aa^Fpa      , Gs^Fp       , Gs^Fp       , Aa          , Gs          , Gs          , Gs          , Gs          , Gs          , Gs          , Gg^Vh       , Gs          , Gs          , Gs          , Ce          , Rr          , Ce          , Gs          , Gs          , Aa          , Gs          , Gs          , Gs          , Gs          , Gs          , Aa          , Aa          , Gs          , Re          , Re          , Gs          , Aa          , Aa          , Ai          , Ww          , Ww          , Ww          , Ww          
Gs          ,Gs          , Gs          , Gs          , Gs          , Gs          , Gs          , Gs          , Gs          , Aa          , Aa          , Gs          , Gs          , Gs          , Gs          , Gs          , Gs          , Ce          , Gg^Vh       , Rr          , Gg^Vh       , Ce          , Gs          , Gs          , Gs          , Gg^Vh       , Gs          , Gs          , Gs          , Gs          , Gs          , Gs          , Re          , Gs          , Hh          , Gs          , Hh          , Aa          , Aa          , Aa          , Aa          , Aa          
Gs          ,Gs          , Gs          , Aa^Fpa      , Gs          , Gs          , Re          , Gs          , Gs          , Aa          , Gs          , Gs          , Gs          , Gs          , Gs          , Gs          , Gs          , Ce          , Ce          , Rr          , 1 Ce        , Ce          , Ha          , Ha          , Aa          , Gs          , Gs          , Gs          , Gs          , Aa^Fpa      , Aa^Fpa      , Gs          , Re          , Gs          , Gs          , Hh          , Ha          , Aa          , Gs          , Gs          , Gs          , Gs          
Gs          ,Gs          , Gs          , Gs          , Ce          , Ce          , Ce          , Re          , Re          , Gs          , Re          , Aa          , Aa          , Gs          , Gs          , Gs          , Gs          , Gs          , Re          , Ke          , Gs          , Aa^Fpa      , Ha          , Ha          , Aa          , Gs          , Gs          , Gs          , Aa          , Aa^Fpa      , Aa^Fpa      , Re          , Aa          , Ce          , Ce          , Ha          , Ha          , Ha          , Hh          , Gs          , Gs          , Gs          
Gs          ,Gs          , Gs          , Gs          , Gs          , Ce          , Aa^Fpa      , Gs          , Gs          , Re          , Gs          , Re          , Re          , Re          , Re          , Re          , Re          , Re          , Gs          , Re          , Re          , Gs          , Gs          , Aa          , Re          , Re          , Re          , Re          , Re          , Aa          , Re          , Re          , Gs          , Ce          , Ce          , Ce          , Gs          , Ha          , Hh          , Gs          , Gs          , Gs          
Gs          ,Gs          , Aa          , Gs          , Gs          , Gs          , Aa^Fpa      , Gs          , Gs          , Gs          , Hh          , Gs          , Aa          , Ce          , Ce          , Gs          , Gs          , Aa          , Aa          , Gs          , Qxu         , Re          , Re          , Re          , Ce          , Gs          , Gs          , Gs          , Gs          , Re          , Aa          , Gs          , Gs          , Ha          , Ha          , Gs          , Gs          , Gs          , Gs          , Gs          , Gs          , Gs          
Aa          ,Aa          , Aa          , Gs          , Gs          , Aa^Fpa      , Gs          , Aa^Fpa      , Gs          , Gs          , Aa          , Hh          , Aa          , Ce          , Gs          , Gs          , Aa^Fpa      , Aa          , Aa^Fpa      , Qxu         , Gs          , Qxu         , Gs          , Ce          , Aa          , Aa          , Gs          , Gs          , Gs          , Aa          , Gs          , Gs          , Gs          , Gs          , Gs          , Gs          , Gs          , Gs          , Aa          , Gs          , Gs          , Gs          
Aa^Fpa      ,Aa^Fpa      , Aa^Fpa      , Gs          , Gs          , Gs          , Gs          , Gs          , Gs          , Aa          , Aa          , Hh          , Gs          , Aa          , Qxu         , Gs          , Aa^Fpa      , Aa^Fpa      , Gs          , Gs          , Gs          , Gs          , Gs          , Gs          , Aa          , Gs          , Qxu         , Gs          , Aa          , Gs          , Gs          , Gs          , Aa          , Gs          , Gs          , Gs          , Gs          , Gs          , Gs          , Aa          , Gs          , Gs          
Aa^Fpa      ,Aa^Fpa      , Aa          , Gs          , Aa^Fpa      , Aa          , Aa^Fpa      , Gs          , Gs          , Gs          , Gs          , Gs          , Qxu         , Qxu         , Gs          , Gs          , Gs          , Aa          , Gs          , Aa          , Gs          , Gs          , Gs          , Gs          , Gs          , Gs          , Qxu         , Gs          , Gs          , Gs          , Gs          , Gs          , Gs          , Gs          , Gs^Fp       , Gs          , Gs          , Gs          , Gs^Fp       , Gs          , Gs          , Gs          
Ha          ,Ha          , Ha          , Aa          , Aa^Fpa      , Aa          , Aa          , Aa          , Gs          , Gs          , Gs          , Gs          , Qxu         , Gs          , Aa^Fpa      , Gs          , Hh          , Gs          , Aa^Fpa      , Gs          , Gs          , Gs          , Aa          , Gs          , Gs          , Qxu         , Gs          , Qxu         , Gs          , Gs          , Gs          , Gs          , Gs          , Gs          , Aa^Fpa      , Gs^Fp       , Hh          , Gs^Fp       , Aa^Fpa      , Gs          , Gs          , Gs          
Mm          ,Mm          , Mm          , Aa^Fpa      , Aa^Fpa      , Aa^Fpa      , Aa          , Aa          , Gs          , Gs          , Gs          , Gs          , Gs          , Aa^Fpa      , Gs          , Aa^Fpa      , Hh          , Ha          , Ha          , Aa^Fpa      , Gs          , Gs          , Gs          , Gs          , Gs          , Qxu         , Gs          , Gs          , Gs          , Gs          , Gs          , Gs          , Gs          , Aa^Fpa      , Aa^Fpa      , Ha          , Ha          , Ha          , Hh          , Gs          , Gs          , Gs          
Mm          ,Mm          , Mm          , Mm          , Mm          , Aa^Fpa      , Aa^Fpa      , Aa^Fpa      , Gs          , Gs          , Gs          , Gs          , Gs          , Gs          , Gs          , Aa^Fpa      , Aa^Fpa      , Ha          , Ha          , Aa^Fpa      , Aa^Fpa      , Aa^Fpa      , Gs          , Gs          , Gs          , Gs          , Gs          , Gs          , Gs          , Aa          , Gs          , Gs          , Gs^Fp       , Aa^Fpa      , Gs          , Gs          , Aa^Fpa      , Hh          , Ha          , Aa^Fpa      , Gs          , Gs          
Mm          ,Mm          , Mm          , Mm          , Mm          , Ha          , Ha          , Gs          , Aa^Fpa      , Aa^Fpa      , Gs          , Aa^Fpa      , Gs          , Gs          , Gs          , Gs          , Gs          , Hh          , Hh          , Ha          , Gs          , Aa^Fpa      , Aa^Fpa      , Aa^Fpa      , Gs          , Gs          , Gs          , Gs          , Rd          , Gs          , Gs          , Gs          , Gs          , Gs^Fp       , Gs          , Aa^Fpa      , Aa^Fpa      , Ha          , Hh          , Ha          , Aa^Fpa      , Aa^Fpa      
Mm          ,Mm          , Mm          , Mm          , Mm          , Ha          , Ha          , Aa^Fpa      , Aa          , Aa          , Aa^Fpa      , Aa^Fpa      , Gs          , Rd          , Gs          , Rd          , Gs          , Aa^Fpa      , Aa^Fpa      , Aa^Fpa      , Aa^Fpa      , Gs          , Gs          , Gs          , Gs          , Gs          , Rd          , Gs          , Gs          , Gs          , Ha          , Gs          , Aa^Fpa      , Gs          , Gs          , Gs          , Gs          , Aa^Fpa      , Gs          , Hh          , Ha          , Ha          
Mm          ,Mm          , Mm          , Mm          , Mm          , Mm          , Ha          , Aa^Fpa      , Aa^Fpa      , Aa^Fpa      , Aa^Fpa      , Aa^Fpa      , Aa          , Gs          , Rd          , Gs          , Gs          , Rd          , Aa^Fpa      , Aa^Fpa      , Gs          , Gs          , Gs          , Gs          , Aa^Fpa      , Gs          , Aa^Fpa      , Rd          , Rd          , Rd          , Ha          , Aa^Fpa      , Aa^Fpa      , Aa          , Aa          , Gs          , Gs          , Gs          , Gs          , Gs          , Gs          , Gs          
Mm          ,Mm          , Mm          , Mm          , Ha          , Mm          , Ha          , Aa^Fpa      , Ha          , Aa          , Aa^Fpa      , Aa          , Aa          , Aa          , Rd          , Rd          , Gs          , Gs          , Gs          , Gs          , Gs          , Gs          , Gs          , Gs          , Hh          , Aa^Fpa      , Hh          , Rd          , Rd          , Mm          , Mm          , Ha          , Ha          , Aa          , Aa^Fpa      , Gs          , Gs          , Gs          , Gs          , Gs          , Gs          , Gs          
Mm          ,Mm          , Ha          , Ha          , Ha          , Ha          , Mm          , Mm          , Ha          , Aa          , Aa^Fpa      , Aa^Fpa      , Aa^Fpa      , Rd          , Ch          , Rd          , Rd          , Rd          , Gs          , Rd          , Aa^Fpa      , Gs          , Aa^Fpa      , Hh          , Ha          , Aa^Fpa      , Mm          , Rd          , Cud         , Cud         , Cud         , Mm          , Mm          , Ha          , Aa^Fpa      , Gs          , Gs          , Gs          , Aa          , Gs          , Gs          , Gs          
Mm          ,Mm          , Ha          , Ha          , Mm          , Mm          , Mm          , Mm          , Mm          , Mm          , Ha          , Aa^Fpa      , Aa          , Ch          , 3 Kh        , Ch          , Ch          , Rd          , Rd          , Gs          , Aa^Fpa      , Aa^Fpa      , Hh          , Hh          , Ha          , Mm          , Mm          , Cud         , 2 Kud       , Cud         , Mm          , Mm          , Mm          , Ha          , Aa^Fpa      , Aa^Fpa      , Aa          , Aa          , Gs          , Gs          , Gs          , Gs          
Mm          ,Mm          , Ha          , Ha          , Mm          , Mm          , Mm          , Mm          , Mm          , Ha          , Ha          , Aa^Fpa      , Rd          , Ch          , Ch          , Ch          , Rd          , Rd          , Gs          , Gs          , Gs          , Hh          , Ha          , Ha          , Ha          , Mm          , Mm          , Mm          , Mm          , Cud         , Mm          , Mm          , Mm          , Ha          , Gs          , Aa          , Aa          , Gs          , Gs          , Gs          , Gs          , Gs          
Mm          ,Mm          , Ha          , Ha          , Mm          , Mm          , Mm          , Mm          , Mm          , Ha          , Ha          , Aa^Fpa      , Rd          , Ch          , Ch          , Ch          , Rd          , Rd          , Gs          , Gs          , Gs          , Hh          , Ha          , Ha          , Ha          , Mm          , Mm          , Mm          , Mm          , Cud         , Mm          , Mm          , Mm          , Ha          , Gs          , Aa          , Aa          , Gs          , Gs          , Gs          , Gs          , Gs          
