border_size=1
usage=map

Aa^Fda      , Aa^Fda      , Aa^Fda      , Ss          , Aa^Fda      , Ss          , Ss          , Re          , Re          , Re          , Re          , Aa          , Aa          , Gg          , Aa          , Gg          , Gg          , Ww          , Ww          , Ds          , Gg          , Gg          , Aa          , Aa^Fda      , Aa^Fda      , Hh          , Hh          , Re          , Re          , Aa          , Aa          , Aa          , Aa          , Aa^Fda      , Aa^Fda      , Aa^Fda      , Gg          , Aa          , Aa          , Aa          , Aa          , Gg          
Ss          , Ss          , Ss          , Ss          , Ss          , Aa^Fda      , Ai          , Ss          , Aa^Fda      , Gg          , Gg          , Re          , Gg          , Gg          , Gg          , Aa          , Aa^Fda      , Ai          , Ww          , Ds          , Gg          , Gg          , Aa^Vha      , Gg          , Aa^Fda      , Ha          , Aa^Fda      , Gg          , Gg          , Re          , Gg          , Gg          , Gg          , Aa          , Gg          , Gg          , Rr          , Rr          , Rr          , Aa^Vha      , Rr          , Rr          
Ss          , Ss          , Ww          , Ss          , Ww          , Ai          , Ai          , Aa^Fda      , Aa^Fda      , Gs          , Aa^Fda      , Re          , Aa          , Aa^Fda      , Gg          , Aa          , Aa          , Ai          , Ww          , Ww          , Ds          , Gg          , Aa          , Aa          , Aa^Fda      , Aa^Fda      , Aa          , Gg          , Re          , Re          , Gg          , Ggf         , Gg          , Gg          , Rr          , Rr          , Gg          , Aa          , Aa          , Rr          , Aa          , Gg          
Ai          , Ai          , Ww          , Ww          , Ww          , Ww          , Ai          , Ss          , Ss          , Aa^Fda      , Gs^Fdw      , Re          , Re          , Gg          , Gg          , Aa^Fda      , Gg          , Aa^Vha      , Ww          , Ai          , Ds          , Gg          , Gg          , Gg          , Gg          , Aa          , Aa          , Aa          , Re          , Gg          , Re          , Gg          , Gg          , Gg^Vh       , Rr          , Gg          , Aa          , Aa          , Gg          , Aa          , Aa          , Aa          
Ai          , Ai          , Ai          , Ww          , Ss          , Ww          , Ss          , Ss          , Ss          , Ha          , Gs^Fdw      , Gs^Fdw      , Aa          , Re          , Aa          , Gg          , Ai          , Ai          , Ww          , Ai          , Gg          , Gg          , Re^Gvs      , Re^Gvs      , Re          , Gg          , Gg          , Ggf         , Gg          , Re          , Gg          , Re          , Rr          , Rr          , Gg          , Gg          , Ggf         , Gg          , Aa          , Aa          , Gg          , Aa          
Aa^Fda      , Aa^Fda      , Aa^Fda      , Ai          , Ss          , Ss          , Ss          , Ss          , Ss          , Gs^Fdw      , Aa          , Aa^Vha      , Gs^Fdw      , Re          , Re          , Gg          , Ai          , Ww          , Ww          , Ds          , Gg          , Re^Gvs      , Re          , Re          , Re^Gvs      , Re^Gvs      , Gg          , Aa          , Aa          , Gg          , Aa          , Gg          , Rr          , Gg          , Aa^Fda      , Gg          , Gg          , Gg          , Aa          , Aa          , Gg          , Aa          
Re          , Re          , Re          , Ha          , Aa^Fda      , Ss          , Hh          , Ha          , Ha          , Ha          , Ha          , Aa          , Gs^Fdw      , Gs^Fdw      , Re          , Gg          , Ds          , Ai          , Ww          , Ww          , Ds          , Gg          , Gg          , Re^Gvs      , Gg          , Gg          , Gg^Vh       , Aa          , Rr          , Aa          , Rr          , Rr          , Aa^Fda      , Gg          , Gg          , Gg          , Gg          , Gg          , Gg          , Gg          , Aa          , Gg          
Aa^Fda      , Aa^Fda      , Re          , Aa^Fda      , Aa^Fda      , Ha          , Aa^Fda      , Hh          , Hh          , Mm          , Hh          , Hh          , Gs^Fdw      , Gg          , Re          , Gs^Fdw      , Gg^Vh       , Ds          , Ww          , Ww          , Ai          , Gg          , Ce          , Gg          , Rr          , Rr          , Rr          , Rr          , Gg          , Rr          , Aa^Fda      , Gg          , Gs^Fdw      , Aa^Fda      , Aa^Fda      , Aa^Fda      , Gg          , Aa^Fda      , Gg          , Gg          , Gg          , Aa          
Aa^Fda      , Aa^Fda      , Re          , Gs^Fdw      , Gs^Fdw      , Gs^Fdw      , Aa^Fda      , Ha          , Gs^Fdw      , Hh          , Gs^Fdw      , Gs^Fdw      , Gs^Fdw      , Gs^Fdw      , Gg          , Re          , Re          , Gg          , Gg          , Ww          , Ww          , Ww          , Ww^Bw/      , Rr          , Gg          , Gg          , Re^Gvs      , Gg          , Aa^Fda      , Rr          , Aa^Fda      , Gg          , Gs^Fdw      , Gs^Fdw      , Aa^Fda      , Gg^Vh       , Aa^Fda      , Aa^Fda      , Aa^Fda      , Aa^Fda      , Gg          , Gg          
Gs^Fdw      , Gs^Fdw      , Gs^Fdw      , Re          , Re          , Gg^Vh       , Hh          , Ha          , Hh          , Gs^Fdw      , Gs^Fdw      , Aa          , Gg          , Gg          , Re^Gvs      , Ggf         , Gg          , Rr          , Rr          , Ce          , Rr          , Ww^Bw/      , Ww          , Ai          , Gg          , Re^Gvs      , Re^Gvs      , Re^Gvs      , Gs^Fdw      , Rr          , Gs^Fdw      , Gg          , Aa          , Aa^Fda      , Aa^Fda      , Aa^Fda      , Aa^Fda      , Aa^Fda      , Aa^Fda      , Gg          , Gg          , Gg          
Aa^Fda      , Aa^Fda      , Gs^Fdw      , Aa^Fda      , Re          , Gs^Fdw      , Gs^Fdw      , Gs^Fdw      , Aa^Fda      , Gs^Fdw      , Aa^Fda      , Gs^Fdw      , Re          , Re^Gvs      , Re^Gvs      , Re^Gvs      , Gg          , Ce          , Gg^Vh       , Rr          , Rr          , Gg^Vh       , Ai          , Ww          , Ww          , Gg          , Gg          , Gg          , Rr          , Rr          , Gg          , Gs^Fdw      , Gs^Fdw      , Aa          , Gs^Fdw      , Aa          , Aa          , Aa          , Aa^Fda      , Gg          , Gs^Fdw      , Gs^Fdw      
Aa^Fda      , Gs^Fdw      , Aa^Fda      , Gs^Fdw      , Re          , Gs^Fdw      , Gs^Fdw      , Gs^Fdw      , Aa^Fda      , Aa^Fda      , Aa^Fda      , Ggf         , Gg          , Re^Gvs      , Gg          , Gg          , Ggf         , Ce          , Gg^Vh       , Rr          , Rr          , Ch          , 1 Kh        , Ww          , Ww          , Ds          , Gg          , Rr          , Aa          , Aa          , Gs^Fdw      , Gg^Vh       , Ha          , Hh          , Mm          , Aa          , Hh          , Aa^Fda      , Ha          , Aa          , Ha          , Hh          
Aa^Fda      , Aa^Fda      , Aa^Fda      , Gs^Fdw      , Gs^Fdw      , Re          , Aa^Fda      , Gs^Fdw      , Aa^Fda      , Aa^Fda      , Aa          , Aa^Fda      , Gg          , Gg          , Re^Gvs      , Gg          , Gg          , Ce          , Rr          , Rr          , Rr          , Ch          , Ch          , Ww^Bw/      , Wo          , Ai          , Ds          , Rr          , Gs^Fdw      , Gs^Fdw      , Gs^Fdw      , Gs^Fdw      , Aa          , Mm          , Mm          , Mm          , Mm          , Ha          , Gs^Fdw      , Hh          , Gs^Fdw      , Gs^Fdw      
Aa^Fda      , Aa^Fda      , Aa^Fda      , Gs^Fdw      , Re          , Re          , Aa^Fda      , Aa^Fda      , Aa^Fda      , Aa          , Aa^Fda      , Ggf         , Re^Gvs      , Re^Gvs      , Gg          , Gg          , Re          , Rr          , Ce          , Gg^Vh       , Gg^Vh       , Rr          , Gg^Vh       , Ww^Bw/      , Wo          , Ww          , Gg          , Rr          , Rr          , Gg          , Hh          , Hh          , Mm          , Mm          , Mm          , Mm          , Mm          , Hh          , Gs^Fdw      , Aa^Fda      , Aa^Fda      , Gs^Fdw      
Aa^Fda      , Gs^Fdw      , Gs^Fdw      , Re          , Gs^Fdw      , Aa^Fda      , Gs^Fdw      , Aa          , Gs^Fdw      , Aa^Fda      , Aa          , Gg          , Aa^Fda      , Gg          , Gg          , Re          , Ggf         , Gg          , Gg          , Ce          , Ce          , Rr          , Ai          , Ww          , Ww          , Ww          , Gg          , Hh          , Rr          , Hh          , Gg^Vh       , Mm          , Mm          , Mm          , Mm          , Mm          , Mm          , Gs^Fdw      , Aa^Fda      , Aa^Fda      , Aa^Fda      , Gs^Fdw      
Aa^Fda      , Gs^Fdw      , Gs^Fdw      , Re          , Gs^Fdw      , Gs^Fdw      , Gg          , Gs^Fdw      , Gg          , Aa          , Gg          , Gg          , Aa^Vha      , Aa          , Re          , Re          , Gg^Vh       , Gg          , Re^Gvs      , Gg          , Gg          , Ai          , Ww          , Ww          , Ds          , Gg          , Gg          , Gg          , Rr          , Hh          , Gg          , Mm          , Ha          , Ha          , Gs^Fdw      , Ha          , Ha          , Hh          , Ai          , Aa^Fda      , Aa^Fda      , Gs^Fdw      
Aa^Fda      , Aa^Fda      , Aa^Fda      , Re          , Re          , Gs^Fdw      , Re          , Aa^Vha      , Aa^Fda      , Aa^Fda      , Re          , Aa^Fda      , Re          , Gs^Fdw      , Re          , Gg          , Gg          , Re^Gvs      , Re^Gvs      , Re^Gvs      , Gg          , Gg          , Ww          , Ds          , Ds          , Gg          , Ds          , Gg          , Rr          , Gg          , Gg          , Hh          , Gs^Fdw      , Ha          , Hh          , Aa^Fda      , Ai          , Ai          , Aa^Fda      , Ai          , Ai          , Ai          
Aa^Fda      , Aa^Fda      , Aa^Fda      , Gs^Fdw      , Gs^Fdw      , Re          , Aa^Fda      , Re          , Re          , Re          , Gs^Fdw      , Re          , Gs^Fdw      , Re          , Aa          , Gs^Fdw      , Aa          , Aa          , Gg          , Gg          , Ww          , Ww          , Ww          , Ds          , Ww          , Ds          , Wwf         , Ds          , Wwf^Bw|     , Gg^Vh       , Hh          , Hh          , Aa^Fda      , Aa^Fda      , Hh          , Gs^Fdw      , Ai          , Gs^Fdw      , Aa^Fda      , Aa^Fda      , Aa^Fda      , Aa^Fda      
Gs^Fdw      , Gs^Fdw      , Gs^Fdw      , Gs^Fdw      , Gs^Fdw      , Gs          , Aa^Fda      , Aa          , Aa          , Gg          , Ss          , Ss          , Ss          , Aa          , Ss          , Ss          , Ss          , Aa          , Gg          , Gg^Vh       , Ww^Bw\      , Wo          , Wo          , Ww          , Ww          , Ww          , Ds          , Wwf         , Re          , Wwf         , Ww          , Gs^Fdw      , Aa^Fda      , Gs^Fdw      , Ww          , Ww          , Gs^Fdw      , Aa^Fda      , Gs^Fdw      , Aa^Fda      , Aa^Fda      , Gs^Fdw      
Gs^Fdw      , Gs^Fdw      , Gs^Fdw      , Gs^Fdw      , Gs^Fdw      , Aa^Fda      , Aa          , Aa          , Ai          , Ss          , Ss          , Gg          , Ww          , Ss          , Ss          , Ss          , Ww          , Ww          , Ww          , Ww          , Wo          , Wo          , Ww          , Ww          , Ds          , Ds          , Re          , Re          , Aa^Fda      , Aa^Fda      , Ww          , Aa^Fda      , Gg^Vh       , Gs^Fdw      , Ww          , Gs^Fdw      , Aa^Fda      , Aa^Fda      , Gs^Fdw      , Aa^Fda      , Gs^Fdw      , Aa^Fda      
Gs^Fdw      , Gs^Fdw      , Gs^Fdw      , Gs^Fdw      , Ww          , Gs^Fdw      , Ww          , Aa^Fda      , Ai          , Ai          , Ss          , Ww          , Ss^Vhs      , Ss          , Ww          , Ww          , Ww          , Ww          , Ww          , Ww          , Ww          , Ww          , Ds          , Ds          , Gg^Vh       , Re          , Aa^Fda      , Aa^Fda      , Aa^Fda      , Aa^Fda      , Aa^Fda      , Ww          , Ww          , Ww          , Gs^Fdw      , Gs^Fdw      , Gs^Fdw      , Gs^Fdw      , Aa^Fda      , Aa^Fda      , Aa^Fda      , Gs^Fdw      
Gs^Fdw      , Gs^Fdw      , Ww          , Ww          , Ww          , Ww          , Ww          , Ai          , Ww          , Ww          , Ww          , Gs^Fdw      , Ss          , Ww          , Ww          , Ww          , Aa^Fda      , Aa^Fda      , Aa^Fda      , Gs^Fdw      , Gs^Fdw      , Gs^Fdw      , Gs^Fdw      , Gs^Fdw      , Re          , Re          , Gs^Fdw      , Aa^Fda      , Aa^Fda      , Hh          , Hh          , Aa^Fda      , Gs^Fdw      , Gs^Fdw      , Aa^Fda      , Gs^Fdw      , Hh          , Gs^Fdw      , Gs^Fdw      , Gs^Fdw      , Gs^Fdw      , Gs^Fdw      
Ai          , Ai          , Ww          , Ww          , Aa^Fda      , Ai          , Hh          , Ww          , Gs^Fdw      , Ww          , Ai          , Ww          , Ww          , Ww          , Ww          , Gs^Fdw      , Aa          , Aa^Fda      , Aa^Fda      , Aa^Fda      , Aa^Fda      , Gs^Fdw      , Re          , Re          , Gs^Fdw      , Aa^Fda      , Aa^Fda      , Aa^Fda      , Gs^Fdw      , Hh          , Hh          , Gs^Fdw      , Gs^Fdw      , Hh          , Aa^Fda      , Aa^Fda      , Ha          , Gg^Vh       , Aa^Fda      , Gs^Fdw      , Gs^Fdw      , Gs^Fdw      
Ww          , Ww          , Aa^Fda      , Aa^Fda      , Aa^Fda      , Gg          , Ha          , Hh          , Ha          , Aa^Fda      , Ha          , Ww          , Ww          , Ww          , Aa^Fda      , Aa          , Re          , Aa          , Aa          , Aa          , Aa          , Re          , Gs^Fdw      , Gs^Fdw      , Aa^Fda      , Aa^Fda      , Aa^Fda      , Gs^Fdw      , Hh          , Hh          , Wo          , Mm          , Mm          , Hh          , Hh          , Ha          , Ww          , Aa^Fda      , Ha          , Ha          , Gs^Fdw      , Gs^Fdw      
Gs^Fdw      , Aa^Fda      , Gs^Fdw      , Aa^Fda      , Gs^Fdw      , Gg          , Gg          , Hh          , Hh          , Ha          , Aa^Fda      , Aa^Fda      , Ww          , Aa^Fda      , Aa^Fda      , Aa          , Re          , Re          , Gg^Vh       , Gg          , Re          , Re          , Gs^Fdw      , Gs^Fdw      , Aa^Fda      , Aa^Fda      , Gs^Fdw      , Gs^Fdw      , Hh          , Mm          , Mm          , Hh          , Mm          , Hh          , Mm          , Hh          , Ha          , Aa^Fda      , Ha          , Ha          , Ha          , Ha          
Hh          , Hh          , Aa^Fda      , Aa^Fda      , Aa^Fda      , Gs^Fdw      , Gs^Fdw      , Gg          , Gg          , Ha          , Hh          , Gs^Fdw      , Ww          , Gg          , Aa^Fda      , Aa          , Aa^Fda      , Aa^Fda      , Re          , Re          , Gs^Fdw      , Re          , Gs^Fdw      , Gs^Fdw      , Aa^Fda      , Aa^Fda      , Hh          , Hh          , Gs^Fdw      , Mm          , Hh          , Mm          , Mm          , Mm          , Hh          , Mm          , Hh          , Hh          , Ha          , Mm          , Ha          , Ha          
Gs^Fdw      , Gs^Fdw      , Gs^Fdw      , Gs^Fdw      , Gs^Fdw      , Gg^Vh       , Aa^Fda      , Gs^Fdw      , Aa^Fda      , Gg          , Hh          , Gs^Fdw      , Gs^Fdw      , Ww          , Gg          , Gs^Fdw      , Gs^Fdw      , Aa^Fda      , Re          , Aa^Fda      , Aa^Fda      , Re          , Gs^Fdw      , Gs^Fdw      , Aa^Fda      , Aa^Fda      , Hh          , Gs^Fdw      , Ww          , Gs^Fdw      , Gs^Fdw      , Hh          , Mm          , Mm          , Mm          , Ha          , Ha          , Mm          , Ha          , Ha          , Aa^Fda      , Aa^Fda      
Gg          , Gg          , Gg          , Gs^Fdw      , Gs^Fdw      , Gs^Fdw      , Gs^Fdw      , Aa^Fda      , Gs^Fdw      , Gg          , Gs^Fdw      , Gg          , Aa^Fda      , Ss          , Ss          , Gs^Fdw      , Re          , Re          , Gs^Fdw      , Aa^Fda      , Gs^Fdw      , Re          , Aa          , Aa^Fda      , Aa^Fda      , Aa^Fda      , Gs^Fdw      , Ww          , Hh          , Hh          , Gs^Fdw      , Hh          , Mm          , Wo          , Mm          , Hh          , Ha          , Ha          , Aa^Fda      , Ha          , Ha          , Ha          
Gs^Fmw      , Gs^Fmw      , Aa^Fda      , Re          , Re          , Gg          , Gg          , Gg          , Gg          , Gg^Vh       , Gs^Fdw      , Aa          , Aa^Fda      , Aa^Fda      , Gg          , Ss          , Aa          , Gs^Fdw      , Gs^Fdw      , Gs^Fdw      , Gs^Fdw      , Re          , Re          , Gs^Fmw      , Hh          , Hh          , Hh          , Hh          , Hh          , Ww          , Mm          , Mm          , Mm          , Mm          , Hh          , Ha          , Aa          , Aa          , Aa          , Aa^Fda      , Aa^Fda      , Aa^Fda      
Gs^Fmw      , Gs^Fmw      , Gs^Fmw      , Gs^Fmw      , Gs^Fmw      , Gs^Fmw      , Gs^Fmw      , Gs^Fmw      , Gs^Fmw      , Re          , Re          , Gs^Fdw      , Gg          , Aa^Fda      , Ss          , Ss          , Gs^Fmw      , Aa^Fda      , Aa          , Aa^Fda      , Aa^Fda      , Aa          , Re          , Gs^Fmw      , Hh          , Gs^Fp       , Gs^Fp       , Hh          , Hh          , Hh          , Hh          , Mm          , Mm          , Hh          , Aa^Fpa      , Aa^Fpa      , Ha          , Aa          , Ha          , Ww          , Ha          , Aa^Fda      
Gs^Fmw      , Gs^Fmw      , Aa^Fma      , Gs^Fmw      , Gs^Fp       , Aa^Fma      , Aa^Fma      , Gs^Fmw      , Aa^Fma      , Gs^Fmw      , Gs^Fmw      , Re          , Gs^Fmw      , Gs^Fmw      , Ss          , Gs^Fmw      , Gg          , Gs^Fmw      , Gs^Fmw      , Gs^Fmw      , Gs^Fmw      , Gs^Fmw      , Re          , Gs^Fmw      , Gs^Fp       , Gs^Fmw      , Hh          , Hh          , Hh          , Mm          , Mm          , Mm          , Mm          , Hh          , Ha          , Aa^Fpa      , Ha          , Ha          , Ww          , Ha          , Ha          , Aa^Fda      
Gs^Fp       , Aa^Fma      , Gs^Fp       , Aa^Fma      , Gs^Fmw      , Gs^Fmw      , Gs^Fmw      , Gs^Fp       , Aa^Fma      , Gs^Fmw      , Gs^Fmw      , Re          , Gg^Vh       , Gs^Fmw      , Gg          , Gg          , Gs^Fmw      , Gg          , Gg          , Gg          , Gg          , Gg          , Re          , Gs^Fp       , Gs^Fmw      , Gs^Fp       , Hh          , Hh          , Hh          , Mm          , Mm          , Mm          , Mm          , Ha          , Ha          , Aa^Fpa      , Ha          , Ww          , Ww          , Aa^Fda      , Aa^Fda      , Aa^Fda      
Gs^Fp       , Gs^Fmw      , Aa^Fma      , Aa^Fma      , Gs^Fp       , Gs^Fp       , Gs^Fmw      , Aa^Fma      , Gs^Fp       , Gs^Fmw      , Gs^Fp       , Re          , Gs^Fmw      , Gg          , Gs^Fp       , Gg          , Gs^Fp       , Gg          , Gs^Fp       , Gg          , Gs^Fp       , Gg^Vh       , Gs^Fp       , Re          , Re          , Gg^Vh       , Hh          , Hh          , Hh          , Mm          , Mm          , Mm          , Mm          , Hh          , Mm          , Mm          , Ha          , Aa^Fpa      , Ha          , Ha          , Ha          , Aa^Fda      
Gs^Fp       , Aa^Fpa      , Aa^Fpa      , Aa^Fpa      , Re          , Re          , Re          , Gs^Fp       , Gs^Fp       , Gs^Fmw      , Re          , Re          , Gg          , Gg          , Gs^Fmw      , Gg          , Gg          , Gs^Fmw      , Gs^Fp       , Gs^Fmw      , Gs^Fp       , Gg          , Gs^Fp       , Gs^Fmw      , Gs^Fp       , Re          , Re          , Hh          , Hh          , Mm          , Mm          , Mm          , Mm          , Hh          , Mm          , Mm          , Hh          , Hh          , Mm          , Aa^Fpa      , Ha          , Aa^Fda      
Re          , Re          , Re          , Re          , Gs^Fp       , Gs^Fmw      , Gs^Fp       , Re          , Re          , Re          , Re          , Gg          , Gs^Fmw      , Gg          , Gg          , Gs^Fp       , Gg          , Gg          , Gg          , Gg          , Gg          , Gs^Fmw      , Gg          , Gs^Fp       , Gs^Fmw      , Gs^Fp       , Re          , Hh          , Hh          , Mm          , Gg^Vh       , Mm          , Mm          , Mm          , Mm          , Mm          , Mm          , Hh          , Mm          , Mm          , Hh          , Aa^Fda      
Gs^Fp       , Gs^Fmw      , Gs^Fp       , Gs^Fmw      , Gs^Fmw      , Gs^Fmw      , Re          , Re          , Gs^Fp       , Gs^Fmw      , Gs^Fmw      , Re          , Re          , Re          , Re          , Re          , Re          , Gs^Fp       , Gg^Vh       , Gs^Fmw      , Gs^Fp       , Gg          , Gg          , Gs^Fp       , Gs^Fp       , Re^Vct      , Ce          , Re^Vct      , Hh          , Hh          , Gs^Fp       , Mm          , Mm          , Mm          , Hh          , Mm          , Mm          , Mm          , Mm          , Hh          , Mm          , Hh          
Gs^Fp       , Gg          , Gg^Vh       , Gs^Fmw      , Re          , Re          , Re          , Gs^Fmw      , Gs^Fp       , Gs^Fp       , Gs^Fmw      , Gs^Fmw      , Gs^Fp       , Gs^Fp       , Gg          , Gs^Fmw      , Gg          , Gs^Fp       , Gs^Fmw      , Gs^Fp       , Gs^Fmw      , Gg          , Gg          , Gg          , Re^Vct      , Ce          , 2 Ke        , Ce          , Re^Vct      , Hh          , Hh          , Gs^Fp       , Gs^Fp       , Hh          , Gs^Fp       , Gs^Fp       , Gs^Fp       , Mm          , Mm          , Mm          , Gs^Fp       , Gs^Fp       
Gs^Fmw      , Gs^Fp       , Gg          , Gg          , Gs^Fmw      , Gs^Fmw      , Gs^Fp       , Re          , Gs^Fp       , Gs^Fmw      , Gg          , Gs^Fp       , Gg          , Gs^Fmw      , Gs^Fp       , Gg          , Gg          , Gs^Fmw      , Gs^Fmw      , Gg          , Gg          , Gs^Fp       , Gg          , Gg          , Gs^Fp       , Ce          , Ce          , Ce          , Hh          , Hh          , Hh          , Gs^Fp       , Hh          , Gs^Fp       , Gs^Fp       , Gs^Fp       , Mm          , Mm          , Mm          , Gs^Fp       , Gs^Fp       , Gs^Fp       
Gg          , Gg          , Gs^Fp       , Gs^Fmw      , Gg          , Gs^Fmw      , Gg^Vh       , Gs^Fp       , Gs^Fmw      , Gg          , Gs^Fmw      , Gs^Fp       , Gs^Fp       , Gg          , Gg          , Gg          , Gs^Fp       , Gs^Fp       , Gs^Fmw      , Gg          , Gg          , Gs^Fmw      , Gs^Fp       , Gs^Fp       , Gs^Fp       , Re^Vct      , Re          , Re^Vct      , Hh          , Hh          , Gs^Fp       , Gs^Fp       , Gs^Fp       , Hh          , Gs^Fp       , Hh          , Hh          , Mm          , Mm          , Mm          , Mm          , Mm          
Gg          , Gs^Fmw      , Gs^Fp       , Gs^Fp       , Gs^Fp       , Gs^Fmw      , Gg          , Gg          , Gg          , Gs^Fp       , Gg          , Gg          , Gs^Fmw      , Gg          , Gs^Fp       , Gs^Fmw      , Gs^Fp       , Gs^Fmw      , Gs^Fp       , Gs^Fmw      , Gs^Fp       , Gs^Fp       , Gg^Vh       , Re^Vct      , Re          , Gs^Fp       , Re          , Hh          , Gg^Vh       , Gs^Fp       , Gs^Fp       , Gs^Fp       , Gs^Fp       , Hh          , Hh          , Hh          , Hh          , Mm          , Mm          , Hh          , Mm          , Mm          
Gs^Fp       , Gs^Fp       , Gs^Fp       , Gs^Fmw      , Gs^Fp       , Gs^Fp       , Gs^Fp       , Gs^Fp       , Gs^Fp       , Gs^Fp       , Gs^Fp       , Gs^Fp       , Gs^Fp       , Gs^Fp       , Gs^Fmw      , Gs^Fp       , Gs^Fmw      , Gs^Fp       , Gg          , Gg          , Gg          , Gg          , Gs^Fp       , Re^Vct      , Gs^Fp       , Re          , Gs^Fp       , Re          , Re^Vct      , Gs^Fp       , Hh          , Gs^Fp       , Hh          , Gs^Fp       , Hh          , Hh          , Gs^Fp       , Hh          , Hh          , Mm          , Gs^Fp       , Gs^Fp       
Gs^Fp       , Gs^Fp       , Gs^Fp       , Gs^Fp       , Gs^Fp       , Gs^Fp       , Gs^Fp       , Gs^Fp       , Gs^Fp       , Gs^Fp       , Gs^Fp       , Gs^Fp       , Gs^Fp       , Gs^Fp       , Ss          , Gs^Fp       , Gs^Fp       , Gg          , Gs^Fp       , Gs^Fp       , Gs^Fp       , Gs^Fp       , Gs^Fp       , Gs^Fp       , Gs^Fp       , Re          , Gs^Fp       , Gs^Fp       , Gs^Fp       , Gs^Fp       , Gs^Fp       , Gs^Fp       , Gs^Fp       , Hh          , Hh          , Gs^Fp       , Gs^Fp       , Hh          , Gs^Fp       , Gs^Fp       , Gs^Fp       , Gs^Fp       
