Mm          , Hh          , Hh          , Gs^Fp       , Gs^Fp       , Gs^Fp       , Gs^Fp       , Gs^Fp       , Rd          , Gs          , Gg          , Gg          , Ww          , Ww          , Ds          , Ds          , Gg          , Gg          , Gg          , Gs          , Gs          , Gs          , Re          , Gs          , Gs          , Gs          , Gs          , Gs          , Gs          , Gs^Fp       , Hh          , Mm          , Mm          , Mm          , Hh          , Mm          , Hh          
Hh          , Hh          , Gs^Fp       , Gs^Fp       , Gs^Fp       , Gs          , Gs          , Gs          , Rd          , Gs          , Gg          , Gg          , Ww          , Ww          , Ww          , Ww          , Gg          , Gg          , Gg          , Gg          , Gs          , Gs          , Re          , Re          , Gs          , Re          , Gs          , Gs          , Hh          , Hh          , Hh          , Hh          , Mm          , Mm          , Mm          , Hh          , Hh          
Gs^Fp       , Gs^Fp       , Gs^Fp       , Gs^Fp       , Gs^Fp       , Gg          , Gs^Fp       , Gs          , Rd          , Gs          , Gs          , Gs          , Gs^Fp       , Gs^Fp       , Ww          , Ww          , Ww          , Ww          , Gg          , Gg          , Gg          , Gg          , Gs          , Gg          , Re          , Gg          , Re          , Gs          , Gs^Fp       , Hh          , Gs^Fp       , Gs^Fp       , Hh          , Mm          , Gs          , Gs          , Hh          
Gs^Fp       , Gs^Fp       , Gs^Fp       , Ss          , Ss          , Gg          , Gs^Fp       , Gs^Fp       , Rd          , Hh          , Gs^Fp       , Gs^Fp       , Gs          , Gs^Fp       , Gs^Fp       , Ds          , Ww          , Ww          , Ds          , Gg          , Gg          , Gg          , Gs^Fp       , Gs^Fp       , Gg          , Gg          , Re          , Gs          , Gs^Fp       , Gs          , Gs          , Gs          , Gs^Fp       , Hh          , Hh          , Gs          , Hh          
Gs^Fp       , Gs^Fp       , Ss          , Gs^Fp       , Ss          , Gg          , Gg          , Gg          , Rd          , Rd          , Gg^Vh       , Gg          , Gs          , Gs          , Gs          , Gs^Fp       , Ww          , Ww          , Ds          , Gg          , Gs          , Gs          , Gs^Fp       , Gs^Fp       , Hh          , Hh          , Re          , Re          , Gs          , Gs          , Gs          , Gs          , Gs^Fp       , Gs^Fp       , Gs^Fp       , Gs          , Gs          
Ss          , Ss          , Ss          , Ss          , Gs^Fp       , Ss          , Ss          , Gs^Fp       , Gs^Fp       , Gs          , Rd          , Gg          , Gs^Fp       , Gs^Fp       , Gs          , Gs^Fp       , Ww          , Ww          , Ds          , Gs          , Gs          , Gg^Vh       , Gs          , Gs^Fp       , Hh          , Gs^Fp       , Gs          , Gs          , Re          , Gs          , Gs          , Gs          , Gs          , Gs          , Gs          , Rr          , Rr          
Ss          , Ww          , Ss          , Ww          , Ss          , Ss          , Gs^Fp       , Gs^Fp       , Gs          , Gs^Fp       , Rd          , Gs          , Gs^Fp       , Gs          , Gs          , Gs          , Ww          , Ww          , Ww          , Ds          , Gs          , Gs          , Gs          , Gs^Fp       , Gs^Fp       , Gs          , Gs          , Re          , Re          , Gs          , Gs          , Gs          , Gs          , Rr          , Rr          , Re          , Re          
Ss          , Ww          , Ww          , Ww          , Ww          , Ww          , Ss          , Ss          , Gs^Fp       , Gs^Fp       , Rd          , Rd          , Gs          , Gs          , Gs^Fp       , Gs          , Gs          , Ww          , Ww          , Ds          , Gs          , Gs          , Gs          , Gs          , Gs          , Gs          , Gs          , Re          , Gs          , Re          , Gs          , Gs          , Gg^Vh       , Rr          , Gs          , Gs          , Re          
Ss          , Ss          , Ww          , Ss          , Ww          , Ss          , Ss          , Ss          , Hh          , Gs^Fp       , Gs^Fp       , Gs          , Rd          , Gs          , Gs          , Ww          , Ww          , Ww          , Ww          , Gs          , Gs          , Re          , Re          , Re          , Gs          , Gs          , Gs          , Gs          , Re          , Gs          , Re          , Rr          , Rr          , Gs          , Gs          , Gs          , Gs          
Gs^Fp       , Gs^Fp       , Ss          , Ss          , Ss          , Ss          , Ss          , Ss          , Gs^Fp       , Gs^Fp       , Gg^Vh       , Gs^Fp       , Rd          , Rd          , Gs          , Ww          , Ww          , Ww          , Ds          , Gs          , Re          , Re          , Re          , Re          , Re          , Gs          , Gs          , Gs          , Gs          , Gs          , Gs          , Rr          , Gs          , Gs^Fp       , Gs          , Gs          , Gs          
Re          , Re          , Hh          , Gs^Fp       , Ss          , Hh          , Hh          , Hh          , Hh          , Hh          , Gs^Fp       , Gs^Fp       , Gs^Fp       , Rd          , Gs          , Ds          , Ww          , Ww          , Ww          , Ds          , Gs          , Gs          , Re          , Gs          , Gs          , Gg^Vh       , Gs          , Rr          , Gs          , Rr          , Rr          , Gs^Fp       , Gs          , Gs          , Gs          , Gs          , Gs          
Gs^Fp       , Re          , Gs^Fp       , Gs^Fp       , Hh          , Gs^Fp       , Hh          , Hh          , Mm          , Hh          , Hh          , Gs^Fp       , Gg          , Rd          , Gs^Fp       , Gg^Vh       , Ds          , Ww          , Ww          , Ww          , Gs          , Ch          , Gs          , Rr          , Rr          , Rr          , Rr          , Gs          , Rr          , Gs          , Gs          , Gs^Fp       , Gs^Fp       , Gs^Fp       , Gs^Fp       , Gs          , Gs^Fp       
Gs^Fp       , Re          , Gs^Fp       , Gs^Fp       , Gs^Fp       , Gs^Fp       , Hh          , Gs^Fp       , Hh          , Gs^Fp       , Gs^Fp       , Gs^Fp       , Gs^Fp       , Gs          , Rd          , Rd          , Gs          , Gs          , Ww          , Ww          , Ww          , Ww^Bw/      , Rr          , Gs          , Gs          , Gs          , Gs          , Rd          , Rd          , Gg^Vh       , Gs          , Gs^Fp       , Gs^Fp       , Gs^Fp       , Gs          , Gs^Fp       , Gs^Fp       
Gs^Fp       , Gs^Fp       , Re          , Re          , Gs^Fp       , Hh          , Hh          , Hh          , Gs^Fp       , Gs^Fp       , Hh          , Hh          , Gs          , Gs          , Gs          , Gg^Vh       , Rd          , Rd          , Ch          , Rr          , Ww^Bw/      , Ww          , Ww          , Ww          , Gs          , Gs          , Gs          , Rd          , Gs          , Gs          , Gs          , Gs          , Gs^Fp       , Gs^Fp       , Gs^Fp       , Gs^Fp       , Gs^Fp       
Gs^Fp       , Gs^Fp       , Gs^Fp       , Re          , 2 Gs^Fp     , Gg^Fet      , Gs^Fp       , Gs^Fp       , Gs^Fp       , Gs^Fp       , Gs^Fp       , Hh          , Gg^Vh       , Gs          , Gs          , Gg          , Ch          , Gg^Vh       , Rr          , Rr          , Rr          , Ch          , Ww          , Wo          , Ww          , Gs          , Gs          , Rd          , Gs          , Gs          , Gs          , Gs^Fp       , Gs          , Gs^Fp       , Gs          , Gs          , Gs          
Gs^Fp       , Gs^Fp       , Gs^Fp       , Re          , Gs^Fp       , Gs^Fp       , Gs^Fp       , Gs^Fp       , Gs^Fp       , Gs^Fp       , Gs          , Gs          , Hh          , Re          , Gs          , Gs          , Ch          , Rr          , Rr          , Rr          , Ch          , 1 Kh        , Ww^Bw\      , Wo          , Ww          , Gs          , Rd          , Gs          , Gs          , Gs          , Gs          , Hh          , Hh          , Mm          , Gs          , Hh          , Gs^Fp       
Gs^Fp       , Gs^Fp       , Gs^Fp       , Gs^Fp       , Re          , Gs^Fp       , Gs^Fp       , Gs^Fp       , Gs^Fp       , Gs          , Gs^Fp       , Re          , Re          , Re          , Re          , Gg^Vh       , Ch          , Rr          , Rr          , Rr          , Ch          , Ch          , Ww^Bw\      , Wo          , Ww          , Ds          , Rd          , Gg^Vh       , Gs          , Gs^Fp       , Gs^Fp       , Gs          , Mm          , Mm          , Mm          , Mm          , Hh          
Gs^Fp       , Gs^Fp       , Gs^Fp       , Re          , Re          , Gs^Fp       , Gs^Fp       , Gs^Fp       , Gs^Fp       , Gs^Fp       , Gs          , Gs          , Re          , Gs          , Gs          , Rr          , Rr          , Ch          , Rr          , Gg^Vh       , Rr          , Rr          , Ww^Bw\      , Wo          , Ww          , Rd          , Rd          , Hh          , Gs          , Hh          , Hh          , Mm          , Mm          , Mm          , Mm          , Mm          , Hh          
Gs^Fp       , Gs^Fp       , Re          , Gs^Fp       , Gs^Fp       , Gs^Fp       , Gs          , Gs^Fp       , Gs^Fp       , Gs          , Gs          , Gs^Fp       , Gs          , Rr          , Rr          , Ce          , Rd          , Rd          , Ch          , Ch          , Rr          , Ww          , Ww          , Ww          , Ww          , Rd          , Hh          , Gs          , Hh          , Gs          , Mm          , Mm          , Mm          , Mm          , Mm          , Mm          , Gs^Fp       
Gs^Fp       , Gs^Fp       , Re          , Gs^Fp       , Gs^Fp       , Gs          , Gs^Fp       , Gs          , Gs          , Gs          , Gs          , Gg^Vh       , Gs          , Rr          , Ce          , Gg          , Rd          , Rd          , Rd          , Gs^Fp       , Ww          , Ww          , Wo          , Ww^Bw/      , Gg          , Rd          , Gg^Vh       , Gs          , Hh          , Gs          , Mm          , Hh          , Hh          , Gs^Fp       , Hh          , Hh          , Hh          
Gs^Fp       , Gs^Fp       , Re          , Re          , Gs^Fp       , Re          , Gg^Vh       , Gs^Fp       , Gs^Fp       , Rd          , Gs^Fp       , Rd          , Gs^Fp       , Rr          , Ce          , Gg^Vh       , Rd          , Rd          , Rd          , Gg          , Gs^Fp       , Ww          , Wo          , Ww          , Gg          , Gg          , Rd          , Gg          , Gs          , Gs          , Hh          , Gs^Fp       , Hh          , Hh          , Gs^Fp       , Ww          , Ww          
Gs^Fp       , Gs^Fp       , Gs^Fp       , Gs^Fp       , Re          , Gs^Fp       , Rd          , Rd          , Rd          , Gs^Fp       , Rd          , Gs^Fp       , Rr          , Gg          , Gg          , Gg          , Rd          , Rd          , Gg^Vh       , Ww^Bw\      , Ww^Bw\      , Wo          , Wo          , Ww          , Gg          , Ww          , Rd          , Ww          , Gg          , Hh          , Hh          , Gs^Fp       , Gs^Fp       , Hh          , Gs^Fp       , Ww          , Aa^Fpa      
Gs^Fp       , Gs^Fp       , Gs^Fp       , Gs^Fp       , Gs          , Gs^Fp       , Gg          , Gg          , Gg          , Gg          , Gg          , Gg          , Gg          , Ww          , Ww          , Ww          , Gs^Fp       , Gg^Vh       , Gg          , Ww^Bw\      , Wo          , Wo          , Wo          , Wo          , Ww          , Ds          , Ww^Bw|      , Ds          , Ww          , Ww          , Gs^Fp       , Gs^Fp       , Aa^Fpa      , Ww          , Ww          , Aa^Fpa      , Gs^Fp       
Gs^Fp       , Gs^Fp       , Gs^Fp       , Gs^Fp       , Gs^Fp       , Gg          , Gg          , Ww          , Ww          , Ww          , Gg          , Ww          , Ww          , Ww          , Ww          , Ww          , Ww          , Ww          , Ww          , Wo          , Wo          , Wo          , Wo          , Ww          , Ww          , Rd          , Rd          , Gg          , Gg          , Ww          , Aa^Fpa      , Aa^Fpa      , Aa^Fpa      , Ww          , Gs^Fp       , Gs^Fp       , Aa^Fpa      
Gs^Fp       , Gs^Fp       , Gs^Fp       , Ww          , Gs^Fp       , Ww          , Gs^Fp       , Ww          , Ww          , Ww          , Ww          , Ww          , Ww          , Ww          , Ww          , Ai          , Ww          , Ai          , Ai          , Ai          , Ww          , Ww          , Ww          , Gg^Vh       , Rd          , Gs          , Gs          , Gs          , Gg          , Aa^Fpa      , Ww          , Ww          , Ww          , Gs^Fp       , Aa^Fpa      , Aa^Fpa      , Gs^Fp       
Gs^Fp       , Ww          , Ww          , Ww          , Ww          , Ww          , Ww          , Ww          , Ww          , Ww          , Gs^Fp       , Ww          , Ww          , Wo          , Wo          , Ai          , Gg          , Gs          , Gs          , Gs          , Gg          , Gg          , Gg          , Rd          , Rd          , Gs          , Gs          , Gs          , Hh          , Hh          , Aa^Fpa      , Aa^Fpa      , Gs^Fp       , Aa^Fpa      , Aa^Fpa      , Hh          , Aa^Fpa      
Ww          , Ww          , Ww          , Gs^Fp       , Ww          , Hh          , Ww          , Gs^Fp       , Ww          , Ww          , Ww          , Ww          , Ww          , Ai          , Ai          , Gs          , Gs          , Gs          , Gs          , Aa          , Gs          , Rd          , Rd          , Gs          , Gs          , Gs          , Gs          , Gs          , Hh          , Hh          , Aa^Fpa      , Aa^Fpa      , Hh          , Gs^Fp       , Aa^Fpa      , Hh          , Gg^Ve       
Ww          , Gs^Fp       , Gs^Fp       , Gs^Fp       , Gs^Fp       , Hh          , Hh          , Hh          , Gs^Fp       , Hh          , Ww          , Ai          , Ai          , Aa          , Aa          , Gs          , Gg          , Re          , Re          , Aa          , Rd          , Aa^Vha      , Aa          , Aa          , Gs          , Gs          , Gs          , Hh          , Hh          , Wo          , Mm          , Mm          , Hh          , Hh          , Hh          , Ai          , Aa^Fpa      
Gs^Fp       , Gs^Fp       , Gs^Fp       , Gs^Fp       , Gs          , Gs^Fp       , Hh          , Hh          , Hh          , Gg          , Gg          , Ai          , Aa          , Aa^Vha      , Re          , Gs          , Gs          , Gs          , Aa          , Aa^Fpa      , Rd          , Gs^Fp       , Aa          , Gs          , Gs          , Gs          , Gs          , Hh          , Mm          , Mm          , Hh          , Mm          , Hh          , Mm          , Hh          , Ha          , Aa^Fpa      
Hh          , Gs^Fp       , Gs^Fp       , Gs^Fp       , Gs^Fp       , Gs^Fp       , Hh          , Gs          , Hh          , Hh          , Gg          , Ww          , Gg          , Aa          , Aa          , Gs          , Gs          , Aa^Fpa      , Hh          , Ha          , Rd          , Gs^Fp       , Aa          , Gs          , Gs          , Hh          , Hh          , Aa^Fpa      , Mm          , Hh          , Mm          , Mm          , Mm          , Ha          , Mm          , Ha          , Hh          
Gs^Fp       , Gs^Fp       , Gs^Fp       , Gs^Fp       , Gs          , Gs^Fp       , Gs^Fp       , Gs          , Gs^Fp       , Hh          , Gg          , Gg          , Ai          , Gg          , Aa          , Gs          , Gs          , Aa^Fpa      , Ha          , Aa^Fpa      , Rd          , Gs          , Gs          , Gs          , Gg^Vh       , Hh          , Aa^Fpa      , Ai          , Aa^Fpa      , Gs^Fp       , Hh          , Mm          , Mm          , Mm          , Ha          , Ha          , Mm          
Gs          , Gs          , Gs^Fp       , Gs^Fp       , Gs^Fp       , Gs^Fp       , Gs^Fp       , Gs^Fp       , Gs          , Gs          , Gs          , Aa          , Ss          , Ai          , Gs          , Re          , Re          , Aa          , Aa^Fpa      , Aa^Fpa      , Rd          , Gg^Vh       , Gs          , Gs          , Gs          , Gs          , Ai          , Hh          , Hh          , Gs^Fp       , Hh          , Mm          , Wo          , Mm          , Mm          , Ha          , Ha          
Gs^Fp       , Gs^Fp       , Re          , Re          , Gs          , Gg          , Gs          , Gs          , Gs^Fp       , Gs^Fp       , Aa          , Aa          , Aa          , Re          , Ai          , Gs          , Aa          , Gs          , Aa          , Gs          , Rd          , Rd          , Aa^Fpa      , Ha          , Hh          , Hh          , Hh          , Ha          , Ai          , Mm          , Mm          , Mm          , Mm          , Ha          , Ha          , Ha          , Ha          
Gs^Fp       , Gs^Fp       , Gs^Fp       , Ss          , Gs^Fp       , Ss          , Gs^Fp       , Gs^Fp       , Re          , Re          , Aa          , Re          , Re          , Ai          , Ai          , Gs          , Gs          , Gs          , Gs          , Gs          , Gs          , Rd          , Aa^Fpa      , Ha          , Aa^Fpa      , Gs^Fp       , Ha          , Ha          , Hh          , Hh          , Mm          , Mm          , Ha          , Aa^Fpa      , Gs^Fp       , Ha          , Gs^Fp       
Gs^Fp       , Gs^Fp       , Gs^Fp       , Gs^Fp       , Ss          , Gs^Fp       , Gs^Fp       , Gs^Fp       , Gs^Fp       , Gs^Fp       , Re          , Aa^Vha      , Aa          , Ss          , Gg          , Gg          , Gs^Fp       , Hh          , Gs^Fp       , Gs          , Gs          , Rd          , Aa^Fpa      , Aa^Fpa      , Aa^Fpa      , Hh          , Ha          , Hh          , Mm          , Mm          , Mm          , Mm          , Hh          , Hh          , Aa^Fpa      , Aa^Fpa      , Aa^Fpa      
Gg          , Ss          , Ss          , Ss          , Ss          , Gs^Fp       , Gs          , Gs^Fp       , Gs          , Gs          , Gs          , Gs          , Gg          , Ai          , Gg          , Ww          , Gs^Fp       , Gs^Fp       , Gs^Fp       , Gs^Fp       , Aa          , Rd          , Gs          , Gs          , Aa          , Gs          , Gs          , Gs          , Aa          , Aa          , Aa          , Gs          , Aa          , Gs          , Aa          , Gs          , Aa          
Gs^Fp       , Ss          , Ss          , Ss^Vhs      , Gg          , Gs^Fp       , Gs^Fp       , Gs^Fp       , Gs^Fp       , Gs^Fp       , Aa          , Aa          , Gs          , Gs          , Ai          , Aa          , Ai          , Ai          , Gs^Fp       , Gs          , Rd          , Aa          , Gs          , Gs^Fp       , Gs          , Hh          , Aa          , Gs          , Gs          , Gs          , Gs          , Aa^Fpa      , Gs          , Gs          , Gs          , Gs          , Gs          
