border_size=1
usage=map

Ww          ,Ww          , Ww          , Ww          , Ww       , Ww          , Xu          , Uu^Uf       , Uh          , Wwf         , Rd          , Rd          , Rd          , Xu          , Uu^Uf       , Uu          , Rd          , Uu       , Xu          , Xu          , Rd          , Gs          , Hh          , Gs          , Mm          , Gs          , Gs          , Hh      , Rd          , Rd          , Gs^Fp      , Gs          , Gs          , Gs^Fp       , Gs          , Rd          , Gs          , Gs          , Ch          , Ch          , 1 Ch        , Gs          , Gs          
Ww          ,Ww          , Ww          , Ww          , Ww^Vm       , Ww          , Xu          , Uu^Uf       , Uh          , Wwf         , Rd          , Rd          , Rd          , Xu          , Uu^Uf       , Uu          , Rd          , Uu^Vu       , Xu          , Xu          , Rd          , Gs          , Hh          , Gs          , Mm          , Gs          , Gs          , Hh^Vhh      , Rd          , Rd          , Gg^Fet      , Gs          , Gs          , Gs^Fp       , Gs          , Rd          , Gs          , Gs          , Ch          , Ch          , 1 Kh        , Gs          , Gs          
Uu^Uf       ,Uu^Uf       , Uu^Uf       , Ww          , Ww          , Wwf         , Wwf         , Uh          , Rd          , Rr          , Rd          , Xu          , Uu^Vu       , Rd          , Rr          , Rr          , Xu          , Rd          , Rd          , Gs          , Rd          , Mm          , Gs          , Gg^Fet      , Hh          , Hh          , Gs          , Gs          , Gs          , Gs^Fp       , Wwf         , Wwf         , Wwf         , Wwf         , Wwf         , Wwf         , Wwf         , Ch          , Wwf         , Ch          , Ch          , Wwf         , Wwf         
Xu          ,Xu          , Ww          , Ww          , Rd          , Rd          , Xu          , Rd          , Xu          , Xu          , Rd          , Xu          , Xu          , Uu          , Rd          , Xu          , Gs          , Gs          , Gs          , Rd          , Rr          , Rd          , Rr          , Gs          , Gg^Ve       , Gs          , Gs^Fp       , Gs          , Wwf         , Wwf         , Ww          , Ww          , Ww          , Ww          , Ww          , Ww^Vm       , Wwf         , Wwf         , Ch          , Ch          , Rr          , Gs          , Gs          
Uu^Uf       ,Uu^Uf       , Ww          , Xu          , Uh          , Xu          , Xu          , Uu^Uf       , Xu          , Gs          , Gs^Fp       , Gs          , Gs          , Xu          , Rr          , Gs          , Rr          , Rr          , Rr          , Rr          , Gs          , Rr          , Gs          , Rr          , Rr          , Gs          , Gs          , Wwf         , Ww          , Ww          , Wo          , Wo          , Wo          , Wo          , Ww          , Wwf         , Gs^Fp       , Gs          , Gs          , Rr          , Gs          , Gs          , Gs          
Wwf         ,Wwf         , Wwf         , Xu          , Wwf         , Rr          , Rr          , Rr          , Rr          , Rr          , Rr          , Hh          , Rr          , Rr          , Wwf         , Rr          , Wwf         , Wwf         , Wwf         , Gs          , Gs          , Gs          , Gs          , Gs          , Gs^Fp       , Rr          , Ww^Bw\      , Wwf         , Ww          , Wo          , Ww          , Ww          , Ww          , Ww          , Wwf         , Wwf         , Gs          , Gs          , Rr          , Rr          , Gs^Fp       , Gs^Fp       , Gs^Fp       
Wwf         ,Wwf         , Rr          , Rr          , Rr          , Rr          , Wwf         , Gs^Fp       , Wwf         , Wwf         , Wwf         , Rr          , Rr          , Wwf         , Gs          , Wwf         , Hh          , Gs^Fp       , Rd          , Wwf         , Wwf         , Wwf         , Wwf         , Gs          , Wwf         , Gs          , Wwf         , Ww^Bw\      , Ww^Bw\      , Wo          , Ww          , Wwf         , Gs          , Wwf         , Gs          , Gs          , Ss^Vhs      , Rd          , Mm          , Hh          , Mm          , Hh          , Hh          
Ww          ,Ww          , Wwf         , Wwf         , Wwf         , Wwf         , Gs^Fp       , Wwf         , Gg^Ve       , Gs^Fp       , Gs          , Wwf         , Wwf         , Wwf         , Gg^Fet      , Gs          , Gs          , Gs          , Rd          , Gs          , Ce          , Ce          , Ce          , Wwf         , Rd          , Wwf         , Ww          , Ww          , Wo          , Ww^Bw\      , Ww^Bw\      , Wwf         , Gs          , Gs          , Gs          , Ss          , Gg^Fet      , Rr          , Gg^Fet      , Mm          , Mm          , Gs^Fp       , Gs^Fp       
Ww          ,Ww          , Ww          , Ww          , Xu          , Rd          , Rd          , Gs          , Hh          , Gs          , Rd          , Gs          , Rd          , Hh          , Mm          , Gs          , Gs          , Rd          , Gs          , Gs          , Rd          , Ke          , Rd          , Rd          , Gs          , Wwf         , Ww          , Ww          , Ww          , Ww          , Wwf         , Rr          , Rr          , Rr          , Rr          , Gg^Fet      , Rr          , Rr          , Gs^Fp       , Gs          , Gs          , Gs          , Gs          
Ww          ,Ww          , Xu          , Uu^Uf       , Xu          , Gs^Fp       , Gs          , Mm          , Gs          , Hh          , Gs^Fp       , Gs          , Gs^Fp       , Gs          , Gs          , Gs          , Rd          , Rd          , Gs^Fp       , Gs          , Rd          , Gs          , Gs          , Gs^Fp       , Gs          , Wwf         , Wwf         , Wwf         , Gs          , Ww          , Wwf         , Gs          , Gs          , Gs^Fp       , Rd          , Rr          , Gs          , Rr          , Rr          , Gs          , Rd          , Rd          , Rd          
Ww          ,Ww          , Uu^Uf       , Xu          , Gs          , Gs^Fp       , Rd          , Gs          , Gs^Fp       , Gs          , Ss          , Gs          , Hh          , Gs          , Gs          , Rd          , Gs          , Gg^Fet      , Gs          , Hh          , Gs          , Gs          , Gs^Fp       , Hh          , Gs          , Gs          , Wwf         , Gs          , Gs^Fp       , Ww          , Wwf         , Gs          , Gs          , Gs          , Gs          , Rd          , Gs^Fp       , Gs          , Rr          , Gs^Fp       , Ss          , Ss          , Ss          
Ww          ,Ww          , Ww          , Xu          , Rd          , Gs          , Hh          , Gs          , Gs          , Gg^Fet      , Mm          , Gs          , Mm          , Ss          , Gg^Ve       , Rd          , Gs          , Gs          , Ss          , Ss          , Rd          , Gs          , Gs          , Gs          , Wwf         , Wwf         , Ww          , Gs          , Gs          , Gs          , Ww          , Wwf         , Wwf         , Wwf         , Wwf         , Gs          , Gs          , Gs^Fp       , Rr          , Gs          , Rd          , Gs          , Gs          
Ww          ,Ww          , Wwf         , Mm          , Gs^Fp       , Rr          , Gg^Fet      , Gs          , Mm          , Mm          , Mm          , Hh          , Gg^Fet      , Hh          , Gs^Fp       , Rd          , Gs          , Hh          , Gs^Fp       , Rd          , Gs          , Gg^Ve       , Wwf         , Wwf         , Ww          , Ww          , Wo          , Ww          , Ww          , Ww^Vm       , Wwf         , Ww          , Ww          , Ww          , Wwf         , Gs          , Gs          , Rr          , Mm          , Gs          , Gg^Ve       , Gs          , Gs          
Rd          ,Rd          , Rr          , Rd          , Rd          , Ss          , Rd          , Gs          , Gs          , Gs          , Gs^Fp       , Mm          , Gs^Fp       , Gs          , Rd          , Rd          , Gs          , Gs          , Hh          , Ss          , Gs          , Gs          , Wwf         , Ww          , Wo          , Wo          , Ww          , Ww          , Gs          , Gs          , Gs          , Wwf         , Wwf         , Wwf         , Gs          , Gs          , Gs          , Rr          , Hh          , Gs          , Gs          , Gs          , Gs          
Wwf         ,Wwf         , Ww^Bw|      , Rr          , Hh          , Hh          , Gs          , Gs          , Ss          , Ss          , Gs          , Gs          , Rd          , Rd          , Gs^Fp       , Rd          , Gs          , Gg^Fet      , Rd          , Gs          , Wwf         , Ww^Bw\      , Ww^Bw\      , Ww          , Wo          , Wo          , Ww          , Gs^Fp       , Ww          , Gs^Fp       , Gs^Fp       , Gs          , Gs          , Gs^Fp       , Gs          , Gs          , Rr          , Rr          , Mm          , Gg^Fet      , Gs          , Mm          , Mm          
Ww          ,Ww          , Rd          , Wwf         , Ww          , Gs^Fp       , Gs          , Mm          , Hh          , Ss          , Gs          , Rd          , Gs          , Gs          , Gs          , Rd          , Gs          , Gg^Fet      , Gg^Fet      , Gs          , Wwf         , Ww          , Wo          , Ww^Bw\      , Ww^Bw\      , Ww          , Wwf         , Ww          , Wwf         , Ww          , Wwf         , Ww          , Ww          , Gs          , Ww^Bw/      , Rr          , Gs          , Gs          , Ss          , Hh          , Gs          , Gs          , Gs          
Uu^Uf       ,Uu^Uf       , Rd          , Wwf         , Wwf         , Ww          , Ww          , Gs          , Gs^Fp       , Gs          , Rd          , Rd          , Gs          , Ss          , Gs          , Rd          , Rd          , Gs          , Gs          , Gs          , Ww          , Ww          , Ww^Vm       , Ww          , Wwf         , Ww^Bw\      , Gs          , Wwf         , Ke          , Wwf         , Ce          , Wwf         , Ww^Bw/      , Ww^Bw/      , Ww          , Gs          , Gs          , Gs^Fp       , Ss          , Ss^Vhs      , Gs          , Gs^Fp       , Gs^Fp       
Uh          ,Uh          , Uu^Vu       , Rr          , Xu          , Wwf         , Ww          , Gs          , Gs          , Rd          , Rd          , Gs          , Gs^Fp       , Gg^Fet      , Hh          , Gs          , Gs          , Rd          , Rd          , Gs          , Ww          , Ww          , Ww          , Ww          , Wwf         , Gs          , Gs^Fp       , Gs          , Ce          , Ce          , Rr          , Ww^Bw/      , Gs          , Wwf         , Wwf         , Ww          , Gs          , Ss          , Rd          , Gs^Fp       , Gs          , Gs          , Gs          
Ww          ,Ww          , Uu^Uf       , Xu          , Xu          , Gs          , Gs          , Ww          , Gs          , Gs          , Rd          , Gs          , Ss          , Ss          , Gs          , Gs^Fp       , Gs          , Gs          , Ww          , Ww^Bw\      , Ww^Bw\      , Ww          , Wwf         , Wwf         , Gs          , Gs          , Gs          , Gs          , Rr          , Rr          , Gs          , Gs          , Gs          , Gs          , Wwf         , Ww          , Gs^Fp       , Gg^Fet      , Hh          , Gs          , Gs          , Mm          , Mm          
Ww          ,Ww          , Ww          , Xu          , Xu          , Gs          , Ww          , Ww          , Gs          , Rd          , Gs          , Gg^Vh       , Gs          , Rd          , Gs          , Gs          , Wwf         , Gs          , Ww          , Ww          , Gs          , Gs          , Gs          , Gs          , Gg^Ve       , Gs^Fp       , Rr          , Rr          , Mm          , Mm          , Gs^Fp       , Gg^Vh       , Gs          , Gs          , Wwf         , Ww          , Mm          , Mm          , Mm          , Gg^Fet      , Hh          , Rd          , Rd          
Wwf         ,Wwf         , Uu^Uf       , Wwf         , Uh          , Gs          , Ww          , Gs          , Rd          , Rd          , Rd          , Gs^Fp       , Hh          , Gs          , Ww          , Wwf         , Gs          , Wwf         , Gs          , Gs          , Hh          , Hh          , Gs          , Gs          , Gs          , Rr          , Gs^Fp       , Mm          , Hh          , Mm          , Gs          , Gs          , Gs          , Gs^Fp       , Wwf         , Wwf         , Gs          , Gs^Fp       , Rd          , Mm          , Mm          , Gs          , Gs          
Rr          ,Rr          , Uh          , Xu          , Gs          , Wwf         , Ww^Bw/      , Rd          , Gs          , Gs          , Rd          , Gs^Fp       , Gs          , Gs          , Ww          , Wwf         , Gs          , Gs          , Gs          , Gs^Fp       , Gs          , Mm          , Rr          , Rr          , Rr          , Rr          , Gs^Fp       , Mm          , Gs^Fp       , Hh          , Gs          , Gs          , Ww^Vm       , Wwf         , Ww          , Ww          , Gs          , Gg^Ve       , Gs          , Gs          , Ss          , Gs          , Gs          
Rd          ,Rd          , Rd          , Rr          , Rd          , Ww^Bw/      , Ww          , Gs          , Gs          , Gs^Fp       , Rd          , Gs          , Gg^Ve       , Ww          , Gs          , Gs          , Hh          , Gs          , Gs          , Gs          , Rr          , Rr          , Gs^Fp       , Hh          , Gs          , Gs          , Ss^Vhs      , Ss          , Mm          , Gs^Fp       , Gs          , Gs          , Gs          , Ww          , Ww          , Ww          , Gs          , Hh          , Gg^Fet      , Ss          , Gs          , Gs          , Gs          
Rr          ,Rr          , Rd          , Rd          , Rr          , Wwf         , Wwf         , Ww          , Gs          , Gs          , Rd          , Gs          , Ww^Bw\      , Ww          , Gs          , Gs^Fp       , Ss          , Mm          , Gs          , Gs          , Rr          , Gs^Fp       , Gs          , Gs          , Gs          , Hh          , Gs^Fp       , Gs          , Gs          , Gs          , Wwf         , Wwf         , Wwf         , Wwf         , Ke          , Gs          , Hh          , Gs^Fp       , Gs          , Gs          , Hh          , Gs          , Gs          
Uu       ,Uu^Vu       , Uu^Uf       , Rr          , Uh          , Xu          , Gs          , Wwf         , Wwf         , Rd          , Ce          , Gs          , Ww          , Ww^Bw\      , Gs          , Ss^Vhs      , Gs          , Gs          , Hh          , Rr          , Gs          , Gs          , Gs^Fp       , Gs^Fp       , Gs          , Gs          , Mm          , Mm          , Hh          , Gg^Ve       , Wwf         , Ww          , Gs          , Ce          , Ce          , Gs^Fp       , Rd          , Gs          , Ss          , Mm          , Gs          , Gs          , Gs          
Wwf         ,Wwf         , Rd          , Uu          , Uh          , Xu          , Gs          , Wwf         , Wwf         , Gs          , Ce          , Wwf         , Ww          , Ww          , Gs^Fp       , Hh          , Gs          , Gs^Fp       , Gs          , Rr          , Gs          , Gs          , Gs          , Gs          , Ss          , Gs          , Gs          , Hh          , Gs^Fp       , Gs          , Wwf         , Gs          , Gs          , Ce          , Rd          , Ss          , Ss          , Gs^Fp       , Hh          , Rd          , Gs          , Mm          , Mm          
Rd          ,Rd          , Rr          , Rr          , Xu          , Rd          , Gs          , Gs          , Wwf         , Ce          , Ke          , Wwf         , Ww          , Ww          , Gs          , Gs          , Ss          , Gs^Fp       , Gs          , Rr          , Gs          , Hh          , Hh          , Ss          , Gs^Fp       , Gs          , Gs          , Gs          , Gs          , Gs          , Wwf         , Gs          , Gs^Fp       , Gg^Fet      , Rd          , Gs          , Gs          , Gs          , Rd          , Gs          , Gs          , Gs          , Gs          
Rr          ,Rr          , Rd          , Uu^Uf       , Xu          , Gs^Vht      , Gs          , Wwf         , Ww          , Rd          , Gs          , Ww          , Ww          , Ww          , Gs^Fp       , Ss          , Ss          , Ss^Vhs      , Mm          , Rr          , Rr          , Gs          , Gs^Fp       , Gs          , Mm          , Mm          , Mm          , Gs          , Gs          , Wwf         , Ww          , Wwf         , Wwf         , Gs          , Hh          , Gs          , Hh          , Gs^Fp       , Gs          , Mm          , Gs          , Gs          , Gs          
Uu^Uf       ,Uu^Uf       , Xu          , Rd          , Xu          , Rd          , Gs          , Wwf         , Ww          , Gs          , Ww          , Ww          , Gs          , Gs^Fp       , Gs          , Gs          , Gs          , Gs          , Gs^Fp       , Gs          , Rr          , Gs          , Gs          , Gs^Fp       , Mm          , Mm          , Hh          , Wwf         , Ww          , Ww          , Wo          , Ww          , Wwf         , Gg^Ve       , Gs          , Gs^Fp       , Gs          , Gs          , Gs          , Gs          , Gs^Fp       , Gs^Fp       , Gs^Fp       
Ww          ,Ww          , Xu          , Rd          , Uh          , Xu          , Gs          , Wwf         , Ww^Vm       , Ww          , Ww          , Gs          , Gs          , Gs          , Ww          , Gs          , Gs^Fp       , Hh          , Ss          , Gs          , Rr          , Gs          , Gs          , Gs          , Ss          , Hh          , Gs^Fp       , Wwf         , Ww          , Wo          , Ww          , Ww          , Gs          , Wwf         , Wwf         , Gs          , Gs          , Gs          , Rd          , Gs          , Gs          , Mm          , Mm          
Ww          ,Ww          , Uu^Uf       , Rd          , Xu          , Xu          , Gs          , Wwf         , Ww          , Ww          , Gs          , Gs          , Ww          , Ww          , Ww^Vm       , Gs          , Hh          , Gs^Fp       , Gs          , Gg^Vh       , Gs          , Rr          , Gs          , Ss          , Gs          , Gs^Fp       , Ww          , Gs          , Gs          , Ww          , Ww          , Gs          , Gs          , Gs          , Wwf         , Wwf         , Wwf         , Gs          , Gs          , Gs^Fp       , Rd          , Gg^Fet      , Gs^Fp      
Wwf         ,Wwf         , Uu          , Uu^Vu       , Xu          , Rd          , Gs          , Wwf         , Wwf         , Ww          , Ww          , Ww          , Ww          , Ww          , Gs          , Ww          , Gs          , Ce          , Ke          , Ce          , Gs          , Rr          , Gs          , Gs^Fp       , Gs          , Ww          , Gs          , Gs          , Wwf         , Gs^Fp       , Wwf         , Gs          , Gs^Fp       , Gs          , Wwf         , Gs          , Gs          , Wwf         , Gs          , Gg^Vh       , Gs          , Gs          , Gs          
Rr          ,Rr          , Wwf         , Wwf         , Wwf         , Gs          , Wwf         , Wwf         , Ww          , Ww          , Ww          , Ww          , Ww          , Ww          , Ww          , Gs          , Ww          , Ww          , Gs          , Ce          , Gs          , Rr          , Rr          , Gs          , Rr          , Ww          , Ww          , Ww^Vm       , Ce          , Wwf         , Ce          , Gs          , Gg^Fet      , Gs          , Wwf         , Gs^Fp       , Rd          , Wwf         , Wwf         , Gs          , Gs          , Gs^Fp       , Gs^Fp       
Wwf         ,Wwf         , Xu          , Xu          , Gs          , Wwf         , Ww          , Ww          , Wo          , Wo          , Wo          , Wo          , Ww          , Ww          , Ww          , Ww          , Ww^Bw/      , Ww^Bw/      , Ww          , Wwf         , Wwf         , Gs          , Gs          , Rr          , Gs          , Ww^Bw\      , Ww^Bw\      , Ww          , Ke          , Ce          , Mm          , Gs^Fp       , Mm          , Wwf         , Gs          , Gs          , Ss          , Gs          , Gs          , Ww          , Ww          , Xu          , Xu          
Rr          ,Rr          , Gs          , Gs          , Gs          , Wwf         , Ww          , Ww          , Wo          , Wo          , Ww          , Ww          , Ww          , Ww          , Gs          , Ww^Bw/      , Ww          , Ww          , Ww          , Gs^Fp       , Gs          , Ww          , Ww          , Gs          , Ww          , Ww          , Gs          , Rr          , Hh          , Mm          , Mm          , Mm          , Wwf         , Wwf         , Gs          , Ss          , Xu          , Gs^Fp       , Gs          , Ww          , Wwf         , Xu          , Xu          
Rr          ,Rr          , Rr          , Gs^Fp       , Wwf         , Wwf         , Ww          , Wo          , Ww          , Ww          , Ww          , Gs          , Gs          , Gs          , Ww          , Ww          , Ww          , Gs          , Gs          , Gg^Ve       , Ww          , Ww          , Gs          , Ww          , Gs          , Gs          , Gg^Ve       , Rr          , Rr          , Gs          , Gg^Fet      , Hh          , Wwf         , Gs          , Rd          , Gs          , Xu          , Xu          , Uu^Uf       , Gs          , Xu          , Wwf         , Wwf         
Gs^Fp       ,Gs^Fp       , Rr          , Gs          , Gs          , Wwf         , Ww          , Wo          , Ww          , Ww          , Gs          , Gs          , Ss          , Gs          , Ww          , Ww          , Ww          , Ww          , Ww          , Ww          , Gs          , Gs          , Gs          , Gs          , Rd          , Hh          , Gs          , Gs^Fp       , Gs          , Rr          , Gs          , Wwf         , Gs          , Gs          , Ss          , Gs          , Xu          , Uu^Uf       , Wwf         , Xu          , Xu          , Uu^Uf       , Uu^Uf       
Gs          ,Gs          , Gs          , Rr          , Wwf         , Wwf         , Ww          , Ww          , Wwf         , Ww          , Gs          , Gs^Fp       , Ss^Vhs      , Gs          , Ww          , Gs          , Gs          , Ww          , Ww          , Gs          , Gs          , Gs          , Hh          , Gs^Fp       , Gs          , Ss          , Ss          , Gs          , Gs^Fp       , Rr          , Ww^Bw\      , Wwf         , Gs^Fp       , Ss          , Xu          , Xu          , Rd          , Rd          , Uu^Vu       , Uu          , Xu          , Rd          , Rd          
Gs^Fp       ,Gs^Fp       , Ch          , Ch          , Ww          , Ww^Vm       , Wwf         , Wwf         , Gs          , Wwf         , Gs          , Ss          , Gs          , Gs          , Wwf         , Gs          , Gg^Ve       , Gs          , Gs          , Wwf         , Gs          , Gs^Fp       , Gs          , Mm          , Gs          , Gs^Fp       , Gs          , Gs          , Gs          , Gs          , Ww          , Ww^Bw\      , Rr          , Xu          , Uh          , Uu^Uf       , Rd          , Rr          , Uh          , Rr          , Xu          , Uh          , Uh          
Gs          ,Gs          , Wwf         , Ch          , Wwf         , Wwf         , Ch          , Ch          , Gs          , Gs          , Gs          , Gs          , Wwf         , Wwf         , Gs          , Gs          , Ss          , Gs          , Gs          , Wwf         , Gs          , Gs^Fp       , Gs          , Gs          , Ss          , Ss          , Ss^Vhs      , Ss          , Gs          , Ww          , Gs          , Gs          , Xu          , Rd          , Uu          , Rr          , Rr          , Uh          , Uu^Uf       , Wwf         , Ww          , Ww          , Ww          
Wwf         ,Wwf         , Gs          , 2 Kh        , Ch          , Ch          , Gs          , Ch          , Gg^Fet      , Hh          , Gs          , Gs          , Wwf         , Gs          , Rd          , Gs^Fp       , Ss          , Ss          , Gg^Fet      , Wwf         , Wwf         , Gs          , Gs          , Rd          , Gg^Fet      , Mm          , Gs          , Rd          , Gs          , Ww          , Gs          , Xu          , Uu^Uf       , Rd          , Rd          , Wwf         , Rr          , Rd          , Rd          , Ww          , Uu^Uf       , Xu          , Xu          
Gs^Fp      ,Gg^Fet      , Wwf         , Wwf         , Gg^Fet      , Rr          , Rr          , Gg^Ve       , Gs          , Gs          , Wwf         , Wwf         , Gs          , Gs^Fp       , Gs          , Ss          , Gs          , Ss          , Gs          , Gs          , Wwf         , Gs          , Gs          , Gs^Fp       , Gs          , Gg^Fet      , Gs          , Gs          , Ww          , Ww          , Gs          , Rd          , Xu          , Uh          , Uu          , Rr          , Uu^Vu       , Uh          , Ww          , Ww^Vm       , Uh          , Rr          , Rr          
Gs^Fp      ,Gs^Fp      , Wwf         , Wwf         , Gs^Fp      , Rr          , Rr          , Gg       , Gs          , Gs          , Wwf         , Wwf         , Gs          , Gs^Fp       , Gs          , Ss          , Gs          , Ss          , Gs          , Gs          , Wwf         , Gs          , Gs          , Gs^Fp       , Gs          , Gs^Fp      , Gs          , Gs          , Ww          , Ww          , Gs          , Rd          , Xu          , Uh          , Uu          , Rr          , Uu       , Uh          , Ww          , Ww       , Uh          , Rr          , Rr          
