Xv, Xv, Xv, Xv, Xv, Xv, Xv, Xv, Xv, Xv, Xv, Xv, Xv, Xv, Xv, Xv, Wwf, Wwf, Gll^Fdf, Gs, Rr, Ss, Wwf, Ww^Ewl, Ww, Wo, Wo, Wo, Wo
Xv, Xv, Xv, Xv, Xv, Xv, Xv, Xv, Xv, Xv, Xv, Xv, Xv, Xv, Wwf, Wwg, Wwf, Gs, Rr, Rr, Gs, Gs, Wwf, Ww^Ewl, Wo, Wo, Wo, Wo, Wo
Xv, Xv, Xv, Xv, Xv, Xv, Xv, Xv, Xv, Xv, Xv, Xv, Md, Hhd^Fmf, Ss, Wwf, Wwf, Gs, Rr, Gs, Chs, Ss, Wwf, Ww, Wo, Wo, Wo, Wo, Wo
Xv, Xv, Xv, Xv, Xv, Xv, Xv, Xv, Xv, Xv, Md, Hhd^Dr, Ss, Ss, Gll^Fdf, Hhd^Dr, Rr, Wwf^Bsb/, Wwf, Gll^Fdf, Hhd^Dr, Ss^Bw\r, Wwf^Bw\r, Ww, Wo, Wo, Wo, Wo, Wo
Xv, Xv, Xv, Xv, Xv, Xv, Xv, Xv, Mm^Xm, Mm^Xm, Chs, Hhd^Dr, Ss, Gll^Fdf, Gs, Gs^Es, Rr, Rr, Rr, Wwf, Wwf, Wwf, Wo, Wo^Bw\r, Ww, Wo, Wo, Wo, Wo
Xv, Xv, Xv, Xv, Xv, Xv, Gll^Fdf, Gll^Fdf, Hhd^Dr, Hhd^Dr, Ss, Chs, Gs, Gs, Rr, Rr, Rb^Eff, Rb, Rb^Vh, Rr, Rr, Wwf^Fdf, Wo, Wwf^Bw|, Wwf, Ww, Mm^Xm, Wo, Wo
Xv, Xv, Xv, Xv, Ss, Hhd^Dr, Rb^Gvs, Gll^Fdf, Gll^Fdf, Ss, Gll^Vl, Hhd^Fmf, Rr, Rr, Rb^Eff, Rb^Eff, Rb^Gvs, Rb^Gvs, Rb^Gvs, Rb^Eff, Rb^Eff, Chw, Chw, Rr, Wwf, Gll^Fdf, Hhd^Dr, Mm^Xm, Mm^Xm
Xv, Xv, Hhd^Dr, Gll^Fdf, Rb^Gvs, Rb^Gvs, Rb^Gvs, Rb^Gvs, Gll^Fdf, Ss, Ce, Ce, Rb^Eff, Rb^Eff, Rb^Gvs, Rb^Gvs, Rb^Gvs, Rb^Gvs, Rb^Gvs, Rb^Gvs, Rb^Gvs, Rb^Eff, Wwf^Es, Hhd^Dr, Wwf, Gs, Gll^Es, Mm, Mm^Xm
Mm^Xm, Hhd^Dr, Gll^Fdf, Rb^Gvs, Rb^Gvs, Rb^Vct, Rb^Eff, Rb^Eff, Ce, Ce, Rb^Eff, Re^Fdf, Hhd^Dr, Rb^Eff, Gll^Fdf, Rb^Gvs, Rb^Gvs, Hhd^Fmf, Hhd^Uf, Rb^Gvs, Ss, Wwf, Wwf, Wwf, Wwf, Gs, Gll^Es, Hhd^Dr, Md
Mm^Eff, Mm, Rb^Gvs, Rb^Gvs, Rb^Eff, Rb, Rr, Ket, Hhd^Eff, Rb^Eff, Rb^Gvs, Rb^Eff, Rb^Eff, Ss, Ss, Rb^Eff, Rb^Eff, Mm^Xm, Md, Gll^Fdf, Wwf, Wwf, Wwf, Wwr, Wwf, Gll^Fdf, Gll^Fmf, Hhd^Dr, Md
Gll^Fdf, Rb^Eff, Rb^Vhr, Rb^Eff, Wwf, Rr, Wwf, Rb, Mm^Xm, Hhd^Gvs, Rb^Gvs, Rb^Gvs, Rb^Gvs, Rb^Eff, Rp, Gs, Gs^Es, Mm^Xm, Mm^Xm, Hhd^Uf, Wwf, Gs, Gll^Fdf, Rr, Rr, Wwf, Wwf, Hhd^Dr, Md
Ss, Gll, Gs, Gs, Gs, Wwf, Ce, Wwf, Wwf, Rb^Eff, Rb^Eff, Rb^Gvs, Md, Hhd^Fmf, Hhd^Vhh, Rp, Rp, Hhd^Dr, Mm^Xm, Hhd^Dr, Wwf, Gs, Gll, Gll^Uf, Hhd^Dr, Rr, Wwf, Hhd^Fmf, Hhd^Fmf
Hhd^Fmf, Hhd^Fmf, Rb^Eff, Rb^Eff, 2 Ket^Eff, Ce, Gs, Gs, Gll^Fdf, Wwf^Es, Hhd^Dr, Hhd^Uf, Rp^Em, Rp, Wwf, Wwf, Wwf, Chr, Ww^Bw\r, Ww, Ww, Gs, Gs, Gll^Es, Gll^Es, Rr, Wwf, Wwf, Wwf
Hhd^Eff, Rb^Eff, Rb^Gvs, Rb^Gvs, Ce, Rb^Eff, Rb^Eff, Gll^Uf, Gll^Fdf, Wwf, Wwf, Mm^Xm, Wog, Wog^Bw|r, Ww, Gs, Gs, Wwf, Wwf, Hh^Fdf, Wwf, Gs, Wwf, Gs, Gs, Rp^Vhc, Wwf, Wwf, Wwf
Gll^Fdf, Rb^Gvs, Rb^Gvs, Rb^Gvs, Rb^Gvs, Rb^Gvs, Rb^Gvs, Mm^Xm, Hhd^Dr, Wwf, Wwf, Wog, Wwf^Uf, Wog^Bw|r, Wwf, Gs, Gs, Ww, Wwf, Wwr, Wwr, Wwf, Md, Wwf, Wwf, Wwf, Gs, Wwf, Ww
Hhd^Dr, Hhd^Gvs, Rb^Vct, Rb^Gvs, Rb^Gvs, Rb^Gvs, Rb^Gvs, Rb^Gvs, Rb^Eff, Ss^Vhs, Wwf, Wwf, Gll^Uf, Gs, Gs, Mm^Xm, Wwf, Wwf, Gs, Wwf, Mm^Xm, Wwr, Mm^Xm, Hh^Fdf, Rb^Eff, Rb^Eff, Rb^Eff, Gll^Fdf, Ss
Gll^Fdf, Gll^Fdf, Rb^Gvs, Rb^Gvs, Rb^Gvs, Hhd^Gvs, Ce, Rb^Eff, Gll^Fdf, Wwf, Wwf, Gs^Em, Hhd^Dr, Gll^Fmf, Wwf, Wwr, Hhd^Dr, Gs^Es, Wwf, Chw, Gll^Fdf, Gs, Ce, Rb^Eff, Rb^Gvs, Rb^Gvs, Rb^Gvs, Hhd^Eff, Gll^Fdf
Ss, Hhd^Eff, Rb^Eff, Rb^Gvs, Rb^Eff, Rb^Eff, Mm^Xm, Gs, Mm^Xm, Chw, Gs, Gs^Es, Wwf, Wwr, Gs, Gll^Fmf, Gll^Uf, Gs, Wwf, Wwf, Rb^Eff, Rb^Eff, Rb^Gvs, Hhd^Gvs, Rb^Gvs, Rb^Gvs, Rb^Vct, Gll^Fdf, Hhd^Dr
Ww, Gll^Fdf, Gs, Rb^Eff, Wwf, Hhd^Fmf, Md, Wwr, Wwr, Wwf, Wwf, Wwf, Gs, Mm^Xm, Wwf, Gs^Em, Wwf^Uf, Wwf, Wwf, Ss^Vhs, Hhd^Dr, Rb^Gvs, Rb^Gvs, Rb^Gvs, Rb^Gvs, Rb^Gvs, Rb^Gvs, Hhd^Gvs, Gs^Fdf
Wwf, Wwf, Wwf, Wwf, Gs, Wwf, Wwf, Wwf, Wwf, Wwr, Wwf, Ww, Gs, Gs, Ww, Wog^Bw|r, Wog, Wog, Wwf, Wwf, Gll^Fdf, Mm^Xm, Rb^Eff, Rb^Gvs, Ce, Rb^Gvs, Rb^Gvs, Rb^Gvs, Hhd^Eff
Wwf, Wwf, Wwf, Rp^Vhc, Gll, Gs, Gs, Gs, Ww, Hhd^Fmf, Ww^Bw\, Wwf, Wwf, Gs, Wwf, Wog^Bw|, Rp^Em, Mm^Xm, Hhd^Dr, Wwf, Gll^Fdf, Gll^Uf, Gs, Rb^Eff, 1 Ket^Eff, Rb^Gvs, Rb^Eff, Rb^Eff, Gll^Fdf
Hhd^Fmf, Wwf, Wwf, Rr, Hhd^Dr, Gll^Es, Gll, Gs, Wwf, Ww, Mm^Xm, Chr, Rp, Wwf, Hhd^Vhh, Rp, Mm, Hhd^Uf, Rb^Eff, Wwf^Es, Wwf, Gs, Ce, Ce, Gs, Rb^Eff, Gs, Hhd^Fmf, Ss
Mm, Hhd^Fmf, Wwf, Rr, Rr, Gll^Uf, Re^Fdf, Gs, Wwf, Hhd^Dr, Mm^Xm, Hhd^Dr, Gs^Es, Rp, Rp, Hhd^Fmf, Rb^Gvs, Rb^Gvs, Rb^Gvs, Rb^Eff, Mm^Xm, Wwf, Wwf, Wwf, Wwf, Gs, Rb^Vhr, Gll, Gll^Fdf
Mm, Hhd^Dr, Gll^Fdf, Wwf, Wwf, Rr, Rr, Gs, Wwf, Hhd^Uf, Md, Mm^Xm, Rb^Eff, Gs, Ss, Rb^Eff, Rb^Eff, Rb^Gvs, Rb^Gvs, Hhd^Gvs, Hhd^Eff, Rb, Rr, Rr, Rb^Eff, Rb^Eff, Rb^Gvs, Rb^Eff, Mm^Eff
Mm^Xm, Hhd^Dr, Gll^Es, Gll^Fdf, Wwf, Wwr, Wwf, Wwf, Ss, Gd^Fdf, Hhd^Uf, Mm^Xm, Rb^Gvs, Rb^Eff, Gll^Fdf, Ss, Hhd^Dr, Rb^Eff, Rb, Rb^Eff, Ce, Ket, Rb^Eff, Rb, Rb^Gvs, Rb^Gvs, Gll^Fdf, Md, Mm^Xm
Mm^Xm, Hhd^Dr, Gll^Es, Gs, Wwf, Wwf, Wwf^Es, Wwf, Rb^Gvs, Rb^Gvs, Rb^Gvs, Hhd^Fmf, Rb^Gvs, Rb^Gvs, Rb^Gvs, Rb^Eff, Rb^Eff, Gll^Fdf, Ce, Ce, Gll^Fdf, Rb^Eff, Rb^Gvs, Rb^Vct, Rb^Gvs, Rb^Gvs, Hhd^Dr, Hhd^Dr, Xv
Mm^Xm, Md, Hhd^Dr, Gs, Wwf, Hhd^Dr, Chw, Rb^Eff, Rb^Eff, Rb^Gvs, Rb^Gvs, Rb^Gvs, Rb^Gvs, Rb^Gvs, Rb, Rb^Eff, Rr, Ce, Gll^Vl, Ss, Gll^Fdf, Rb^Gvs, Rb^Gvs, Rb^Gvs, Ss, Gd^Fdf, Xv, Xv, Xv
Wo, Mm^Xm, Mm^Xm, Gll^Fdf, Wwf, Rr, Wo, Chw, Rr, Rb^Eff, Rb^Vh, Rb^Gvs, Rb^Eff, Rb^Eff, Rr, Rr, Gs, Hhd^Fmf, Ss, Ss, Hhd^Dr, Gll^Fdf, Gll^Fdf, Hhd^Dr, Xv, Xv, Xv, Xv, Xv
Wo, Wo, Wo, Chw, Ww, Wwf^Bw|r, Wo, Wwf^Fdf, Wwf, Rr, Rr, Rb, Rr, Rr, Gs, Gs, Ss, Chs, Chs, Hhd^Dr, Mm^Xm, Gll^Fdf, Xv, Xv, Xv, Xv, Xv, Xv, Xv
Wo, Wo, Wo, Wo, Wo, Wo^Bw|r, Wwf^Bw\, Wwf, Hhd^Dr, Wwf, Wwf, Rr, Rr, Gs^Es, Gll^Fdf, Gll^Fdf, Ss, Hhd^Dr, Mm^Xm, Mm^Xm, Xv, Xv, Xv, Xv, Xv, Xv, Xv, Xv, Xv
Wo, Wo, Wo, Wo, Wo, Ww, Wwf, Ss^Bw\, Chs, Gll^Fdf, Rr, Wwf^Bsb/, Wwf, Hhd^Dr, Ss, Ss, Md, Hhd^Dr, Xv, Xv, Xv, Xv, Xv, Xv, Xv, Xv, Xv, Xv, Xv
Wo, Wo, Wo, Wo, Wo, Ww^Ewl, Wwf, Ss, Gs, Gs, Rr, Gs, Wwf, Wwf, Wwf, Hhd^Fmf, Xv, Xv, Xv, Xv, Xv, Xv, Xv, Xv, Xv, Xv, Xv, Xv, Xv
Wo, Wo, Wo, Wo, Wo, Ww^Ewl, Wwf, Gs, Rr, Rr, Gll^Fdf, Gs, Wwf, Wwg, Xv, Xv, Xv, Xv, Xv, Xv, Xv, Xv, Xv, Xv, Xv, Xv, Xv, Xv, Xv
