border_size=1
usage=map

Xu          , Xu          , Xu          , Xu          , Xu          , Xu          , Xu          , Xu          , Xu          , Xu          , Xu          , Xu          , Xu          , Xu          , Ql          , Ql          , Ql          , Xu          , Xu          , Xu          , Xu          , Xu          , Xu          , Xu          , Xu          , Xu          , Xu          , Xu          , Xu          , Xu          , Xu          
Xu          , Xu          , Xu          , Xu          , Xu          , Xu          , Xu          , Xu          , Xu          , Xu          , Xu          , Xu          , Xu          , Xu          , Ql          , Ql          , Ql          , Xu          , Xu          , Xu          , Xu          , Xu          , Xu          , Xu          , Xu          , Xu          , Xu          , Xu          , Xu          , Xu          , Xu          
Xu          , Xu          , Xu          , Xu          , Xu          , Xu          , Xu          , Xu          , Xu          , Xu          , Xu          , Xu          , Xu          , Ql          , Re          , 2 Kud       , Uu          , Ql          , Xu          , Xu          , Xu          , Xu          , Xu          , Xu          , Xu          , Xu          , Xu          , Xu          , Xu          , Xu          , Xu          
Xu          , Xu          , Xu          , Xu          , Xu          , Xu          , Xu          , Xu          , Xu          , Xu          , Uh          , Uu^Uf       , Wwf         , Rd          , Re          , Cud         , Re          , Uu^Uf       , Wwf         , Xu          , Xu          , Xu          , Xu          , Xu          , Xu          , Xu          , Xu          , Xu          , Xu          , Xu          , Xu          
Xu          , Xu          , Xu          , Xu          , Xu          , Xu          , Xu          , Xu          , Xu          , Xu          , Rd          , Uu^Vu       , Rr          , Wwf         , Rd          , Cud         , Cud         , Rr          , Re          , Hh          , Ss          , Xu          , Xu          , Xu          , Xu          , Xu          , Xu          , Xu          , Xu          , Xu          , Xu          
Xu          , Xu          , Xu          , Xu          , Xu          , Xu          , Wwf         , Xu          , Rd          , Wwf         , Rd          , Rr          , Mm          , Wwf         , Wwf         , Re          , Rr          , Cud         , Re          , Hh          , Ss^Vhs      , Ss          , Re          , Xu          , Xu          , Xu          , Xu          , Xu          , Xu          , Xu          , Xu          
Xu          , Xu          , Xu          , Xu          , Rd          , Wwf         , Rr          , Rd          , Rd          , Wwf         , Rd          , Wwf         , Rr          , Rr          , Gs^Fp       , Gs^Fp       , Hh          , Re          , Re          , Gs^Fp       , Wwf         , Re          , Hh          , Rd          , Uu^Vu       , Xu          , Xu          , Xu          , Xu          , Xu          , Xu          
Xu          , Xu          , Xu          , Ql          , Uh          , Xu          , Re          , Xu          , Xu          , Wwf         , Re          , Re          , Ql          , Ql          , Ql          , Uu^Uf       , Wwf         , Rd          , Re          , Hh          , Gs^Fp       , Rr          , Xu          , Rd          , Wwf         , Xu          , Xu          , Xu          , Xu          , Xu          , Xu          
Xu          , Xu          , Xu          , Xu          , Xu          , Uu^Uf       , Rd          , Re          , Xu          , Ww          , Ww          , Uh          , Xu          , Xu          , Ss^Vhs      , Rr          , Rd          , Rd          , Re          , Rd          , Rd          , Re          , Xu          , Xu          , Gs^Fp       , Xu          , Xu          , Xu          , Xu          , Xu          , Xu          
Xu          , Xu          , Ql          , Ql          , Rr          , Uu^Vu       , Xu          , Rd          , Xu          , Ww          , Wwf         , Xu          , Re          , Re          , Rd          , Gs^Fp       , Hh          , Re          , Wwf         , Mm          , Wwf         , Ss^Vhs      , Re          , Rd          , Re          , Xu          , Xu          , Xu          , Xu          , Xu          , Xu          
Xu          , Xu          , Rr          , Rr          , Xu          , Xu          , Uh          , Rr          , Xu          , Wwf         , Mm          , Wwf         , Gs^Fp       , Mm          , Hh          , Rd          , Wwf         , Wwf         , Re          , Hh          , Wwf         , Rd          , Xu          , Xu          , Uh          , Xu          , Xu          , Xu          , Xu          , Xu          , Xu          
Xu          , Xu          , Wwf         , Wwf         , Gs^Fp       , Rr          , Rd          , Uu^Uf       , Xu          , Wwf         , Wwf         , Wwf         , Ww          , Ww          , Hh          , Re          , Wwf         , Re          , Hh          , Gs^Fp       , Hh          , Wwf         , Xu          , Gs^Fp       , Rd          , Uu^Uf       , Xu          , Xu          , Xu          , Xu          , Xu          
Xu          , Xu          , Xu          , Rr          , Rd          , Rd          , Xu          , Re          , Xu          , Wwf         , Rr          , Ww          , Re          , Gs^Fp       , Re          , Re          , Wwf         , Re          , Rd          , Gs^Fp       , Rr          , Wwf         , Wwf         , Uh          , Rd          , Re          , Uu^Uf       , Xu          , Xu          , Xu          , Xu          
Xu          , Xu          , Xu          , Ss          , Uh          , Uu^Uf       , Re          , Xu          , Wwf         , Wwf         , Rr          , Rd          , Rd          , Re          , Wwf         , Rd          , Re          , Re          , Re          , Rd          , Rr          , Wwf         , Xu          , Xu          , Xu          , Uh          , Re          , Ss          , Xu          , Xu          , Xu          
Xu          , Xu          , Xu          , Xu          , Xu          , Rr          , Rd          , Uh          , Xu          , Wwf         , Hh          , Gs^Fp       , Hh          , Re          , Wwf         , Re          , Hh          , Gs^Fp       , Ww          , Ww          , Wwf         , Wwf         , Xu          , Rr          , Rd          , Rd          , Gs^Fp       , Rr          , Wwf         , Xu          , Xu          
Xu          , Xu          , Xu          , Xu          , Xu          , Uu^Uf       , Uh          , Gs^Fp       , Xu          , Wwf         , Wwf         , Gs^Fp       , Re          , Re          , Wwf         , Re          , Hh          , Ww          , Gs^Fp       , Wwf         , Mm          , Wwf         , Xu          , Uh          , Uu^Uf       , Rr          , Xu          , Wwf         , Rr          , Xu          , Xu          
Xu          , Xu          , Xu          , Xu          , Xu          , Xu          , Rd          , Xu          , Rd          , Rd          , Wwf         , Hh          , Wwf         , Wwf         , Hh          , Rd          , Rd          , Mm          , Re          , Wwf         , Wwf         , Wwf         , Xu          , Re          , Xu          , Xu          , Rr          , Rr          , Ql          , Xu          , Xu          
Xu          , Xu          , Xu          , Xu          , Xu          , Xu          , Gs^Fp       , Rr          , Xu          , Ss^Vhs      , Rd          , Mm          , Re          , Re          , Rd          , Gs^Fp       , Ss^Vhs      , Re          , Xu          , Xu          , Ww          , Ww          , Xu          , Rd          , Rd          , Uu^Vu       , Xu          , Ql          , Xu          , Xu          , Xu          
Xu          , Xu          , Xu          , Xu          , Xu          , Xu          , Wwf         , Xu          , Xu          , Re          , Gs^Fp       , Rd          , Re          , Rd          , Wwf         , Rr          , Ql          , Xu          , Ql          , Uh          , Re          , Ww          , Xu          , Re          , Re          , Uu^Uf       , Uh          , Xu          , Xu          , Xu          , Xu          
Xu          , Xu          , Xu          , Xu          , Xu          , Xu          , Uu^Vu       , Rd          , Hh          , Rr          , Wwf         , Hh          , Re          , Rd          , Hh          , Uu^Uf       , Gs^Fp       , Ql          , Rr          , Re          , Rd          , Wwf         , Rd          , Xu          , Rr          , Xu          , Rd          , Ql          , Xu          , Xu          , Xu          
Xu          , Xu          , Xu          , Xu          , Xu          , Xu          , Xu          , Rd          , Re          , Re          , Ss^Vhs      , Gs^Fp       , Re          , Re          , Rr          , Gs^Fp       , Wwf         , Rr          , Mm          , Wwf         , Rd          , Wwf         , Rd          , Rd          , Wwf         , Wwf         , Xu          , Xu          , Xu          , Xu          , Xu          
Xu          , Xu          , Xu          , Xu          , Xu          , Xu          , Xu          , Xu          , Xu          , Ss          , Ss          , Hh          , Re          , Cud         , Cud         , Re          , Rd          , Wwf         , Rr          , Rr          , Rd          , Wwf         , Xu          , Xu          , Xu          , Xu          , Xu          , Xu          , Xu          , Xu          , Xu          
Xu          , Xu          , Xu          , Xu          , Xu          , Xu          , Xu          , Xu          , Xu          , Xu          , Xu          , Hh          , Wwf         , Rr          , Re          , Cud         , Re          , Wwf         , Wwf         , Uu^Vu       , Uh          , Xu          , Xu          , Xu          , Xu          , Xu          , Xu          , Xu          , Xu          , Xu          , Xu          
Xu          , Xu          , Xu          , Xu          , Xu          , Xu          , Xu          , Xu          , Xu          , Xu          , Xu          , Xu          , Xu          , Uu^Uf       , Uu          , Cud         , Re          , Rd          , Xu          , Uu^Uf       , Xu          , Xu          , Xu          , Xu          , Xu          , Xu          , Xu          , Xu          , Xu          , Xu          , Xu          
Xu          , Xu          , Xu          , Xu          , Xu          , Xu          , Xu          , Xu          , Xu          , Xu          , Xu          , Xu          , Xu          , Ql          , Ql          , 1 Kud       , Ql          , Ql          , Xu          , Xu          , Xu          , Xu          , Xu          , Xu          , Xu          , Xu          , Xu          , Xu          , Xu          , Xu          , Xu          
Xu          , Xu          , Xu          , Xu          , Xu          , Xu          , Xu          , Xu          , Xu          , Xu          , Xu          , Xu          , Xu          , Ql          , Ql          , Ql          , Ql          , Ql          , Xu          , Xu          , Xu          , Xu          , Xu          , Xu          , Xu          , Xu          , Xu          , Xu          , Xu          , Xu          , Xu          
