border_size=1
usage=map

Xu          , Xu          , Xu          , Xu          , Xu          , Xu          , Xu          , Xu          , Xu          , Xu          , Xu          , Xu          , Xu          , Xu          , Ql          , Ql          , Ql          , Xu          , Xu          , Xu          , Xu          , Xu          , Xu          , Xu          , Xu          , Xu          , Xu          , Xu          , Xu          , Xu          , Xu          
Xu          , Xu          , Xu          , Xu          , Xu          , Xu          , Xu          , Xu          , Xu          , Xu          , Xu          , Xu          , Xu          , Xu          , Ql          , Ql          , Ql          , Xu          , Xu          , Xu          , Xu          , Xu          , Xu          , Xu          , Xu          , Xu          , Xu          , Xu          , Xu          , Xu          , Xu          
Xu          , Xu          , Xu          , Xu          , Xu          , Xu          , Xu          , Xu          , Xu          , Xu          , Xu          , Xu          , Xu          , Ql          , Re          , 2 Kud       , Uu          , Ql          , Xu          , Xu          , Xu          , Xu          , Xu          , Xu          , Xu          , Xu          , Xu          , Xu          , Xu          , Xu          , Xu          
Xu          , Xu          , Xu          , Xu          , Xu          , Xu          , Xu          , Xu          , Xu          , Xu          , Uh          , Uu^Uf       , Wwf         , Rd          , Rd          , Cud         , Re          , Uu^Uf       , Rr          , Xu          , Xu          , Xu          , Xu          , Xu          , Xu          , Xu          , Xu          , Xu          , Xu          , Xu          , Xu          
Xu          , Xu          , Xu          , Xu          , Xu          , Xu          , Xu          , Xu          , Xu          , Xu          , Rr          , Uu^Vu       , Rr          , Wwf         , Rd          , Cud         , Cud         , Rd          , Re          , Hh          , Ss          , Xu          , Xu          , Xu          , Xu          , Xu          , Xu          , Xu          , Xu          , Xu          , Xu          
Xu          , Xu          , Xu          , Xu          , Xu          , Xu          , Wwf         , Xu          , Rd          , Wwf         , Rd          , Rr          , Mm          , Wwf         , Wwf         , Rd          , Rr          , Cud         , Re          , Gs^Fp       , Ss^Vhs      , Ss          , Re          , Xu          , Xu          , Xu          , Xu          , Xu          , Xu          , Xu          , Xu          
Xu          , Xu          , Xu          , Xu          , Rd          , Wwf         , Rr          , Rd          , Rd          , Wwf         , Rd          , Rr          , Rr          , Rr          , Gs^Fp       , Gs^Fp       , Hh          , Re          , Re          , Re          , Wwf         , Re          , Hh          , Rd          , Uu^Vu       , Xu          , Xu          , Xu          , Xu          , Xu          , Xu          
Xu          , Xu          , Xu          , Ql          , Uu^Uf       , Xu          , Re          , Xu          , Xu          , Wwf         , Re          , Re          , Ql          , Ql          , Uh          , Uu^Uf       , Rd          , Rd          , Re          , Hh          , Gs^Fp       , Rr          , Xu          , Rd          , Wwf         , Xu          , Xu          , Xu          , Xu          , Xu          , Xu          
Xu          , Xu          , Xu          , Xu          , Rr          , Gs^Fp       , Rd          , Re          , Xu          , Ww          , Ww          , Uh          , Xu          , Xu          , Ss^Vhs      , Rr          , Rd          , Rd          , Re          , Re          , Rd          , Rd          , Xu          , Xu          , Gs^Fp       , Xu          , Xu          , Xu          , Xu          , Xu          , Xu          
Xu          , Xu          , Ql          , Xu          , Rd          , Uu^Vu       , Xu          , Rd          , Xu          , Ww          , Wwf         , Xu          , Rr          , Rr          , Rd          , Gs^Fp       , Hh          , Re          , Rd          , Mm          , Wwf         , Ss^Vhs      , Rd          , Rd          , Re          , Xu          , Xu          , Xu          , Xu          , Xu          , Xu          
Xu          , Xu          , Xu          , Rr          , Xu          , Xu          , Uh          , Gs^Fp       , Xu          , Wwf         , Mm          , Wwf         , Gs^Fp       , Mm          , Hh          , Rd          , Wwf         , Wwf         , Re          , Hh          , Wwf         , Rd          , Xu          , Xu          , Uh          , Xu          , Xu          , Xu          , Xu          , Xu          , Xu          
Xu          , Xu          , Wwf         , Wwf         , Gs^Fp       , Rd          , Rd          , Uu^Uf       , Xu          , Wwf         , Wwf         , Wwf         , Ww          , Ww          , Hh          , Re          , Wwf         , Re          , Hh          , Gs^Fp       , Hh          , Wwf         , Xu          , Gs^Fp       , Rd          , Uu^Uf       , Xu          , Xu          , Xu          , Xu          , Xu          
Xu          , Rr          , Wwf         , Rr          , Rr          , Rd          , Xu          , Re          , Xu          , Wwf         , Re          , Ww          , Rd          , Gs^Fp       , Re          , Re          , Wwf         , Re          , Re          , Gs^Fp       , Re          , Wwf         , Wwf         , Uh          , Re          , Re          , Uh          , Xu          , Wo          , Xu          , Xu          
Xu          , Xu          , Wo          , Ww          , Uh          , Uh          , Rd          , Xu          , Wwf         , Wwf         , Re          , Re          , Re          , Re          , Wwf         , Rd          , Re          , Re          , Rd          , Re          , Re          , Wwf         , Xu          , Xu          , Xu          , Uh          , Rr          , Ww          , Wwf         , Xu          , Xu          
Xu          , Xu          , Xu          , Xu          , Xu          , Rd          , Re          , Uh          , Xu          , Wwf         , Hh          , Gs^Fp       , Hh          , Re          , Wwf         , Re          , Hh          , Gs^Fp       , Ww          , Ww          , Wwf         , Wwf         , Xu          , Re          , Re          , Rd          , Gs^Fp       , Rr          , Wwf         , Rr          , Xu          
Xu          , Xu          , Xu          , Xu          , Xu          , Uu^Uf       , Uh          , Gs^Fp       , Xu          , Wwf         , Wwf         , Gs^Fp       , Re          , Re          , Wwf         , Re          , Hh          , Ww          , Gs^Fp       , Wwf         , Mm          , Wwf         , Xu          , Uu^Uf       , Uh          , Re          , Xu          , Wwf         , Xu          , Xu          , Xu          
Xu          , Xu          , Xu          , Xu          , Xu          , Xu          , Rd          , Xu          , Rd          , Rd          , Wwf         , Hh          , Rd          , Wwf         , Hh          , Rd          , Rd          , Mm          , Rr          , Wwf         , Wwf         , Wwf         , Xu          , Gs^Fp       , Xu          , Xu          , Rd          , Rr          , Ql          , Xu          , Xu          
Xu          , Xu          , Xu          , Xu          , Xu          , Xu          , Gs^Fp       , Rr          , Xu          , Ss^Vhs      , Rd          , Mm          , Re          , Re          , Rd          , Gs^Fp       , Ss^Vhs      , Rr          , Xu          , Xu          , Ww          , Ww          , Xu          , Rd          , Rd          , Uu^Vu       , Rd          , Xu          , Xu          , Xu          , Xu          
Xu          , Xu          , Xu          , Xu          , Xu          , Xu          , Wwf         , Xu          , Xu          , Rd          , Gs^Fp       , Re          , Re          , Rd          , Rd          , Rr          , Uh          , Xu          , Ql          , Uh          , Re          , Ww          , Xu          , Re          , Re          , Gs^Fp       , Uu^Uf       , Xu          , Xu          , Xu          , Xu          
Xu          , Xu          , Xu          , Xu          , Xu          , Xu          , Uu^Vu       , Rd          , Hh          , Rr          , Wwf         , Hh          , Re          , Rd          , Hh          , Uu^Uf       , Gs^Fp       , Ql          , Rr          , Re          , Rd          , Wwf         , Rd          , Xu          , Rr          , Xu          , Rd          , Ql          , Xu          , Xu          , Xu          
Xu          , Xu          , Xu          , Xu          , Xu          , Xu          , Xu          , Rd          , Re          , Re          , Ss^Vhs      , Re          , Re          , Re          , Rr          , Gs^Fp       , Wwf         , Rr          , Mm          , Rr          , Rd          , Wwf         , Rd          , Rd          , Wwf         , Wwf         , Xu          , Xu          , Xu          , Xu          , Xu          
Xu          , Xu          , Xu          , Xu          , Xu          , Xu          , Xu          , Xu          , Xu          , Ss          , Ss          , Gs^Fp       , Re          , Cud         , Cud         , Rd          , Rd          , Wwf         , Rr          , Rr          , Rr          , Wwf         , Xu          , Xu          , Xu          , Xu          , Xu          , Xu          , Xu          , Xu          , Xu          
Xu          , Xu          , Xu          , Xu          , Xu          , Xu          , Xu          , Xu          , Xu          , Xu          , Xu          , Hh          , Rr          , Rd          , Re          , Cud         , Rd          , Wwf         , Wwf         , Uu^Vu       , Uh          , Xu          , Xu          , Xu          , Xu          , Xu          , Xu          , Xu          , Xu          , Xu          , Xu          
Xu          , Xu          , Xu          , Xu          , Xu          , Xu          , Xu          , Xu          , Xu          , Xu          , Xu          , Xu          , Xu          , Uu^Uf       , Uu          , Cud         , Re          , Rd          , Xu          , Uu^Uf       , Xu          , Xu          , Xu          , Xu          , Xu          , Xu          , Xu          , Xu          , Xu          , Xu          , Xu          
Xu          , Xu          , Xu          , Xu          , Xu          , Xu          , Xu          , Xu          , Xu          , Xu          , Xu          , Xu          , Xu          , Ql          , Ql          , 1 Kud       , Ql          , Ql          , Xu          , Xu          , Xu          , Xu          , Xu          , Xu          , Xu          , Xu          , Xu          , Xu          , Xu          , Xu          , Xu          
Xu          , Xu          , Xu          , Xu          , Xu          , Xu          , Xu          , Xu          , Xu          , Xu          , Xu          , Xu          , Xu          , Ql          , Ql          , Ql          , Ql          , Ql          , Xu          , Xu          , Xu          , Xu          , Xu          , Xu          , Xu          , Xu          , Xu          , Xu          , Xu          , Xu          , Xu          
