border_size=1
usage=map

Mm^Xm       , Mm^Xm       , Mm          , Hh          , Mm          , Hh          , Hh          , Gg          , Rd          , Rd          , Rd          , Wwf         , Wwf         , Rd          , Mm          , Hh          , Gs^Fp       , Gs^Fp       , Gg          , Wwf         , Hh          , Ce          , Hh          , Wwf         , Gg          , Gs^Fp       , Mm          , Hh          , Gs^Fp       , Rd          , Wwf         , Wwf         , Rd          , Rd          , Rd          , Ggf         , Hh          , Hh          , Mm          , Hh          , Mm          , Mm          , Mm^Xm       
Mm          , Mm^Xm       , Mm          , Mm          , Hh          , Hh          , Rd          , Rd          , Mm          , Gs^Fp       , Hh          , Rd          , Wwf         , Rd          , Rd          , Hh          , Gg          , Hh          , Gg          , Wwf         , Wwf         , Ce          , Wwf         , Wwf         , Gg          , Hh          , Gg          , Hh          , Rd          , Rd          , Wwf         , Rd          , Hh          , Gs^Fp       , Mm          , Rd          , Rd          , Hh          , Hh          , Mm          , Mm          , Mm^Xm       , Mm^Xm       
Mm^Xm       , Mm^Xm       , Mm          , Mm          , Hh          , Gg          , Rd          , Gg          , Gg          , Hh          , Gg          , Rd          , Rd          , Wwf         , Rd          , Rd          , Rd          , Gg          , Gg          , Gs^Fp       , Gg          , Wwf         , Ggf         , Gs^Fp       , Gg          , Gg          , Rd          , Rd          , Rd          , Wwf         , Rd          , Rd          , Gg          , Hh          , Gg          , Gg          , Rd          , Ggf         , Hh          , Mm          , Mm          , Mm^Xm       , Mm          
Mm          , Mm          , Mm          , Gs^Fp       , Gs^Fp       , Gs^Fp       , Rd          , Gs^Fp       , Ggf         , Gg          , Gs^Fp       , Gg          , Rd          , Wwf         , Wwf         , Wwf         , Wwf         , Rd          , Ce          , Gg          , Gg          , Wwf         , Gg          , Gg          , Ce          , Rd          , Wwf         , Wwf         , Wwf         , Wwf         , Rd          , Gg          , Gs^Fp       , Gg          , Gg          , Gs^Fp       , Rd          , Gs^Fp       , Gs^Fp       , Gs^Fp       , Mm          , Mm^Xm       , Mm          
Hh          , Gs^Fp       , Gs^Fp       , Hh          , Rd          , Rd          , Gs^Fp       , Hh          , Gg^Vh       , Gg          , Gg          , Gg          , Gg          , Rd          , Rd          , Rd          , Wwf         , Rd          , Gs^Fp       , Hh          , Wwf         , Wwf         , Wwf         , Hh          , Gs^Fp       , Rd          , Wwf         , Rd          , Rd          , Rd          , Gg          , Ggf         , Gg          , Gg          , Gg^Vh       , Hh          , Gs^Fp       , Rd          , Rd          , Hh          , Gs^Fp       , Gs^Fp       , Hh          
Gs^Fp       , Gs^Fp       , Rd          , Rd          , Gs^Fp       , Rd          , Rd          , Rd          , Rd          , Gg          , Gg          , Gg          , Rd          , Rd          , Gs^Fp       , Ss^Vhs      , Rd          , Wwf         , Wwf         , Wwf         , Wwf         , Hh          , Wwf         , Wwf         , Wwf         , Wwf         , Rd          , Ss^Vhs      , Gs^Fp       , Rd          , Rd          , Gg          , Gg          , Gg          , Rd          , Rd          , Rd          , Rd          , Gs^Fp       , Rd          , Rd          , Gs^Fp       , Gs^Fp       
Gs^Fp       , Gs^Fp       , Ce          , Gs^Fp       , Gs^Fp       , Mm          , Gs^Fp       , Gs^Fp       , Hh          , Rd          , Rd          , Rd          , Gs^Fp       , Mm          , Gg          , Ggf         , Gg          , Rd          , Mm          , Rd          , Ce          , Wwf         , Ce          , Rd          , Mm          , Rd          , Gg          , Ggf         , Gg          , Mm          , Gs^Fp       , Rd          , Rd          , Rd          , Hh          , Gg          , Gs^Fp       , Mm          , Gs^Fp       , Gs^Fp       , Ce          , Gs^Fp       , Gs^Fp       
Ce          , Ce          , 1 Ke        , Gs^Fp       , Rr          , Hh          , Rd          , Hh          , Mm          , Gs^Fp       , Hh          , Gg          , Gg          , Gg          , Hh          , Gg          , Rd          , Gg          , Gg          , Hh          , Wwf         , Wwf         , Wwf         , Hh          , Gg          , Gg          , Rd          , Gg          , Hh          , Gg          , Gg          , Gg          , Hh          , Gs^Fp       , Mm          , Gs^Fp       , Hh          , Hh          , Rr          , Gs^Fp       , 2 Ke        , Ce          , Ce          
Ce          , Ce          , Ce          , Rr          , Rr          , Gs^Fp       , Mm^Vhh      , Rd          , Rd          , Hh          , Ggf         , Gg          , Gg          , Rd          , Mm          , Rd          , Gg^Ve       , Gg          , Gg          , Wwf         , Gs^Fp       , Ww          , Gs^Fp       , Wwf         , Gg          , Gg          , Gg^Ve       , Rd          , Mm          , Rd          , Gg          , Gg          , Ggf         , Hh          , Rd          , Rd          , Mm^Vhh      , Gs^Fp       , Rr          , Rr          , Ce          , Ce          , Ce          
Ce          , Ce          , Gs^Fp       , Gs^Fp       , Rr          , Hh          , Gs^Fp       , Rd          , Gg          , Gg          , Ke          , Ce          , Gg          , Hh          , Rd          , Rd          , Wwf         , Gg          , Wwf         , Wwf         , Gg          , Wwf         , Gg          , Wwf         , Wwf         , Gg          , Wwf         , Rd          , Rd          , Hh          , Gg          , Ce          , Ke          , Gg          , Gg          , Rd          , Gs^Fp       , Gg          , Rr          , Gs^Fp       , Gs^Fp       , Ce          , Ce          
Wwf         , Wwf         , Wwf         , Rr          , Gs^Fp       , Rr          , Rr          , Gg          , Gs^Fp       , Hh          , Gg          , Ce          , Gs^Fp       , Gg          , Gg          , Gg          , Ww          , Wwf         , Gg          , Gg          , Gg          , Wwf         , Gg          , Gg          , Gg          , Wwf         , Ww          , Gg          , Gg          , Gg          , Gs^Fp       , Ce          , Gg          , Hh          , Gs^Fp       , Gg          , Rr          , Rr          , Gs^Fp       , Rr          , Rr          , Wwf         , Wwf         
Gg          , Gg          , Wwf         , Gs^Fp       , Rd          , Hh          , Gg          , Rr          , Rr          , Gs^Fp       , Rr          , Ce          , Wwf         , Wwf         , Wwf         , Ww          , Gg          , Wwf         , Gg          , Gg          , Hh          , Wwf         , Hh          , Gg          , Gg          , Wwf         , Gg          , Ww          , Wwf         , Wwf         , Wwf         , Ce          , Rr          , Gs^Fp       , Rr          , Rr          , Gg          , Hh          , Rr          , Gs^Fp       , Wwf         , Wwf         , Wwf         
Wwf         , Wwf         , Rd          , Wwf         , Gs^Fp       , Gs^Fp       , Mm          , Hh          , Gs^Fp       , Rr          , Gs^Fp       , Ce          , Ke          , Rr          , Gg^Vh       , Gg          , Hh          , Hh          , Mm^Xm       , Mm^Xm       , Wwf         , Wwf         , Wwf         , Mm^Xm       , Mm^Xm       , Hh          , Hh          , Gg          , Gg^Vh       , Rr          , Ke          , Ce          , Gs^Fp       , Rr          , Gs^Fp       , Hh          , Mm          , Gs^Fp       , Gs^Fp       , Wwf         , Rr          , Gs^Fp       , Gs^Fp       
Gs^Fp       , Gs^Fp       , Rd          , Wwf         , Wwf         , Gs^Fp       , Wwf         , Wwf         , Rr          , Rr          , Gg          , Gg          , Rr          , Rr          , Gg          , Gg          , Mm^Xm       , Mm^Xm       , Gs^Fp       , Wwf         , Ww          , Ww          , Ww          , Wwf         , Gs^Fp       , Mm^Xm       , Mm^Xm       , Gg          , Gg          , Rr          , Rr          , Gg          , Gg          , Rr          , Rr          , Wwf         , Wwf         , Gs^Fp       , Wwf         , Wwf         , Wwf         , Gs^Fp       , Hh          
Gs^Fp       , Gs^Fp       , Rd          , Gs^Fp       , Wwf         , Wwf         , Hh          , Mm          , Hh          , Wwf         , Hh          , Gs^Fp       , Gg          , Gg          , Gs^Fp       , Gg          , Mm          , Mm^Xm       , Wwf         , Wwf         , Ww          , Ww          , Ww          , Wwf         , Wwf         , Mm^Xm       , Mm          , Gg          , Gs^Fp       , Gg          , Gg          , Gs^Fp       , Hh          , Gg          , Hh          , Mm          , Hh          , Wwf         , Wwf         , Gs^Fp       , Rd          , Wwf         , Wwf         
Rd          , Rd          , Gg          , Gg^Ve       , Wwf         , Hh          , Mm          , Gs^Fp       , Gs^Fp       , Rr          , Gg^Ve       , Gg          , Gg          , Gg          , Gg          , Gg          , Wwf         , Wwf         , Ww          , Ww          , Wo          , Wo          , Wo          , Ww          , Ww          , Wwf         , Wwf         , Gg          , Gg          , Gg          , Gg          , Gg          , Gg^Ve       , Rr          , Gs^Fp       , Gs^Fp       , Mm          , Hh          , Wwf         , Gg^Ve       , Gg          , Rd          , Rd          
Hh          , Gg          , Gs^Fp       , Gg          , Gg          , Wwf         , Wwf         , Rr          , Rr          , Rr          , Rr          , Wwf         , Wwf         , Gg          , Hh          , Ss^Vhs      , Wwf         , Ww          , Ww          , Wo          , Wo          , Wo          , Wo          , Wo          , Ww          , Ww          , Wwf         , Ss^Vhs      , Hh          , Gg          , Wwf         , Wwf         , Rr          , Rr          , Rr          , Rr          , Wwf         , Wwf         , Gs^Fp       , Gg          , Gs^Fp       , Gg          , Gg          
Rd          , Rd          , Mm          , Gs^Fp       , Rd          , Gg          , Ww          , Hh          , Gg          , Gs^Fp       , Rr          , Rr          , Wwf         , Mm          , Mm^Xm       , Wwf         , Rr          , Wwf         , Wwf         , Ww          , Wo          , Mm^Xm       , Wo          , Ww          , Wwf         , Wwf         , Rr          , Wwf         , Mm^Xm       , Mm          , Wwf         , Rr          , Rr          , Gs^Fp       , Rr          , Hh          , Ww          , Gg          , Rd          , Hh          , Mm          , Rd          , Hh          
Rd          , Rd          , Rd          , Hh          , Gg          , Gg          , Ww          , Gs^Fp       , Gg          , Gg          , Rr          , Hh          , Mm          , Wwf         , Wwf         , Wwf         , Mm^Xm       , Gs^Fp       , Wwf         , Ww          , Ww          , Wo          , Ww          , Ww          , Wwf         , Gs^Fp       , Mm^Xm       , Wwf         , Wwf         , Wwf         , Mm          , Hh          , Rr          , Gg          , Gg          , Gs^Fp       , Ww          , Gg          , Gg          , Gs^Fp       , Rd          , Rd          , Rd          
Gs^Fp       , Gs^Fp       , Gs^Fp       , Gg          , Gg          , Ww          , Gg          , Hh          , Rr          , Rr          , Rr          , Hh          , Wwf         , Wwf         , Rr          , Ke          , Ce          , Ce          , Hh          , Wwf         , Ww          , Ww          , Ww          , Wwf         , Hh          , Ce          , Ce          , Ke          , Rr          , Wwf         , Wwf         , Hh          , Rr          , Rr          , Rr          , Hh          , Gg          , Ww          , Gg          , Gg          , Gs^Fp       , Gs^Fp       , Gs^Fp       
Hh          , Hh          , Rd          , Gg          , Gg          , Wwf         , Wwf         , Gg          , Gg          , Gg          , Wwf         , Wwf         , Ss^Vhs      , Wwf         , Gs^Fp       , Hh          , Ce          , Mm^Xm       , Wwf         , Wwf         , Wwf         , Wwf         , Wwf         , Wwf         , Wwf         , Mm^Xm       , Ce          , Hh          , Gs^Fp       , Wwf         , Ss^Vhs      , Wwf         , Wwf         , Gg          , Gg          , Gg          , Wwf         , Wwf         , Gg          , Gg          , Rd          , Hh          , Hh          
Gs^Fp       , Gs^Fp       , Rd          , Rd          , Rd          , Gg^Ve       , Gg          , Ww          , Ww          , Ww          , Ww          , Rr          , Ss          , Wwf         , Ss          , Gg          , Ss          , Wwf         , Mm^Xm       , Gs^Fp       , Hh          , Hh          , Hh          , Gs^Fp       , Mm^Xm       , Wwf         , Ss          , Gg          , Ss          , Wwf         , Ss          , Rr          , Ww          , Ww          , Ww          , Ww          , Gg          , Gg^Ve       , Rd          , Rd          , Rd          , Gs^Fp       , Gs^Fp       
Mm          , Mm          , Gs^Fp       , Mm          , Hh          , Rd          , Gs^Fp       , Gg          , Gs^Fp       , Gs^Fp       , Ww          , Gs^Fp       , Mm          , Ss          , Gs^Fp       , Ss          , Mm^Xm       , Hh          , Mm^Xm       , Mm^Xm       , Mm^Xm       , Mm^Xm       , Mm^Xm       , Mm^Xm       , Mm^Xm       , Hh          , Mm^Xm       , Ss          , Gs^Fp       , Ss          , Mm          , Gs^Fp       , Ww          , Gs^Fp       , Hh          , Gg          , Gs^Fp       , Rd          , Gs^Fp       , Mm          , Hh          , Mm          , Mm          
Mm          , Mm          , Gs^Fp       , Hh          , Hh          , Rd          , Gs^Fp       , Gg          , Hh          , Gs^Fp       , Ww          , Hh          , Hh          , Gs^Fp       , Hh          , Mm          , Mm^Xm       , Mm          , Mm          , Mm          , Mm^Xm       , Mm          , Mm          , Mm          , Mm^Xm       , Mm          , Mm^Xm       , Hh          , Gs^Fp       , Gs^Fp       , Hh          , Hh          , Ww          , Hh          , Gs^Fp       , Gg          , Gs^Fp       , Rd          , Hh          , Mm          , Hh          , Mm          , Mm          
