border_size=1
usage=map

Mm          ,Mm          , Mm          , Gs^Fp       , Gs^Fp       , Gs^Fp       , Rd          , Gs^Fp       , Gg          , Gg          , Gs^Fp       , Gg          , Gg          , Gg          , Gg          , Gg          , Gg          , Gg          , Gg          , Gg          , Gg          , Wwf         , Gg          , Gg          , Gg          , Gg          , Gg          , Gg          , Gg          , Gg          , Gg          , Gg          , Gs^Fp       , Gg          , Gg          , Gs^Fp       , Rd          , Gs^Fp       , Gs^Fp       , Gs^Fp       , Mm          , Mm          , Mm          
Mm          ,Mm          , Mm          , Gs^Fp       , Gs^Fp       , Gs^Fp       , Rd          , Gs^Fp       , Gg          , Gg          , Gs^Fp       , Gg          , Gg          , Gg          , Gg          , Gg          , Gg          , Gg          , Gg          , Gg          , Gg          , Wwf         , Gg          , Gg          , Gg          , Gg          , Gg          , Gg          , Gg          , Gg          , Gg          , Gg          , Gs^Fp       , Gg          , Gg          , Gs^Fp       , Rd          , Gs^Fp       , Gs^Fp       , Gs^Fp       , Mm          , Mm          , Mm          
Gs^Fp       ,Gs^Fp       , Gs^Fp       , Hh          , Rd          , Hh          , Gs^Fp       , Gs^Fp       , Gg^Vh       , Gg          , Gg          , Gg          , Gg          , Gg          , Gs^Fp       , Rd          , Rd          , Gg          , Gs^Fp       , Hh          , Rd          , Wwf         , Rd          , Hh          , Gs^Fp       , Gg          , Rd          , Rd          , Gs^Fp       , Gg          , Gg          , Gg          , Gg          , Gg          , Gg^Vh       , Gs^Fp       , Gs^Fp       , Hh          , Rd          , Hh          , Gs^Fp       , Gs^Fp       , Gs^Fp       
Gs^Fp       ,Gs^Fp       , Rd          , Rd          , Gs^Fp       , Rd          , Rd          , Rd          , Gg          , Gg          , Gg          , Gg          , Gg          , Gg          , Ss          , Ss^Vhs      , Gg          , Gg          , Gg          , Rd          , Gs^Fp       , Ss          , Gs^Fp       , Rd          , Gg          , Gg          , Gg          , Ss^Vhs      , Ss          , Gg          , Gg          , Gg          , Gg          , Gg          , Gg          , Rd          , Rd          , Rd          , Gs^Fp       , Rd          , Rd          , Gs^Fp       , Gs^Fp       
Gs^Fp       ,Gs^Fp       , Ce          , Gs^Fp       , Gs^Fp       , Mm          , Gs^Fp       , Gs^Fp       , Hh          , Gg          , Gg          , Gg          , Gs^Fp       , Mm          , Gg          , Gg          , Gg          , Gg          , Gg          , Mm          , Hh          , Ss          , Hh          , Mm          , Gg          , Gg          , Gg          , Gg          , Gg          , Mm          , Gs^Fp       , Gg          , Gg          , Gg          , Hh          , Gg          , Gs^Fp       , Mm          , Gs^Fp       , Gs^Fp       , Ce          , Gs^Fp       , Gs^Fp       
Ce          ,Ce          , 1 Ke        , Gs^Fp       , Rr          , Hh          , Rd          , Hh          , Mm          , Gs^Fp       , Hh          , Gg          , Gg          , Gg          , Hh          , Gg          , Rd          , Gg          , Gg          , Hh          , Wwf         , Wwf         , Wwf         , Hh          , Gg          , Gg          , Rd          , Gg          , Hh          , Gg          , Gg          , Gg          , Hh          , Gs^Fp       , Mm          , Gs^Fp       , Hh          , Hh          , Rr          , Gs^Fp       , 2 Ke        , Ce          , Ce          
Ce          ,Ce          , Ce          , Rr          , Rr          , Gs^Fp       , Mm^Vhh      , Rd          , Rd          , Hh          , Mm          , Gg          , Gg          , Rd          , Mm          , Rd          , Gg^Ve       , Gg          , Gg          , Wwf         , Ww          , Ww          , Ww          , Wwf         , Gg          , Gg          , Gg^Ve       , Rd          , Mm          , Rd          , Gg          , Gg          , Mm          , Hh          , Rd          , Rd          , Mm^Vhh      , Gs^Fp       , Rr          , Rr          , Ce          , Ce          , Ce          
Ce          ,Ce          , Gs^Fp       , Gs^Fp       , Rr          , Hh          , Gs^Fp       , Rd          , Gg          , Gg          , Ke          , Ce          , Gg          , Hh          , Rd          , Rd          , Gg          , Wwf         , Wwf         , Gg          , Gs^Fp       , Ww          , Gs^Fp       , Gg          , Wwf         , Wwf         , Gg          , Rd          , Rd          , Hh          , Gg          , Ce          , Ke          , Gg          , Gg          , Rd          , Gs^Fp       , Gg          , Rr          , Gs^Fp       , Gs^Fp       , Ce          , Ce          
Wwf         ,Wwf         , Wwf         , Rr          , Gs^Fp       , Rr          , Rr          , Gg          , Gs^Fp       , Hh          , Gg          , Ce          , Gs^Fp       , Gg          , Gg          , Gg          , Ww          , Ww          , Gg          , Gg          , Gg          , Wwf         , Gg          , Gg          , Gg          , Ww          , Ww          , Gg          , Gg          , Gg          , Gs^Fp       , Ce          , Gg          , Hh          , Gs^Fp       , Gg          , Rr          , Rr          , Gs^Fp       , Rr          , Rr          , Wwf         , Wwf         
Gg          ,Gg          , Wwf         , Gs^Fp       , Rd          , Hh          , Gg          , Rr          , Rr          , Gs^Fp       , Rr          , Ce          , Wwf         , Wwf         , Wwf         , Ww          , Gg          , Wwf         , Gg          , Gg          , Mm          , Wwf         , Mm          , Gg          , Gg          , Wwf         , Gg          , Ww          , Wwf         , Wwf         , Wwf         , Ce          , Rr          , Gs^Fp       , Rr          , Rr          , Gg          , Hh          , Rr          , Gs^Fp       , Wwf         , Wwf         , Wwf         
Wwf         ,Wwf         , Rd          , Wwf         , Gs^Fp       , Gs^Fp       , Mm          , Hh          , Gs^Fp       , Rr          , Gs^Fp       , Ce          , Ke          , Rr          , Gg^Vh       , Gg          , Hh          , Hh          , Mm^Xm       , Mm^Xm       , Wwf         , Wwf         , Wwf         , Mm^Xm       , Mm^Xm       , Hh          , Hh          , Gg          , Gg^Vh       , Rr          , Ke          , Ce          , Gs^Fp       , Rr          , Gs^Fp       , Hh          , Mm          , Gs^Fp       , Gs^Fp       , Wwf         , Rr          , Gs^Fp       , Gs^Fp       
Gs^Fp       ,Gs^Fp       , Rd          , Wwf         , Wwf         , Gs^Fp       , Wwf         , Wwf         , Rr          , Rr          , Wwf         , Wwf         , Rr          , Rr          , Gg          , Gg          , Mm^Xm       , Mm^Xm       , Gs^Fp       , Wwf         , Ww          , Ww          , Ww          , Wwf         , Gs^Fp       , Mm^Xm       , Mm^Xm       , Gg          , Gg          , Rr          , Rr          , Wwf         , Wwf         , Rr          , Rr          , Wwf         , Wwf         , Gs^Fp       , Wwf         , Wwf         , Wwf         , Gs^Fp       , Gs^Fp       
Gs^Fp       ,Gs^Fp       , Rd          , Gs^Fp       , Wwf         , Wwf         , Hh          , Mm          , Hh          , Wwf         , Hh          , Gs^Fp       , Gg          , Gg          , Gs^Fp       , Gg          , Mm          , Mm^Xm       , Wwf         , Wwf         , Ww          , Ww          , Ww          , Wwf         , Wwf         , Mm^Xm       , Mm          , Gg          , Gs^Fp       , Gg          , Gg          , Gs^Fp       , Hh          , Wwf         , Hh          , Mm          , Hh          , Wwf         , Wwf         , Gs^Fp       , Rd          , Wwf         , Wwf         
Rd          ,Rd          , Gg          , Gg^Ve       , Wwf         , Mm          , Mm          , Gs^Fp       , Gs^Fp       , Rr          , Gg^Ve       , Gg          , Gg          , Gg          , Gg          , Gg          , Wwf         , Wwf         , Ww          , Ww          , Wo          , Wo          , Wo          , Ww          , Ww          , Wwf         , Wwf         , Gg          , Gg          , Gg          , Gg          , Gg          , Gg^Ve       , Rr          , Gs^Fp       , Gs^Fp       , Mm          , Mm          , Wwf         , Gg^Ve       , Gg          , Rd          , Rd          
Gg          ,Gg          , Gs^Fp       , Gg          , Gg          , Wwf         , Wwf         , Rr          , Rr          , Rr          , Rr          , Wwf         , Wwf         , Gg          , Ss          , Ss^Vhs      , Wwf         , Ww          , Ww          , Wo          , Wo          , Wo          , Wo          , Wo          , Ww          , Ww          , Wwf         , Ss^Vhs      , Ss          , Gg          , Wwf         , Wwf         , Rr          , Rr          , Rr          , Rr          , Wwf         , Wwf         , Gs^Fp       , Gg          , Gs^Fp       , Gg          , Gg          
Rd          ,Rd          , Mm          , Gs^Fp       , Rd          , Gg          , Ww          , Hh          , Gg          , Gs^Fp       , Gg          , Rr          , Wwf         , Mm          , Mm^Xm       , Hh          , Wwf         , Wwf         , Wwf         , Ww          , Wo          , Mm^Xm       , Wo          , Ww          , Wwf         , Wwf         , Wwf         , Hh          , Mm^Xm       , Mm          , Wwf         , Rr          , Gg          , Gs^Fp       , Rr          , Hh          , Ww          , Gg          , Rd          , Hh          , Mm          , Rd          , Rd          
Rd          ,Rd          , Rd          , Hh          , Gg          , Gg          , Ww          , Gs^Fp       , Gg          , Gg          , Mm          , Rr          , Mm          , Wwf         , Wwf         , Wwf         , Mm^Xm       , Hh          , Wwf         , Ww          , Ww          , Wo          , Ww          , Ww          , Wwf         , Hh          , Mm^Xm       , Wwf         , Wwf         , Wwf         , Mm          , Rr          , Mm          , Gg          , Gg          , Gs^Fp       , Ww          , Gg          , Gg          , Gs^Fp       , Rd          , Rd          , Rd          
Gs^Fp       ,Gs^Fp       , Gs^Fp       , Gg          , Gg          , Ww          , Gg          , Hh          , Rd          , Rd          , Rd          , Hh          , Wwf         , Wwf         , Mm          , Ke          , Ce          , Ce          , Mm          , Wwf         , Ww          , Ww          , Ww          , Wwf         , Mm          , Ce          , Ce          , Ke          , Mm          , Wwf         , Wwf         , Hh          , Rd          , Rd          , Rd          , Hh          , Gg          , Ww          , Gg          , Gg          , Gs^Fp       , Gs^Fp       , Gs^Fp       
Hh          ,Hh          , Rd          , Gg          , Gg          , Wwf         , Wwf         , Gg          , Gg          , Gg          , Ww          , Wwf         , Ss^Vhs      , Wwf         , Gs^Fp       , Gs^Fp       , Ce          , Mm^Xm       , Ss          , Wwf         , Wwf         , Wwf         , Wwf         , Wwf         , Ss          , Mm^Xm       , Ce          , Gs^Fp       , Gs^Fp       , Wwf         , Ss^Vhs      , Wwf         , Ww          , Gg          , Gg          , Gg          , Wwf         , Wwf         , Gg          , Gg          , Rd          , Hh          , Hh          
Gs^Fp       ,Gs^Fp       , Rd          , Rd          , Rd          , Gs^Fp       , Rd          , Ww^Vm       , Ww          , Ww          , Ww          , Ss          , Ss          , Wwf         , Hh          , Gg          , Ss          , Ss          , Mm^Xm       , Hh          , Mm          , Mm          , Mm          , Hh          , Mm^Xm       , Ss          , Ss          , Gg          , Hh          , Wwf         , Ss          , Ss          , Ww          , Ww          , Ww          , Ww^Vm       , Gg          , Gs^Fp       , Rd          , Rd          , Rd          , Gs^Fp       , Gs^Fp       
Mm          ,Mm          , Gs^Fp       , Mm          , Hh          , Rd          , Gs^Fp       , Gg          , Gs^Fp       , Gs^Fp       , Ww          , Gs^Fp       , Mm          , Ss          , Ss          , Ss          , Mm^Xm       , Gs^Fp       , Mm^Xm       , Mm^Xm       , Mm^Xm       , Mm^Xm       , Mm^Xm       , Mm^Xm       , Mm^Xm       , Gs^Fp       , Mm^Xm       , Ss          , Ss          , Ss          , Mm          , Gs^Fp       , Ww          , Gs^Fp       , Gs^Fp       , Gg          , Gs^Fp       , Rd          , Gs^Fp       , Mm          , Hh          , Mm          , Mm          
Mm          ,Mm          , Gs^Fp       , Mm          , Hh          , Rd          , Gs^Fp       , Gg          , Gs^Fp       , Gs^Fp       , Ww          , Gs^Fp       , Mm          , Ss          , Ss          , Ss          , Mm^Xm       , Gs^Fp       , Mm^Xm       , Mm^Xm       , Mm^Xm       , Mm^Xm       , Mm^Xm       , Mm^Xm       , Mm^Xm       , Gs^Fp       , Mm^Xm       , Ss          , Ss          , Ss          , Mm          , Gs^Fp       , Ww          , Gs^Fp       , Gs^Fp       , Gg          , Gs^Fp       , Rd          , Gs^Fp       , Mm          , Hh          , Mm          , Mm          
