Wo          , Wo          , Wo          , Wo          , Wo          , Wo          , Wo          , Wo          , Ww          , Ww          , Ww          , Ww          , Wo          , Uh          , Wo          , Uh          , Ww          , Ww          , Ww          , Ww          , Ww          , Ww          , Wo          , Wo          , Wo          , Wo          , Wo          
Wo          , Wo          , Wo          , Wo          , Wo          , Ww          , Ww          , Ww          , Ww          , Gs^Fp       , Ww          , Xu          , Xu          , Uu^Uf       , Xu          , Mm          , Gs^Fp       , Gs^Fp       , Ww          , Ww          , Ww          , Ww          , Wo          , Wo          , Wo          , Wo          , Wo          
Wo          , Wo          , Wo          , Wo          , Wo          , Ww          , Ww          , Ww          , Ww          , Gg          , Gg          , Ww          , Uh          , Xu          , Gs^Fp       , Ww          , Hh          , Gg          , Gg          , Gs^Fp       , Ww          , Ww          , Ww          , Wo          , Wo          , Wo          , Wo          
Wo          , Wo          , Wo          , Ww          , Ww          , Ww          , Ww          , Gs^Fp       , Gg^Vh       , Wwf         , Mm          , Gg          , Xu          , Xu          , Ww          , Ww          , Gs^Fp       , Gg          , Rd          , Ss^Vhs      , Hh          , Ww          , Ww          , Ww          , Ww          , Ww          , Wo          
Wo          , Ww          , Wo          , Ww          , Ww          , Gg          , Wwf         , Wwf         , Wwf         , Xu          , Hh          , Rr          , Uh          , Gg^Fet      , Uu^Uf       , Xu          , Wwf         , Wwf         , Gg          , Wwf         , Wwf         , Wwf         , Ww          , Ww          , Ww          , Ww          , Ww          
Wo          , Ww          , Ww          , Ww          , Gg          , Rd          , Chw         , Kh          , Ch          , Ww          , Xu          , Rr          , Uu^Uf       , Uh          , Xu          , Xu          , Uh          , Xu          , Wwf         , Wwf         , Gg          , Hh          , Mm          , Ww          , Xu          , Xu          , Xu          
Ww          , Ww          , Ww          , Ww          , Gs^Fp       , Mm          , Hh          , Wwf         , Wwf         , Wwf         , Gs^Fp       , Wwf         , Rr          , Uu^Uf       , Rd          , Gs^Fp       , Xu          , Rr          , Mm          , Ww          , Gg          , Gg^Ve       , Hh          , Ww          , Ww          , Ww          , Xu          
Ww          , Ww          , Ww          , Ww          , Gg          , Wwf         , Gg^Fet      , Wwf         , Uu^Uf       , Xu          , Ss^Vhs      , Xu          , Uh          , Wwf         , Uh          , Xu          , Gg          , Gg          , Hh          , Chw         , Gg          , Rd          , Wwf         , Xu          , Wo          , Wo          , Xu          
Ww          , Ww          , Ww          , Gg          , Ww          , Gg          , Wwf         , Xu          , Xu          , Re          , Xu          , Re          , Re          , Ww          , Re          , Re          , Xu          , Gg          , Gg          , Ww          , Ch          , Ch          , Rd          , Xu          , Xu          , Uh          , Xu          
Ww          , Ww          , Gg          , Rd          , Gs^Fp       , Gg          , Rd          , Rd          , Re          , Gg^Ve       , Re          , Gs^Fp       , Ww          , Wo          , Ww          , Ww          , Gg          , Wwf         , Wwf         , Re          , Ww          , Kh          , Re          , Re          , Uu^Vu       , Uu^Uf       , Xu          
Ww          , Gg          , Gg          , Kh          , Gg          , Rd          , Rd          , Hh          , Gs^Fp       , Gg          , Gg          , Gg          , Ww          , Wo          , Wo          , Ww          , Wwf         , Gg          , Gs^Fp       , Re          , Re          , Gg          , Gg          , Re          , Re          , Wwf         , Xu          
Ww          , Gg          , Ch          , 1 Kh        , Ch          , Ggf         , Gg          , Gg          , Gg          , Gg          , Gs^Fp       , Ww          , Ww          , Ww          , Ww          , Wwf         , Ww^Vm       , Kh          , Re          , Hh          , Gs^Fp       , Gg          , Hh          , Re          , Wwf         , Ww          , Xu          
Ww          , Gg          , Ch          , Kh          , Ch          , Gg          , Gg          , Xu          , Gg          , Hh          , Ww          , Wwf         , Wwf         , Rr          , Ww          , Chw         , Kh          , Wwf         , Re          , Re          , Gg          , Re          , Re          , Gg          , Gs^Fp       , Ww          , Ww          
Gg          , Gg          , Rd          , Rd          , Gg          , Ww          , Ww          , Xu          , Re          , Gg          , Ww          , Chw         , Wwf         , Rr          , Wwf         , Wwf         , Ww          , Gs^Fp       , Re          , Xu          , Re          , 2 Kud       , Gg          , Rd          , Gg          , Ww          , Ww          
Ww          , Gg          , Gg          , Rd          , Gg          , Mm          , Xu          , Gs^Fp       , Re          , Kh          , Kh          , Wwf         , Ww          , Mm          , Wwf         , Ww          , Ww          , Gg          , Gg          , Xu          , Uu^Uf       , Uh          , Cud         , Cud         , Gg          , Gg          , Uh          
Ww          , Rd          , Gg          , Rd          , Rd          , Gs^Fp       , Hh          , Gs^Fp       , Re          , Gg          , Ww^Vm       , Ww          , Ww          , Wo          , Ww          , Ww          , Ww          , Gg          , Gg          , Gg          , Xu          , Gg          , Kud         , Cud         , Rd          , Gg          , Xu          
Xu          , Rd          , Xu          , Wwf         , Rd          , Re          , Gg          , Re          , Gg          , Wwf         , Wwf         , Ww          , Ww          , Ww          , Ww          , Ww          , Gs^Fp       , Rd          , Gg^Ve       , Gg          , Gg          , Kud         , Cud         , Gg          , Rd          , Xu          , Xu          
Xu          , Uu^Uf       , Uu^Uf       , Uu^Vu       , Uh          , Uu          , Re          , Gg          , Gg          , Xu          , Ww          , Hh          , Gs^Fp       , Gs^Fp       , Hh          , Chw         , Gg          , Hh          , Gs^Fp       , Xu          , Rd          , Rd          , Gg          , Rd          , Rd          , Gg          , Uu^Uf       
Xu          , Cud         , Wwf         , Xu          , Xu          , Ww          , Ww          , Cud         , Xu          , Xu          , Xu          , Xu          , Chw         , Xu          , Chw         , Xu          , Xu          , Xu          , Xu          , Gs^Fp       , Gg          , Rd          , Rd          , Xu          , Gg          , Gg          , Xu          
Xu          , Uh          , Ww          , Ww          , Ww          , Gg          , Kud         , Cud         , Rd          , Uu^Vu       , Rr          , Uu^Uf       , Uh          , Rr          , Uh          , Uu^Uf       , Rr          , Uu^Vu       , Rd          , Rd          , Gg          , Rd          , Gg          , Ss          , Uu^Uf       , Cud         , Xu          
Xu          , Xu          , Ww          , Ss          , Ss^Vhs      , Rd          , Rd          , Xu          , Rr          , Rr          , Uh          , Xu          , Wwf         , Wwf         , Wwf         , Xu          , Uh          , Rr          , Rr          , Xu          , Rd          , Gg          , Ss^Vhs      , Gg          , Rd          , Cud         , Xu          
Xu          , Xu          , Xu          , Xu          , Rr          , Rr          , Rd          , Rd          , Xu          , Rd          , Xu          , Wwf         , Wwf         , Rr          , Wwf         , Wwf         , Xu          , Rd          , Xu          , Rd          , Rd          , Kud         , Gg          , Xu          , Xu          , Xu          , Xu          
Xu          , Xu          , Xu          , Xu          , Cud         , Cud         , Gg          , Gg          , Rd          , Gg          , Gg          , Wwf         , Mm          , Gg^Fet      , Hh          , Gg          , Wwf         , Gg          , Rd          , Gg          , Gg          , Cud         , Cud         , Xu          , Xu          , Xu          , Xu          
Xu          , Xu          , Xu          , Xu          , Xu          , Rr          , Uu^Uf       , Uu^Uf       , Gg^Ve       , Gg          , Wwf         , Gg          , Gg          , Gg          , Gg^Fet      , Gg          , Wwf         , Gg          , Gg^Ve       , Uu^Uf       , Uu^Uf       , Rr          , Xu          , Xu          , Xu          , Xu          , Xu          
Xu          , Xu          , Xu          , Xu          , Xu          , Rd          , Xu          , Xu          , Xu          , Gg^Fet      , Wwf         , Gs^Fp       , Hh          , Rr          , Mm          , Hh          , Wwf         , Wwf         , Xu          , Xu          , Xu          , Rd          , Xu          , Xu          , Xu          , Xu          , Xu          
Xu          , Xu          , Xu          , Xu          , Xu          , Xu          , Rd          , Rr          , Rr          , Wwf         , Wwf         , Gg          , Gg          , Xu          , Rr          , Rr          , Gg          , Gs^Fp       , Wwf         , Wwf         , Rr          , Xu          , Xu          , Xu          , Xu          , Xu          , Xu          
Xu          , Xu          , Xu          , Xu          , Xu          , Xu          , Xu          , Wwf         , Chw         , Wwf         , Gg          , Rd          , Xu          , Uu^Uf       , Xu          , Rr          , Gg          , Gg          , Wwf         , Wwf         , Chw         , Wwf         , Xu          , Xu          , Xu          , Xu          , Xu          
Xu          , Xu          , Xu          , Xu          , Xu          , Xu          , Wwf         , Xu          , Wwf         , Rr          , Rd          , Rd          , Uh          , Rd          , Uu^Uf       , Rd          , Rd          , Rr          , Rr          , Xu          , Wwf         , Xu          , Xu          , Xu          , Xu          , Xu          , Xu          
Xu          , Xu          , Xu          , Xu          , Xu          , Xu          , Xu          , Xu          , Xu          , Xu          , Xu          , Uu^Uf       , Rr          , Rr          , Rd          , Uu^Uf       , Xu          , Xu          , Xu          , Xu          , Xu          , Xu          , Xu          , Xu          , Xu          , Xu          , Xu          
Xu          , Xu          , Xu          , Xu          , Xu          , Xu          , Xu          , Xu          , Xu          , Xu          , Xu          , Xu          , Xu          , Xu          , Uh          , Xu          , Xu          , Xu          , Xu          , Xu          , Xu          , Xu          , Xu          , Xu          , Xu          , Xu          , Xu          
