border_size=1
usage=map

_off^_usr   , _off^_usr   , _off^_usr   , _off^_usr   , _off^_usr   , _off^_usr   , _off^_usr   , _off^_usr   , _off^_usr   , _off^_usr   , _off^_usr   , _off^_usr   , _off^_usr   , _off^_usr   , _off^_usr   , _off^_usr   , _off^_usr   , _off^_usr   , _off^_usr   , _off^_usr   , _off^_usr   , _off^_usr   , _off^_usr   , _off^_usr   , _off^_usr   , _off^_usr   , _off^_usr   , _off^_usr   , _off^_usr   , _off^_usr   , _off^_usr   , _off^_usr   , _off^_usr   , _off^_usr   , _off^_usr   , _off^_usr   , _off^_usr   
_off^_usr   , _off^_usr   , _off^_usr   , _off^_usr   , _off^_usr   , _off^_usr   , _off^_usr   , _off^_usr   , _off^_usr   , _off^_usr   , _off^_usr   , _off^_usr   , _off^_usr   , _off^_usr   , _off^_usr   , _off^_usr   , _off^_usr   , _off^_usr   , _off^_usr   , _off^_usr   , _off^_usr   , _off^_usr   , _off^_usr   , _off^_usr   , _off^_usr   , _off^_usr   , _off^_usr   , _off^_usr   , _off^_usr   , _off^_usr   , _off^_usr   , _off^_usr   , _off^_usr   , _off^_usr   , _off^_usr   , _off^_usr   , _off^_usr   
_off^_usr   , _off^_usr   , _off^_usr   , _off^_usr   , _off^_usr   , _off^_usr   , _off^_usr   , _off^_usr   , _off^_usr   , _off^_usr   , _off^_usr   , _off^_usr   , _off^_usr   , _off^_usr   , _off^_usr   , _off^_usr   , _off^_usr   , _off^_usr   , _off^_usr   , _off^_usr   , _off^_usr   , _off^_usr   , _off^_usr   , _off^_usr   , _off^_usr   , _off^_usr   , _off^_usr   , _off^_usr   , _off^_usr   , _off^_usr   , _off^_usr   , _off^_usr   , _off^_usr   , _off^_usr   , _off^_usr   , _off^_usr   , _off^_usr   
_off^_usr   , _off^_usr   , _off^_usr   , _off^_usr   , _off^_usr   , _off^_usr   , _off^_usr   , _off^_usr   , _off^_usr   , _off^_usr   , Mm          , Gg^Fet      , Hh          , Hh          , Rd          , Gs          , Rd          , Mm^Vhh      , 2 Ke        , Gs^Fp       , Hh          , Gs^Fp       , Hh          , Mm          , Gg^Fet      , Gs^Fp       , Gs          , _off^_usr   , _off^_usr   , _off^_usr   , _off^_usr   , _off^_usr   , _off^_usr   , _off^_usr   , _off^_usr   , _off^_usr   , _off^_usr   
_off^_usr   , _off^_usr   , _off^_usr   , _off^_usr   , _off^_usr   , _off^_usr   , _off^_usr   , _off^_usr   , Hh          , Mm          , Gs          , Gs          , Rd          , Ce          , Ke          , Ce          , Re          , Re          , Re          , Ce          , Ce          , Wwf         , Ke          , Ce          , Ce          , Hh          , Rd          , Rd          , Gs^Fp       , _off^_usr   , _off^_usr   , _off^_usr   , _off^_usr   , _off^_usr   , _off^_usr   , _off^_usr   , _off^_usr   
_off^_usr   , _off^_usr   , _off^_usr   , _off^_usr   , _off^_usr   , _off^_usr   , Wwf         , Gs          , Wwf         , Gg^Fet      , Gs          , Rd          , Hh          , Rd          , Ww          , Mm          , Gs^Fp       , Re          , Gs^Fp       , Re          , Wwf         , Re          , Re          , Ce          , Rd          , Ce          , Ce          , Gs          , Hh          , Gs          , Gs          , _off^_usr   , _off^_usr   , _off^_usr   , _off^_usr   , _off^_usr   , _off^_usr   
_off^_usr   , _off^_usr   , _off^_usr   , _off^_usr   , Gs^Fp       , Hh          , Gs          , Wwf         , Chw         , Wwf         , Wwf         , Mm          , Rr          , Gs          , Ww          , Ww          , Ww          , Hh          , Wwf         , Wwf         , Rd          , Gs^Fp       , Gs          , Mm          , Gs          , Ww          , Rd          , Re          , Mm          , Gs^Fp       , Gs          , Gg^Fet      , Hh          , _off^_usr   , _off^_usr   , _off^_usr   , _off^_usr   
_off^_usr   , _off^_usr   , _off^_usr   , Mm          , Gs          , Gs          , Gs          , Rr          , Gs          , Gs          , Ss^Vhs      , Wwf         , Chr         , Wwf         , Chw         , Wo          , Ww          , Hh          , Wwf         , Mm          , Gs          , Rd          , Ss^Vhs      , Gs          , Rd          , Gs          , Gs          , Re          , Wwf         , Gs          , Gs          , Gs          , Wwf         , Mm          , _off^_usr   , _off^_usr   , _off^_usr   
_off^_usr   , _off^_usr   , _off^_usr   , Gs^Fp       , Rd          , Gs          , Gs          , Gs          , Gs          , Re          , Re          , Hh          , Wwf         , Khr         , Wwf         , Chw         , Chw         , Wwf         , Gs          , Gs          , Gs          , Rd          , Gs^Fp       , Hh          , Rd          , Gs          , Ss^Vhs      , Wwf         , Khr         , Wwf         , Wwf         , Wwf         , Gs^Fp       , Wwf         , _off^_usr   , _off^_usr   , _off^_usr   
_off^_usr   , _off^_usr   , _off^_usr   , Gs          , Chw         , Rd          , Gs          , Gs          , Mm          , Hh          , Re          , Gs          , Gs          , Wwf         , Rr          , Wwf         , Ww          , Wwf         , Gs          , Gs          , Rr          , Rd          , Hh          , Mm          , Gs          , Ww          , Ww          , Ss          , Chs         , Gs          , Gs          , Gs          , Gs^Fp       , Hh          , _off^_usr   , _off^_usr   , _off^_usr   
_off^_usr   , _off^_usr   , _off^_usr   , Hh          , Gs          , Gs          , Gs^Fp       , Rr          , Wwf         , Gs          , Gs          , Re          , Re          , Gs^Fp       , Gs          , Gs          , Ww          , Gs          , Ss^Vhs      , Rr          , Chw         , Gs          , Gs          , Gs          , Wwf         , Ww          , Ww          , Ww          , Chw         , Chw         , Rr          , Gs          , Gs          , Gs          , _off^_usr   , _off^_usr   , _off^_usr   
_off^_usr   , _off^_usr   , _off^_usr   , Gs          , Gs          , Gs          , Rr          , Wwf         , Gs          , Gs          , Chw         , Mm          , Re          , Re          , Gs          , Ww          , Gs          , Gs          , Gs          , Rd          , Gs          , Chw         , Gs          , Gg^Vh       , Gg^Fet      , Wwf         , Gs          , Wwf         , Wwf         , Gs          , Gs          , Gs          , Mm          , Wo          , _off^_usr   , _off^_usr   , _off^_usr   
_off^_usr   , _off^_usr   , _off^_usr   , Mm          , Hh          , Gs          , Gs          , Wo          , Wo          , Chw         , Wwf         , Chw         , Gg^Fet      , Gs^Vht      , Gs          , Ww          , Wwf         , Wwf         , Wwf         , Gs^Fp       , Rr          , Gs          , Gs          , Gs          , Wwf         , Wwf         , Gs          , Gs          , Gg^Fet      , Wwf         , Wwf         , Gs          , Wwf         , Hh          , _off^_usr   , _off^_usr   , _off^_usr   
_off^_usr   , _off^_usr   , _off^_usr   , Hh          , Gs^Fp       , Gs          , Gs          , Gs          , Gs^Fp       , Wwf         , Gs          , Rr          , Gs          , Gs          , Wwf         , Wwf         , Ai          , Aa^Fpa      , Chw         , Wwf         , Wwf         , Rr          , Wwf         , Wwf         , Mm          , Hh          , Gs^Fp       , Rd          , Rd          , Hh          , Gs          , Wwf         , Gs^Fp       , Wwf         , _off^_usr   , _off^_usr   , _off^_usr   
_off^_usr   , _off^_usr   , _off^_usr   , Wo          , Chw         , Gs          , Gs          , Gs          , Gs          , Gg^Fet      , Gs          , Hh          , Rd          , Hh          , Wwf         , Aa          , Aa^Fpa      , Ha          , Aa^Fpa      , Ai          , Wwf         , Wo          , Rd          , Gs^Fp       , Rd          , Gs          , Chs         , Chw         , Chw         , Rd          , Rd          , Gs          , Rr          , Hh          , _off^_usr   , _off^_usr   , _off^_usr   
_off^_usr   , _off^_usr   , _off^_usr   , Mm          , Rr          , Gs          , Gs          , Gs          , Rr          , Gs          , Gs          , Chs         , Chs         , Rd          , Chw         , Wwf         , Ha          , Chr         , Khr         , Ha          , Ha          , Chw         , Chw         , Chr         , Chs         , Chs         , Chs         , Rd          , Gs          , Rd          , Gs          , Gs          , Hh          , Mm          , _off^_usr   , _off^_usr   , _off^_usr   
_off^_usr   , _off^_usr   , _off^_usr   , Gs^Fp       , Gs          , Gs          , Gs          , Rr          , Chw         , Rd          , Chs         , Chs         , Rr          , Chr         , Rd          , Chw         , Wwf         , Ha          , Aa^Fpa      , Chr         , Aa^Fpa      , Wwf         , Wwf         , Rd          , Rd          , Rr          , Mm          , Gs          , Gs^Fp       , Gs          , Gs          , Gs          , Gs^Fp       , Wo          , _off^_usr   , _off^_usr   , _off^_usr   
_off^_usr   , _off^_usr   , _off^_usr   , Wwf         , Wwf         , Wwf         , Wwf         , Gs^Fp       , Hh          , Chw         , Gs          , Wwf         , Mm          , Gs^Fp       , Wwf         , Wo          , Wwf         , Ai          , Chw         , Ha          , Ai          , Aa          , Wwf         , Hh          , Re          , Hh          , Wwf         , Rd          , Hh          , Rd          , Gs          , Gs          , Rd          , Chw         , _off^_usr   , _off^_usr   , _off^_usr   
_off^_usr   , _off^_usr   , _off^_usr   , Hh          , Gs          , Gs          , Gs          , Wwf         , Wwf         , Gs          , Wwf         , Wwf         , Wwf         , Wwf         , Gs          , Rr          , Rr          , Wwf         , Wwf         , Aa^Fpa      , Wwf         , Wwf         , Gs          , Re          , Gg^Fet      , Gs          , Wwf         , Mm          , Wwf         , Gs          , Wwf         , Rr          , Gs          , Rd          , _off^_usr   , _off^_usr   , _off^_usr   
_off^_usr   , _off^_usr   , _off^_usr   , Wo          , Re          , Gg^Fet      , Gs^Vht      , Gs          , Chw         , Wwf         , Ww          , Ww          , Wwf         , Gs          , Gs          , Gs          , Gs          , Gs^Fp       , Gs          , Wwf         , Gs          , Ww          , Gs          , Re          , Re          , Gg^Vh       , Rr          , Chw         , Chw         , Wo          , Wo          , Wwf         , Rr          , Gs          , _off^_usr   , _off^_usr   , _off^_usr   
_off^_usr   , _off^_usr   , _off^_usr   , Re          , Hh          , Re          , Gs          , Gs          , Chw         , Chs         , Ss          , Ww          , Ww          , Wwf         , Gs          , Chw         , Chw         , Gs          , Ss^Vhs      , Gs          , Ww          , Ww          , Gs          , Gs          , Re          , Re          , Gs          , Chw         , Gg^Fet      , Gs          , Gs          , Rr          , Chw         , Gs^Fp       , _off^_usr   , _off^_usr   , _off^_usr   
_off^_usr   , _off^_usr   , _off^_usr   , Mm          , Gs^Fp       , Gs          , Gs          , Gs          , Gs          , Khr         , Wwf         , Ss^Vhs      , Re          , Gs          , Rd          , Rr          , Gs          , Rd          , Gs          , Gs          , Ww          , Gs          , Gs^Fp       , Gs          , Gs^Fp       , Re          , Re          , Gs          , Mm          , Gs^Fp       , Gs          , Gs          , Gs          , Gs          , _off^_usr   , _off^_usr   , _off^_usr   
_off^_usr   , _off^_usr   , _off^_usr   , Wwf         , Wwf         , Gs          , Wwf         , Wwf         , Wwf         , Wwf         , Re          , Re          , Mm          , Hh          , Gs^Fp       , Mm          , Gs          , Gs          , Rr          , Wwf         , Wwf         , Ww          , Wwf         , Wwf         , Ss          , Hh          , Gs          , Re          , Hh          , Rd          , Gs          , Gs          , Gs^Fp       , Hh          , _off^_usr   , _off^_usr   , _off^_usr   
_off^_usr   , _off^_usr   , _off^_usr   , Gs          , Re          , Wwf         , Gs          , Gs          , Gs          , Re          , Gs          , Gs          , Rd          , Hh          , Ss^Vhs      , Rd          , Gs          , Gs          , Wwf         , Wwf         , Rr          , Chw         , Chw         , Rr          , Khr         , Ss^Vhs      , Wwf         , Re          , Gs          , Gs          , Gs          , Gs          , Gs          , Gs^Fp       , _off^_usr   , _off^_usr   , _off^_usr   
_off^_usr   , _off^_usr   , _off^_usr   , Hh          , Gg^Fet      , Re          , Re          , Re          , Re          , Re          , Chw         , Gs          , Gs^Fp       , Gs          , Gs          , Rd          , Rd          , Mm          , Wwf         , Hh          , Wwf         , Chw         , Wo          , Chr         , Wwf         , Rr          , Gg^Fet      , Wwf         , Wwf         , Wwf         , Wwf         , Gs          , Hh          , Hh          , _off^_usr   , _off^_usr   , _off^_usr   
_off^_usr   , _off^_usr   , _off^_usr   , Mm          , Gs^Fp       , Re          , Re          , Re          , Re          , Re          , Re          , Ww          , Rd          , Hh          , Wwf         , Hh          , Wwf         , Wwf         , Gs^Fp       , Hh          , Gs^Fp       , Ww          , Ww          , Ww          , Gs          , Mm          , Gs          , Gs          , Gg^Fet      , Gs          , Gs          , Wwf         , Wwf         , Mm          , _off^_usr   , _off^_usr   , _off^_usr   
_off^_usr   , _off^_usr   , _off^_usr   , _off^_usr   , _off^_usr   , Gs          , Hh          , Gs^Fp       , Hh          , Ww          , Gs^Fp       , Re          , Re          , Re          , Gs          , Wwf         , Wwf         , Rd          , Rd          , Rd          , Rd          , Mm          , Gs          , Gs^Fp       , Gs          , Hh          , Re          , Re          , Hh          , Gs          , Gs          , Gs          , _off^_usr   , _off^_usr   , _off^_usr   , _off^_usr   , _off^_usr   
_off^_usr   , _off^_usr   , _off^_usr   , _off^_usr   , _off^_usr   , _off^_usr   , _off^_usr   , Mm          , Hh          , Rd          , Gs          , Gs          , Re          , Mm          , Hh          , Ke          , Ww          , Re          , Re          , Re          , Re          , Rd          , Rd          , Ke          , Gs          , Gs          , Hh          , Re          , Mm          , Gs^Fp       , _off^_usr   , _off^_usr   , _off^_usr   , _off^_usr   , _off^_usr   , _off^_usr   , _off^_usr   
_off^_usr   , _off^_usr   , _off^_usr   , _off^_usr   , _off^_usr   , _off^_usr   , _off^_usr   , _off^_usr   , _off^_usr   , Mm          , Gs^Fp       , Ce          , Ce          , Ce          , Ce          , Ce          , Gs^Fp       , Mm          , Ce          , 1 Ke        , Ce          , Mm^Vhh      , Hh          , Ce          , Ce          , Rd          , Gs^Fp       , Gs^Fp       , _off^_usr   , _off^_usr   , _off^_usr   , _off^_usr   , _off^_usr   , _off^_usr   , _off^_usr   , _off^_usr   , _off^_usr   
_off^_usr   , _off^_usr   , _off^_usr   , _off^_usr   , _off^_usr   , _off^_usr   , _off^_usr   , _off^_usr   , _off^_usr   , _off^_usr   , _off^_usr   , Gg^Fet      , _off^_usr   , Gs^Fp       , _off^_usr   , Gs          , _off^_usr   , Hh          , _off^_usr   , Gg^Fet      , _off^_usr   , Gs^Fp       , _off^_usr   , Mm          , _off^_usr   , Gs          , _off^_usr   , _off^_usr   , _off^_usr   , _off^_usr   , _off^_usr   , _off^_usr   , _off^_usr   , _off^_usr   , _off^_usr   , _off^_usr   , _off^_usr   
_off^_usr   , _off^_usr   , _off^_usr   , _off^_usr   , _off^_usr   , _off^_usr   , _off^_usr   , _off^_usr   , _off^_usr   , _off^_usr   , _off^_usr   , _off^_usr   , _off^_usr   , _off^_usr   , _off^_usr   , _off^_usr   , _off^_usr   , _off^_usr   , _off^_usr   , _off^_usr   , _off^_usr   , _off^_usr   , _off^_usr   , _off^_usr   , _off^_usr   , _off^_usr   , _off^_usr   , _off^_usr   , _off^_usr   , _off^_usr   , _off^_usr   , _off^_usr   , _off^_usr   , _off^_usr   , _off^_usr   , _off^_usr   , _off^_usr   
_off^_usr   , _off^_usr   , _off^_usr   , _off^_usr   , _off^_usr   , _off^_usr   , _off^_usr   , _off^_usr   , _off^_usr   , _off^_usr   , _off^_usr   , _off^_usr   , _off^_usr   , _off^_usr   , _off^_usr   , _off^_usr   , _off^_usr   , _off^_usr   , _off^_usr   , _off^_usr   , _off^_usr   , _off^_usr   , _off^_usr   , _off^_usr   , _off^_usr   , _off^_usr   , _off^_usr   , _off^_usr   , _off^_usr   , _off^_usr   , _off^_usr   , _off^_usr   , _off^_usr   , _off^_usr   , _off^_usr   , _off^_usr   , _off^_usr   
