Ss, Gs, Gs, Gs, Ss, Ss, Ss, Ss, Gs, Gs, Gs, Ss, Ss, Gs, Gs, Gs, Ww, Ww, Gs, Uh, Xu, Xu, Xu
Gs, Gs^Ft, Gs^Ft, Ss, Ss, Ss, 1 Gs^Ft, Ss, Ss, Gs, Gs, Gs^Ft, Gs, Ss^Vhs, Gs, Gs^Ft, Ww, Ww, Gs^Ft, Uh, Xu, Xu, Xu
Ww, Ww, Gs, Gs, Gs, Gs, Gs, Ss, Gs, Ss, Gs, Gs, Gs, Gs, Ww, Gs, Gs, Gs, Gs, Tb^Tf, Uu^Vu, Xu, Xu
Xu, Xu, Gs, Ww, Ww, Ww, Ww, Gs, Kud, Gs, Ww, Ww, Ww, Ww, Gs, Gs, Ww, Gs, Xu, Rb, Rb, Cud, Ss
Xu, Xu, Gs, Gs, Gs, Ww, Gs, Wo, Cud, Wo, Gs, Ww, Gs, Gs, Gs, Ww, Ww, Gs, Rb, Ss, Rb, Rb, Ss
Gs, Gs^Ft, Gs, Ww, Ww, Gs, Gs, Kud, Cud, Kud, Gs, Gs, Ww, Ww, Ww, Gs, Gs, Gs, Rb, Rb, Uu^Vud, Rb, Rb
Ww, Ww, Ww, Gs, Gs, Ww, Gs, Gs, Wwf, Gs, Gs, Gs, Gs, Gs, Ww, Ww, Gs, Xu, Rb, Rb, Cud, Rb, Xu
Gs, Gs, Ww, Gs, Ww, Gs, Gd, Gd, Uu^Vud, Gd, Gd, Hh, Kud, Gs, Gs, Gs, Kud, Xu, Xu, Rb, Xu, Kud, Xu
Ww, Ww, Gs, Ww, Gs, Gs, Gd^Ft, Xu, Xu, Xu, Gd, Cud, Cud, Cud, Gs, Gd, Ss^Vhs, Cud, Ww, Xu, Xu, Cud, Ww
Gs, Gs, Gs^Vht, Gs, Gs, Gs, Gs, Cud, Wwf, Wwf, Wwf, Gs, Gs, Gs, Gs, Gd, Gd, Gs, Gs, Cud, Wwf, Ww, Ww
Ww, Gs^Ft, Wwf, Cud, Re^Tf, Gs, Wwf, Wwf, Ss^Vhs, Gs^Ft, Gs, Wwf, Gs, Re, Re^Ft, Gs, Gs, Gs, Ww, Xu, Kud, Cud, Xu
Gs, Ww, Xu, Kud, Re, Gs, Wwf, Ss, Gs, Re, Re, Wwf, Gs, Mm, Re^Ft, Re, Gs, Gs^Ft, Uh, Xu, Xu, Uh, Xu
Ww, Gs^Ft, Xu, Re^Ft, Re, Gs, Gs, Wwf, Wwf, Gs, Wwf, Wwf, Wwf, Gs, Gs, Re, Re^Tf, Gd, Kud, Xu, Xu, Gs^Ft, Gs^Ft
Uh, Ww, Xu, Cud, Xu, Re, Re, Gs, Wwf, Wwf, Hh, Tb^Tf, Gs, Wwf, Wwf, Uh, Cud, Re^Ft, Cud, Re^Ft, Xu, Cud, Xu
Xu, Uh, Xu, Tb^Tf, Cud, Xu, Cud, Gs, Wwf, Gs^Ft, Gs, Mm, Hh, Gs^Ft, Wwf, Gs, Re, Xu, Xu, Tb^Tf, Xu, Uh, Uh
Gs, Cud, Xu, Re^Ft, Kud, Re^Ft, Re^Tf, Uh, Gs, Wwf, Wwf, Tb^Tf, Wwf, Wwf, Wwf, Gs, Gs, Re, Re, Cud, Xu, Ww, Ww
Xu, Gs^Ft, Xu, Xu, Uh, Gd, Gs, Re, Re^Ft, Gs, Gs, Wwf, Gs, Gs, Gs, Wwf, Wwf, Gs, Re, Re^Ft, Xu, Gs^Ft, Gs^Ft
Xu, Uh, Kud, Xu, Ww, Gs^Ft, Gs, Re, Re^Ft, Mm, Gs, Wwf, Gs, Re, Ss^Vhs, Ss, Wwf, Gs, Re^Tf, Kud, Wwf, Ww, Ww
Ww, Cud, Wwf, Xu, Gs, Gs, Gd, Gs, Gs, Re, Gs, Wwf, Wwf, Gs^Ft, Wwf, Wwf, Gs, Gs, Re, Cud, Gs^Vht, Gs^Ft, Gs
Ww, Ww, Xu, Cud, Ww, Gg, Ss^Vhs, Gd, Gs, Gs, Cud, Gs, Gd, Wwf, Xu, Cud, Gd^Ft, Gs, Gs, Gs, Gs, Gs, Gs
Xu, Cud, Xu, Xu, Xu, Cud, Kud, Gd, Gs, Cud, Kud, Cud, Gd, Xu, Uu^Vud, Xu, Gd, Gs, Ww, Ww, Ww, Ww, Ww
Xu, Kud, Cud, Rb, Rb, Xu, Gs, Gs, Ww, Gs, Gs, Hh, Gs, Gd, Wwf, Gd, Gs, Gs, Gs, Gs, Ww, Gs, Gs
Rb, Rb, Uu^Vud, Rb, Rb, Xu, Gs, Ww, Ww, Gs, Ww, Gs, Gs, Gs, Cud, Gs, Gs, Ww, Ww, Gs, Gs, Ww, Ww
Ss, Rb, Rb, Rb, Rb, Gs, Ww, Gs, Gs, Ww, Gs, Gs, Gs, 2 Kud, Cud, Kud, Gs, Gs, Gs, Ww, Gs, Gs^Ft, Gs
Ss, Rb, Rb, Ss, Xu, Gs, Ww, Ww, Gs, Gs, Ww, Ww, Ww, Wo, Kud, Wo, Ww, Ww, Ww, Gs, Gs, Xu, Xu
Cud, Cud, Uu^Vu, Rb, Gs, Gs, Gs, Gs, Ww, Ww, Gs, Ww, Gs, Gs, Gs, Gs, Gs, Ww, Gs, Ww, Gs, Xu, Xu
Xu, Xu, Xu, Tb^Tf, Gs^Ft, Gs, Ww, Gs, Gs, Gs, Gs, Gs, Gs, Ss, Ss, Ss, Gs, Gs, Ss, Gs, Gs^Ft, Ww, Ww
Xu, Xu, Xu, Uh, Xu, Ww, Gs^Ft, Gs, Ss, Ss^Vhs, Ss, Gs^Ft, Gs, Gs, Ss, Gs, Gs^Ft, Ss, Ss, Ss, Ss, Uh, Uh
Ww, Ww, Ww, Xu, Xu, Xu, Ss, Gs, Ss, Xu, Xu, Xu, Ss, Ss, Gs, Xu, Xu, Xu, Xu, Gs^Ft, Ss, Xu, Xu
Ww, Ww, Ww, Xu, Xu, Xu, Ss, Xu, Ss, Xu, Xu, Xu, Ss, Ss, Gs, Xu, Xu, Xu, Xu, Gs, Ss, Xu, Xu
