border_size=1
usage=map

_off^_usr   , _off^_usr   , _off^_usr   , _off^_usr   , _off^_usr   , _off^_usr   , _off^_usr   , _off^_usr   , _off^_usr   , _off^_usr   , _off^_usr   , _off^_usr   , _off^_usr   , _off^_usr   , _off^_usr   , _off^_usr   , _off^_usr   , _off^_usr   , _off^_usr   , _off^_usr   , _off^_usr   , _off^_usr   , _off^_usr   , _off^_usr   , _off^_usr   , _off^_usr   , _off^_usr   , _off^_usr   , _off^_usr   , _off^_usr   , _off^_usr   , _off^_usr   , _off^_usr   , _off^_usr   , _off^_usr   , _off^_usr   , _off^_usr   , _off^_usr   , _off^_usr   , _off^_usr   , _off^_usr   , _off^_usr   , _off^_usr   
_off^_usr   , _off^_usr   , _off^_usr   , _off^_usr   , _off^_usr   , _off^_usr   , _off^_usr   , _off^_usr   , _off^_usr   , _off^_usr   , _off^_usr   , _off^_usr   , _off^_usr   , _off^_usr   , _off^_usr   , _off^_usr   , _off^_usr   , _off^_usr   , Gs^Vht      , Gs^Ft       , Wwf         , Wwf         , Mm          , Mm          , Chs         , _off^_usr   , _off^_usr   , _off^_usr   , _off^_usr   , _off^_usr   , _off^_usr   , _off^_usr   , _off^_usr   , _off^_usr   , _off^_usr   , _off^_usr   , _off^_usr   , _off^_usr   , _off^_usr   , _off^_usr   , _off^_usr   , _off^_usr   , _off^_usr   
_off^_usr   , _off^_usr   , _off^_usr   , _off^_usr   , _off^_usr   , _off^_usr   , _off^_usr   , _off^_usr   , _off^_usr   , _off^_usr   , _off^_usr   , _off^_usr   , _off^_usr   , _off^_usr   , _off^_usr   , _off^_usr   , Rd          , Rd          , Rd          , Wwf         , Chw         , Wwf         , Rd          , Rd          , Rd          , Ss          , Ss^Vhs      , _off^_usr   , _off^_usr   , _off^_usr   , _off^_usr   , _off^_usr   , _off^_usr   , _off^_usr   , _off^_usr   , _off^_usr   , _off^_usr   , _off^_usr   , _off^_usr   , _off^_usr   , _off^_usr   , _off^_usr   , _off^_usr   
_off^_usr   , _off^_usr   , _off^_usr   , _off^_usr   , _off^_usr   , _off^_usr   , _off^_usr   , _off^_usr   , _off^_usr   , _off^_usr   , _off^_usr   , _off^_usr   , _off^_usr   , _off^_usr   , Ss          , Rd          , Chr         , Chr         , Chr         , Chw         , Chw         , Chw         , Chr         , Chr         , Chr         , Rd          , Gs^Ft       , Gs^Ft       , Rd^Uf       , _off^_usr   , _off^_usr   , _off^_usr   , _off^_usr   , _off^_usr   , _off^_usr   , _off^_usr   , _off^_usr   , _off^_usr   , _off^_usr   , _off^_usr   , _off^_usr   , _off^_usr   , _off^_usr   
_off^_usr   , _off^_usr   , _off^_usr   , _off^_usr   , _off^_usr   , _off^_usr   , _off^_usr   , _off^_usr   , _off^_usr   , _off^_usr   , _off^_usr   , _off^_usr   , Gs^Ft       , Ss^Vhs      , Rd          , Rd          , Rd          , 1 Kh        , Chw         , Wwf         , Rd          , Wwf         , Chw         , 4 Kh        , Wwf         , Rd          , Rd          , Rd          , Rd          , Rd          , Ss^Vhs      , _off^_usr   , _off^_usr   , _off^_usr   , _off^_usr   , _off^_usr   , _off^_usr   , _off^_usr   , _off^_usr   , _off^_usr   , _off^_usr   , _off^_usr   , _off^_usr   
_off^_usr   , _off^_usr   , _off^_usr   , _off^_usr   , _off^_usr   , _off^_usr   , _off^_usr   , _off^_usr   , _off^_usr   , _off^_usr   , Gs^Ft       , Rd^Uf       , Rd          , Gs^Ft       , Rd          , Rd          , Wwf         , Wwf         , Rd          , Rd          , Rd          , Rd          , Wwf         , Wwf         , Rd          , Wwf         , Wwf         , Wwf         , Wwf         , Rd          , Wwf         , Wwf         , Wwf         , _off^_usr   , _off^_usr   , _off^_usr   , _off^_usr   , _off^_usr   , _off^_usr   , _off^_usr   , _off^_usr   , _off^_usr   , _off^_usr   
_off^_usr   , _off^_usr   , _off^_usr   , _off^_usr   , _off^_usr   , _off^_usr   , _off^_usr   , _off^_usr   , Gs^Ft       , Mm          , Mm          , Hh          , Rd          , Rd          , Rd          , Rd          , Wwf         , Rd          , Gs^Ft       , Hh          , Rd          , Rd          , Wwf         , Rd          , Rd          , Rd          , Rd          , Rd          , Wwf         , Wwf         , Rd          , Chw         , Rd          , Mm          , Gs^Ft       , _off^_usr   , _off^_usr   , _off^_usr   , _off^_usr   , _off^_usr   , _off^_usr   , _off^_usr   , _off^_usr   
_off^_usr   , _off^_usr   , _off^_usr   , _off^_usr   , _off^_usr   , _off^_usr   , Hh          , Chr         , Chw         , Rd          , Rd          , Gs^Ft       , Rd          , Rd          , Wwf         , Wwf         , Rd          , Mm^Vhh      , Rd          , Gs^Ft       , Rd          , Wwf         , Mm          , Wwf         , Rd          , Chw         , Chw         , Rd          , Rd          , Chw         , Chr         , Rd          , Rd          , Rd          , Rd          , Ss^Vhs      , Gs^Ft       , _off^_usr   , _off^_usr   , _off^_usr   , _off^_usr   , _off^_usr   , _off^_usr   
_off^_usr   , _off^_usr   , _off^_usr   , _off^_usr   , Rd          , Rd          , Rd          , Hh^Uf       , Rd          , Rd          , Rd          , Rd          , Rd          , Rd          , Wwf         , Gs^Ft       , Rd          , Rd          , Chr         , Rd          , Rd          , Wwf         , Wwf         , Wwf         , Wwf         , Rd          , Rd          , Rd          , Rd          , Rd^Uf       , Kh          , Chr         , Chr         , Chr         , Kh          , Rd          , Rd          , Rd          , Rd          , _off^_usr   , _off^_usr   , _off^_usr   , _off^_usr   
_off^_usr   , _off^_usr   , Wwf         , Rd          , Wwf         , Wwf         , Wwf         , Rd          , Rd          , Rd          , Wwf         , Ss^Vhs      , Chw         , Wwf         , Hh          , Mm          , Rd          , Rd          , Chw         , Wwf         , Wwf         , Wwf         , Ss^Vhs      , Hh          , Mm          , Wwf         , Wwf         , Rd          , Hh^Vhh      , Hh          , Rd          , Rd          , Rd          , Rd          , Rd          , Rd          , Hh          , Hh          , Rd          , Gs^Ft       , Hh          , _off^_usr   , _off^_usr   
_off^_usr   , _off^_usr   , Chw         , Wwf         , Gs^Ft       , Gs^Ft       , Gs^Vht      , Wwf         , Wwf         , Wwf         , Wwf         , Hh          , Mm          , Rd          , Rd          , Hh          , Rd          , Rd          , Kh          , Mm          , Mm^Xm       , Mm^Xm       , Hh          , Mm^Xm       , Mm^Xm       , Mm          , Hh          , Wwf         , Rd          , Gs^Ft       , Rd          , Rd          , Mm          , Hh          , Rd          , Gs^Ft       , Gs^Ft       , Mm          , Rd          , Gs^Vht      , Rd          , _off^_usr   , _off^_usr   
_off^_usr   , _off^_usr   , Wwf         , Mm          , Rd          , Rd          , Rd          , Rd          , Rd          , Rd          , Rd          , Wwf         , Wwf         , Wwf         , Wwf         , Rd          , Chw         , Chw         , Mm^Xm       , Chw         , Rp          , Rp          , Rp          , Mm^Xm       , Wwf         , Wwf         , Wwf         , Wwf         , Wwf         , Rd          , Wwf         , Wwf         , Wwf         , Wwf         , Wwf         , Rd          , Rd          , Rd          , Rd          , Rd          , Rd          , _off^_usr   , _off^_usr   
_off^_usr   , _off^_usr   , Gs^Ft       , Wwf         , Hh          , Rd          , Hh          , Chw         , Gs^Ft       , Rd          , Rd          , Rd          , Rd          , Gs^Ft       , Hh          , Wwf         , Wwf         , Mm^Xm       , Mm          , Hh          , Rd^Uf       , Rd          , Rd          , Rp          , Wwf         , Mm^Xm       , Hh          , Gs^Ft       , Rd          , Wwf         , Ss^Vhs      , Rd          , Rd          , Rd          , Gs^Ft       , Wwf         , Wwf         , Wwf         , Wwf         , Chw         , Rd^Uf       , _off^_usr   , _off^_usr   
_off^_usr   , _off^_usr   , Rd^Uf       , Wwf         , Wwf         , Gs^Ft       , Wwf         , Mm          , Gs^Ft       , Hh          , Rd          , Rd          , Ss^Vhs      , Rd          , Rd          , Rd          , Hh          , Wwf         , Wwf         , Rp          , Rd          , Chw         , Rd^Uf       , Rp          , Mm          , Wwf         , Wwf         , Rd          , Hh          , Rd          , Rd          , Rd          , Rd          , Hh          , Gs^Ft       , Mm          , Hh          , Hh          , Gs^Ft       , Wwf         , Gs^Ft       , _off^_usr   , _off^_usr   
_off^_usr   , _off^_usr   , Rd          , Chw         , Rd          , Wwf         , Rd          , Wwf         , Wwf         , Rd          , Wwf         , Rd          , Wwf         , Wwf         , Wwf         , Gs^Ft       , Wwf         , Mm^Xm       , Wwf         , Rp          , Rp          , Rd          , Rp          , Hh          , Mm^Xm       , Mm^Xm       , Chw         , Wwf         , Wwf         , Gs^Ft       , Wwf         , Rd          , Rd          , Rd          , Rd          , Chw         , Rd          , Rd          , Rd          , Wwf         , Wwf         , _off^_usr   , _off^_usr   
_off^_usr   , _off^_usr   , Rd          , Rd          , Rd          , Rd          , Gs^Ft       , Hh          , Rd          , Wwf         , Mm          , Wwf         , Rd          , Rd          , Rd          , Wwf         , Hh          , Wwf         , Mm^Xm       , Mm^Xm       , Hh          , Rp          , Mm^Xm       , Chw         , Kh          , Chw         , Rd          , Rd          , Rd          , Wwf         , Mm          , Wwf         , Wwf         , Rd          , Rd          , Rd          , Gs^Vht      , Rd          , Gs^Ft       , Mm          , Chw         , _off^_usr   , _off^_usr   
_off^_usr   , _off^_usr   , Hh          , Gs^Vht      , Rd          , Mm          , Hh          , Gs^Ft       , Rd          , Hh          , Rd          , Rd          , Rd          , Gs^Ft       , Hh^Vhh      , Wwf         , Wwf         , Mm          , Mm          , Mm^Xm       , Ss^Vhs      , Mm^Xm       , Wwf         , Mm          , Chw         , Rd          , Rd          , Hh          , Hh          , Rd          , Chw         , Hh          , Wwf         , Wwf         , Wwf         , Wwf         , Wwf         , Gs^Ft       , Wwf         , Wwf         , Wwf         , _off^_usr   , _off^_usr   
_off^_usr   , _off^_usr   , _off^_usr   , Gs^Ft       , Rd          , Hh          , Rd          , Rd          , Kh          , Rd          , Chr         , Rd          , Kh          , Hh          , Rd          , Rd          , Rd          , Wwf         , Wwf         , Hh          , Wwf         , Wwf         , Rd          , Wwf         , Chr         , Rd          , Rd          , Mm          , Wwf         , Wwf         , Rd          , Ss^Vhs      , Rd          , Rd          , Rd          , Rd          , Rd          , Wwf         , Rd          , Rd          , _off^_usr   , _off^_usr   , _off^_usr   
_off^_usr   , _off^_usr   , _off^_usr   , _off^_usr   , _off^_usr   , Rd          , Gs^Ft       , Rd          , Rd          , Chr         , Rd          , Chr         , Chr         , Rd^Uf       , Rd          , Rd          , Chw         , Rd          , Rd          , Wwf         , Mm          , Wwf         , Rd          , Rd          , Rd          , Rd          , Rd          , Gs^Ft       , Wwf         , Rd          , Rd          , Rd          , Rd          , Rd          , Chw         , Hh^Uf       , Hh          , Rd          , _off^_usr   , _off^_usr   , _off^_usr   , _off^_usr   , _off^_usr   
_off^_usr   , _off^_usr   , _off^_usr   , _off^_usr   , _off^_usr   , _off^_usr   , _off^_usr   , Ss^Vhs      , Gs^Ft       , Rd          , Rd          , Rd          , Rd          , Chw         , Wwf         , Rd          , Rd          , Chw         , Rd          , Wwf         , Wwf         , Wwf         , Rd          , Gs^Ft       , Gs^Ft       , Mm^Vhh      , Wwf         , Wwf         , Rd          , Rd          , Rd          , Gs^Ft       , Mm          , Rd          , Gs^Ft       , Chr         , _off^_usr   , _off^_usr   , _off^_usr   , _off^_usr   , _off^_usr   , _off^_usr   , _off^_usr   
_off^_usr   , _off^_usr   , _off^_usr   , _off^_usr   , _off^_usr   , _off^_usr   , _off^_usr   , _off^_usr   , _off^_usr   , Mm          , Wwf         , Chw         , Wwf         , Wwf         , Wwf         , Rd          , Wwf         , Rd          , Rd          , Rd          , Wwf         , Rd          , Rd          , Hh          , Rd          , Rd          , Wwf         , Rd          , Rd          , Rd          , Rd          , Hh          , Gs^Ft       , Mm          , _off^_usr   , _off^_usr   , _off^_usr   , _off^_usr   , _off^_usr   , _off^_usr   , _off^_usr   , _off^_usr   , _off^_usr   
_off^_usr   , _off^_usr   , _off^_usr   , _off^_usr   , _off^_usr   , _off^_usr   , _off^_usr   , _off^_usr   , _off^_usr   , _off^_usr   , _off^_usr   , Wwf         , Ss^Vhs      , Rd          , Rd          , Wwf         , Rd          , Wwf         , Wwf         , Wwf         , Chw         , Rd          , Rd          , Rd          , Chw         , Wwf         , Rd          , Rd          , Rd          , Gs^Ft       , Gs^Ft       , Rd^Uf       , _off^_usr   , _off^_usr   , _off^_usr   , _off^_usr   , _off^_usr   , _off^_usr   , _off^_usr   , _off^_usr   , _off^_usr   , _off^_usr   , _off^_usr   
_off^_usr   , _off^_usr   , _off^_usr   , _off^_usr   , _off^_usr   , _off^_usr   , _off^_usr   , _off^_usr   , _off^_usr   , _off^_usr   , _off^_usr   , _off^_usr   , _off^_usr   , Rd          , Rd^Uf       , Rd          , Gs^Ft       , Rd          , Chr         , 2 Kh        , Chr         , Wwf         , Chw         , Wwf         , Chr         , 3 Kh        , Chr         , Rd          , Ss          , Ss^Vhs      , _off^_usr   , _off^_usr   , _off^_usr   , _off^_usr   , _off^_usr   , _off^_usr   , _off^_usr   , _off^_usr   , _off^_usr   , _off^_usr   , _off^_usr   , _off^_usr   , _off^_usr   
_off^_usr   , _off^_usr   , _off^_usr   , _off^_usr   , _off^_usr   , _off^_usr   , _off^_usr   , _off^_usr   , _off^_usr   , _off^_usr   , _off^_usr   , _off^_usr   , _off^_usr   , _off^_usr   , _off^_usr   , Gs^Ft       , Ss^Vhs      , Rd          , Rd          , Chr         , Rd          , Chw         , Chw         , Chw         , Rd          , Chr         , Rd          , Rd          , _off^_usr   , _off^_usr   , _off^_usr   , _off^_usr   , _off^_usr   , _off^_usr   , _off^_usr   , _off^_usr   , _off^_usr   , _off^_usr   , _off^_usr   , _off^_usr   , _off^_usr   , _off^_usr   , _off^_usr   
_off^_usr   , _off^_usr   , _off^_usr   , _off^_usr   , _off^_usr   , _off^_usr   , _off^_usr   , _off^_usr   , _off^_usr   , _off^_usr   , _off^_usr   , _off^_usr   , _off^_usr   , _off^_usr   , _off^_usr   , _off^_usr   , _off^_usr   , Ss          , Chs         , Rd          , Rd          , Wwf         , Wwf         , Wwf         , Gs^Vht      , Rd          , _off^_usr   , _off^_usr   , _off^_usr   , _off^_usr   , _off^_usr   , _off^_usr   , _off^_usr   , _off^_usr   , _off^_usr   , _off^_usr   , _off^_usr   , _off^_usr   , _off^_usr   , _off^_usr   , _off^_usr   , _off^_usr   , _off^_usr   
_off^_usr   , _off^_usr   , _off^_usr   , _off^_usr   , _off^_usr   , _off^_usr   , _off^_usr   , _off^_usr   , _off^_usr   , _off^_usr   , _off^_usr   , _off^_usr   , _off^_usr   , _off^_usr   , _off^_usr   , _off^_usr   , _off^_usr   , _off^_usr   , _off^_usr   , Mm          , _off^_usr   , Wwf         , _off^_usr   , Gs^Ft       , _off^_usr   , _off^_usr   , _off^_usr   , _off^_usr   , _off^_usr   , _off^_usr   , _off^_usr   , _off^_usr   , _off^_usr   , _off^_usr   , _off^_usr   , _off^_usr   , _off^_usr   , _off^_usr   , _off^_usr   , _off^_usr   , _off^_usr   , _off^_usr   , _off^_usr   
_off^_usr   , _off^_usr   , _off^_usr   , _off^_usr   , _off^_usr   , _off^_usr   , _off^_usr   , _off^_usr   , _off^_usr   , _off^_usr   , _off^_usr   , _off^_usr   , _off^_usr   , _off^_usr   , _off^_usr   , _off^_usr   , _off^_usr   , _off^_usr   , _off^_usr   , _off^_usr   , _off^_usr   , _off^_usr   , _off^_usr   , _off^_usr   , _off^_usr   , _off^_usr   , _off^_usr   , _off^_usr   , _off^_usr   , _off^_usr   , _off^_usr   , _off^_usr   , _off^_usr   , _off^_usr   , _off^_usr   , _off^_usr   , _off^_usr   , _off^_usr   , _off^_usr   , _off^_usr   , _off^_usr   , _off^_usr   , _off^_usr   
