border_size=1
usage=map

Ch          , Ch          , Ch          , Gs^Fp       , Hh          , Gs^Fp       , Hh          , Mm          , Gs^Fp       , Ss          , Ss          , Ss          , Ss          , Ss          , Gg          , Hh          , Ss          , Ss          , Mm          , Mm          , Gg^Efm      , Hh          , Gs^Uf       , Mm          , Mm          , Ss          , Gs^Uf       , Gs          , Re          , Gg          , Gg          , Ss          , Gg^Efm      , Hh          , Mm          , Hh          , Ch          , Ch          , Ch          
Ch          , Ch          , Ch          , Hh          , Gg^Efm      , Mm          , Gs^Fds      , Mm          , Hh          , Gs^Uf       , Hh          , Ss          , Ss^Vhs      , Ss          , Gs^Fp       , Gg          , Gg          , Hh          , Gs^Fp       , Hh          , Gs^Fms      , Gg          , Gg          , Gs^Fp       , Gg          , Hh          , Gs^Fp       , Gs          , Gg          , Re          , Gs^Fp       , Hh          , Re          , Mm          , Gs^Fp       , Gs^Uf       , Ch          , Ch          , Ch          
Ch          , Ch          , 2 Kh        , Gg          , Gg          , Hh          , Re          , Re          , Re          , Gs^Fms      , Gg          , Gs^Fp       , Re          , Hh          , Gg          , Ch          , Kh          , Ch          , Gg          , Gg          , Gg          , Ch          , Kh          , Ch          , Gg          , Gg          , Hh          , Gg^Vh       , Re          , Re          , Re          , Re          , Gs^Fms      , Re          , Re          , Gg          , 4 Kh        , Ch          , Ch          
Gs^Fms      , Rp          , Rp          , Rp          , Rp          , Gg          , Hh          , Mm          , Hh          , Re          , Re          , Re          , Hh          , Re          , Re          , Re          , Gg          , Ch          , Ww          , Ww          , Ww          , Ch          , Gg          , Re          , Re          , Re          , Re          , Re          , Gg          , Hh          , Mm          , Mm          , Rp          , Gs^Vh       , Rp          , Re          , Rp          , Rp          , Rp          
Mm          , Gs^Fp       , Gg          , Gg^Vh       , Rp          , Gg          , Gs^Uf       , Gs^Fp       , Gs^Uf       , Gg          , Re          , Gg          , Gg          , Gg          , Gg^Vh       , Gg          , Wwf         , Ww          , Ww          , Ww^Vm       , Ww          , Ww          , Wwf         , Gg          , Gg^Vh       , Gg          , Re          , Hh          , Gs^Fds      , Hh          , Gs^Fms      , Rp          , Gs^Uf       , Rp          , Hh          , Rp          , Gg          , Gg          , Hh          
Hh          , Hh          , Re          , Gg          , Hh          , Rp          , Rp          , Hh          , Rp          , Gs^Vh       , Re          , Gg          , Gg^Efm      , Hh          , Gs^Fp       , Gg          , Wwf         , Ww          , Hh          , Wwf         , Gg          , Ww          , Wwf         , Gg          , Hh          , Gs^Fp       , Gg          , Re          , Re          , Gg^Ve       , Rp          , Rp          , Hh          , Gs^Uf       , Mm          , Gs          , Gs^Fp       , Gg          , Gg          
Ss          , Gs^Fp       , Re          , Mm          , Hh          , Gs^Fp       , Gs^Fms      , Rp          , Gg          , Rp          , Kh          , Ch          , Gg          , Hh          , Ww          , Ww          , Ww          , Gg          , Gg^Ve       , Gg          , Gs          , Gs^Fp       , Ww          , Ww          , Ww          , Mm          , Gg          , Ch          , Kh          , Rp          , Gs          , Gs^Fp       , Gg^Efm      , Mm          , Gs^Fp       , Gs          , Gg          , Gg          , Gg          
Hh          , Gg^Efm      , Gg          , Re          , Re          , Gg^Ve       , Gg^Efm      , Gg          , Mm          , Re          , Ch          , Ch          , Gg          , Ww          , Ww          , Ww          , Hh          , Gs^Fp       , Hh          , Gs^Uf       , Hh          , Hh          , Hh          , Ww          , Ww          , Ww          , Gg          , Ch          , Ch          , Re          , Re          , Gg          , Hh^Vhh      , Hh          , Re          , Gg          , Gg^Efm      , Gg^Efm      , Hh          
Gg          , Gg          , Ch          , Ch          , Re          , Gg          , Hh          , Mm          , Re          , Re          , Ww          , Gg          , Ww          , Ww^Bw\      , Kh          , Ww          , Gg^Vc       , Gg^Efm      , Mm          , Gs^Fms      , Gg          , Gs^Fds      , Gg^Ve       , Ww          , Kh          , Ww^Bw/      , Ww          , Ww          , Ww          , Gg          , Gs^Fp       , Re          , Hh          , Gs^Fds      , Re          , Ch          , Ch          , Gg          , Gg^Uf       
Gg^Efm      , Gg          , Ch          , Kh          , Gs^Fp       , Re          , Re          , Re          , Gg          , Gg^Ve       , Ww          , Ww          , Ww          , Ww          , Chw         , Chw         , Chr         , Gg          , Gg          , Gg          , Hh          , Gg          , Chr         , Chw         , Chs         , Ww          , Ww          , Ww          , Ww^Vm       , Gg          , Gg          , Re          , Re          , Re          , Hh          , Kh          , Ch          , Gg          , Gg          
Gg          , Gg          , Wwf         , Hh          , Ss          , Hh          , Re          , Gg          , Ww          , Ww          , Wo          , Wo          , Ww          , Gg          , Gs^Uf       , Gs          , Hh          , Rp          , Rp          , Rp          , Rp          , Rp          , Gg^Efm      , Gs^Fp       , Hh          , Ss          , Ww          , Wo          , Wo          , Ww          , Gg          , Gg          , Ww^Bw|      , Gs^Fp       , Ss          , Gs^Fp       , Wwf         , Gg          , Hh          
Wwf         , Wwf         , Wwf         , Ww          , Ss          , Ss^Vhs      , Ww^Bw|      , Ww          , Gg          , Ww          , Wo          , Wo          , Ww          , Gg          , Hh          , Gg^Vc       , Gg          , Gs^Fms      , Rp          , Chs         , Rp          , Gs^Fms      , Hh          , Gg^Vc       , Gs^Uf       , Gg          , Ww          , Wo          , Wo          , Ww          , Ww          , Ww          , Re          , Ss^Vhs      , Ss          , Ww          , Wwf         , Wwf         , Wwf         
Hh          , Gg          , Ch          , Gs^Fp       , Hh          , Gs^Fp       , Re          , Gg          , Gg          , Ww          , Ww^Vm       , Wo          , Ww          , Ss          , Chs         , Gs^Fp       , Chr         , Rp          , Hh          , Rp          , Gg          , Rp          , Chr         , Gs          , Chw         , Gg          , Ww          , Wo          , Ww          , Ww          , Gg          , Gg          , Re          , Hh          , Gs^Fp       , Hh          , Ch          , Gg          , Gg          
Gs^Uf       , Gg          , Ch          , Kh          , Re          , Re          , Hh          , Gs          , Gs          , Gg          , Ww          , Ww          , Ww          , Ww          , Kh          , Chw         , Gg^Ve       , Gg          , Gg          , Gg          , Mm          , Gg          , Gg^Vc       , Chw         , Kh          , Ww          , Ww          , Ww          , Ww          , Gg^Ve       , Re          , Re          , Gg          , Re          , Re          , Kh          , Ch          , Gg          , Gg^Uf       
Hh          , Gg^Efm      , Gg          , Ch          , Re          , Mm          , Gg^Vh       , Gs^Fds      , Gg^Efm      , Gg          , Ch          , Ww          , Gg          , Ww^Bw/      , Ww          , Ww          , Hh          , Gs^Fds      , Hh          , Gs^Fms      , Hh          , Gg^Efm      , Hh          , Ww          , Ww          , Ww^Bw\      , Gg          , Gg          , Ch          , Gg^Efm      , Re          , Gs^Fp       , Gs          , Gg          , Re          , Ch          , Gg          , Gg          , Gg          
Ss          , Ss          , Ss          , Gg          , Re          , Gg          , Rp          , Rp          , Rp          , Gg          , Kh          , Ch          , Gg          , Ww          , Ww          , Ww          , Ww          , Hh          , Gs          , Gs^Uf       , Gg^Ve       , Gs^Fp       , Ww          , Ww          , Ww          , Ww          , Gg          , Ch          , Kh          , Re          , Gg^Ve       , Hh          , Mm          , Hh          , Re          , Gg          , Gg^Vh       , Hh          , Hh          
Ss          , Ss          , Gg          , Gg          , Gg          , Rp          , Gs^Fp       , Gg          , Gg          , Rp          , Re          , Ch          , Gs          , Gs^Fp       , Hh          , Ww          , Wwf         , Gs^Fp       , Gg          , Gg          , Hh          , Gg          , Wwf         , Ww          , Gg          , Gs^Fp       , Re          , Ch          , Re          , Rp          , Rp          , Rp          , Rp          , Mm          , Gs^Fds      , Re          , Gs^Fp       , Ss          , Ss          
Ss          , Ss          , Hh          , Gg          , Rp          , Rp          , Gs^Uf       , Hh          , Gs^Uf       , Hh^Vhh      , Re          , Gs          , Re          , Gs^Fms      , Gg^Ve       , Gg          , Wwf         , Ww          , Ww          , Wwf         , Ww          , Ww          , Wwf         , Gg          , Gg^Vh       , Re          , Mm          , Re          , Gs^Fms      , Hh          , Gs^Uf       , Hh          , Gg^Uf       , Rp          , Re          , Re          , Gg          , Ss          , Hh          
Hh          , Mm          , Gg          , Gg          , Rp          , Gs          , Hh          , Gs^Fp       , Mm          , Gg          , Gg          , Re          , Gg          , Re          , Re          , Gg          , Gg          , Ww          , Ww          , Ww^Vm       , Ww          , Ww          , Gg          , Gg          , Gg          , Re          , Re          , Gs^Fp       , Gg          , Gs          , Gs^Fp       , Mm          , Hh          , Rp          , Gg^Vh       , Gg          , Gg          , Mm          , Mm          
Gs^Fp       , Gs^Fp       , 3 Kh        , Rp          , Aa^Vea      , Re          , Re          , Hh          , Re          , Re          , Re          , Re          , Aa^Vha      , Ha          , Aa          , Re          , Kh          , Ch          , Aa^Fpa      , Ww          , Aa^Fpa      , Ch          , Kh          , Re          , Re          , Gg          , Re          , Gg          , Ha          , Re          , Re          , Re          , Re          , Rp          , Rp          , Rp          , 1 Kh        , Aa^Fpa      , Ha          
Ch          , Ch          , Ch          , Ha          , Aa^Fpa      , Aa^Fda      , Aa^Fpa      , Re          , Ha          , Ai          , Ha          , Aa^Fpa      , Aa^Fpa      , Aa^Fda      , Aa          , Ch          , Aa^Fpa      , Ch          , Ha          , Ai          , Aa          , Ch          , Aa^Fpa      , Ch          , Ha          , Re          , Aa^Fpa      , Aa^Vea      , Aa          , Aa          , Ha          , Ai          , Ha          , Aa          , Aa^Fpa      , Aa^Fda      , Ch          , Ch          , Ch          
Ch          , Ch          , Ha          , Ai          , Ha          , Ms          , Ha          , Ai          , Aa^Fpa      , Ms          , Aa^Fpa      , Ha          , Aa^Fpa      , Ai          , Aa^Fpa      , Aa^Fpa      , Ha          , Aa^Fpa      , Ai          , Aa^Fpa      , Ha          , Ha          , Ai          , Aa^Fpa      , Aa^Fpa      , Re          , Ha          , Aa^Fpa      , Ai          , Ms          , Aa^Fpa      , Ai          , Ai          , Ms          , Mm^Xm       , Ha          , Ha          , Ch          , Ch          
Ch          , Ch          , Mm          , Ai          , Mm^Xm       , Ms          , Mm          , Ai          , Mm^Xm       , Mm^Xm       , Mm^Xm       , Ha          , Ai          , Ai          , Ms          , Ms          , Mm^Xm       , Aa^Fpa      , Ai          , Ha          , Ms          , Ms          , Ms          , Ai          , Aa^Fpa      , Re          , Re          , Ha          , Ai          , Ha          , Mm          , Ha          , Mm^Xm       , Mm^Xm       , Mm          , Mm^Xm       , Mm^Xm       , Ch          , Ch          
