border_size=1
usage=map

      Cud,      Cud,      Cud,       Uh,       Gg,       Xu,       Uh,    Uu^Uf,       Uh,    Uu^Uf,       Hh,       Ss,   Ss,       Ss,    Gs^Fp,       Hh,       Gg,       Hh,    Gs^Fp,       Mm,    Gs^Fp,       Hh,       Gg,       Hh,       Gg,       Hh,    Gs^Fp,       Gg,       Gg,       Rd,    Gs^Fp,       Hh,       Rd,       Uh,    Gs^Fp,    Uu^Uf,      Cud,      Cud,      Cud
      Cud,      Cud,      Cud,       Uh,       Gg,       Xu,       Uh,    Uu^Uf,       Uh,    Uu^Uf,       Hh,       Ss,   Ss^Vhs,       Ss,    Gs^Fp,       Hh,       Gg,       Hh,    Gs^Fp,       Mm,    Gs^Fp,       Hh,       Gg,       Hh,       Gg,       Hh,    Gs^Fp,       Gg,       Gg,       Rd,    Gs^Fp,       Hh,       Rd,       Uh,    Gs^Fp,    Uu^Uf,      Cud,      Cud,      Cud
      Cud,      Cud,     2 Kud,       Gg,       Gg,       Hh,       Rd,       Rd,       Rd,    Gs^Fp,       Gg,    Gs^Fp,       Rd,       Hh,       Gg,       Ch,       Kh,       Ch,       Gg,       Gg,       Gg,       Ch,       Kh,       Ch,       Gg,       Gg,       Hh,    Gg^Vh,       Rd,       Rd,       Rd,       Rd,    Gs^Fp,       Rd,       Rd,       Gg,     4 Kud,      Cud,      Cud
    Uu^Uf,    Uu^Uf,       Rd,       Rr,       Rr,       Rd,       Uh,       Xu,       Xu,       Rd,       Rd,       Rd,       Hh,       Rd,       Rd,       Rd,       Gg,       Ch,       Ww,       Ww,       Ww,       Ch,       Gg,       Rd,       Rd,       Rd,       Rd,       Rd,       Gg,       Hh,       Mm,       Mm,       Rr,    Gg^Vh,       Rr,       Gg,       Rr,    Uu^Uf,    Uu^Uf
    Gs^Fp,    Gs^Fp,       Rd,    Gg^Vh,       Rr,       Gg,    Uu^Uf,       Xu,       Gg,       Gg,       Rd,    Gs^Fp,       Gg,       Gg,    Gg^Vh,       Gg,      Wwf,       Ww,       Ww,    Ww^Vm,       Ww,       Ww,      Wwf,       Gg,    Gg^Vh,       Gg,       Rd,       Hh,    Gs^Fp,       Hh,    Gs^Fp,       Rr,       Uh,       Rr,    Uu^Uf,       Rr,       Gg,       Uh,       Uh
       Hh,       Hh,       Rd,       Gg,       Hh,       Rr,       Rr,       Uh,       Rr,    Gg^Vh,       Rd,       Gg,       Ww,       Hh,    Gs^Fp,       Gg,      Wwf,       Ww,       Hh,      Wwf,       Gg,       Ww,      Wwf,       Gg,       Hh,    Gs^Fp,       Gg,       Rd,       Rd,    Gg^Ve,       Rr,       Rr,       Xu,    Uu^Uf,       Xu,       Rd,    Gs^Fp,       Xu,       Xu
    Gs^Fp,    Gs^Fp,       Rd,       Mm,       Hh,    Gs^Fp,    Gs^Fp,       Rr,       Gg,       Rr,       Kh,       Ch,       Gg,       Hh,       Ww,       Ww,       Ww,       Gg,    Gs^Fp,       Gg,       Gg,    Gs^Fp,       Ww,       Ww,       Ww,       Mm,       Gg,       Ch,       Kh,       Rr,       Gg,    Gs^Fp,       Gg,       Xu,    Gs^Fp,       Rd,       Gg,    Uu^Uf,    Uu^Uf
    Gs^Fp,    Gs^Fp,       Gg,       Rd,       Rd,    Gg^Ve,       Hh,       Gg,       Mm,       Rd,       Ch,       Ch,       Gg,       Ww,       Ww,       Ww,       Hh,    Gs^Fp,       Hh,    Gg^Ve,       Hh,       Hh,       Hh,       Ww,       Ww,       Ww,       Gg,       Ch,       Ch,       Rd,       Rd,       Hh,   Hh^Vhh,       Hh,       Rd,       Rd,       Gg,       Ww,       Ww
       Gg,       Gg,       Ch,       Ch,       Rd,    Gs^Fp,       Mm,       Mm,       Rd,       Rd,       Ds,       Gg,       Ww,   Ww^Bw\,       Kh,       Ww,    Gg^Vh,       Gg,       Mm,    Gs^Fp,       Gg,    Gs^Fp,    Gg^Ve,       Ww,       Kh,   Ww^Bw/,       Ww,       Ds,       Ww,       Gg,    Gs^Fp,       Rd,       Hh,    Gs^Fp,       Rd,       Ch,       Ch,       Gg,       Gg
       Gg,       Gg,       Ch,       Kh,    Gs^Fp,       Rd,       Rd,       Rd,       Gg,    Gg^Ve,       Ww,       Ww,       Ww,       Ww,      Chw,      Chw,      Chr,       Gg,       Gg,       Gg,       Hh,       Gg,      Chr,      Chw,      Chs,       Ww,       Ww,       Ww,    Ww^Vm,       Gg,       Gg,       Rd,       Rd,       Rd,       Hh,       Kh,       Ch,       Gg,       Gg
       Gg,       Gg,      Wwf,       Hh,       Ss,       Hh,       Rd,       Gg,       Ww,       Ww,       Wo,       Ww,       Ww,       Gg,    Gs^Fp,       Gg,       Hh,       Rr,       Rr,       Rr,       Rr,       Rr,       Gg,    Gs^Fp,       Hh,       Ss,       Ww,       Wo,       Wo,       Ww,       Ww,       Gg,   Ww^Bw|,    Gs^Fp,       Ss,    Gs^Fp,      Wwf,       Gg,       Gg
      Wwf,      Wwf,      Wwf,       Ww,       Ss,   Ss^Vhs,   Ww^Bw|,       Ww,       Ww,       Ww,       Wo,       Wo,       Ww,       Gg,       Hh,    Gg^Ve,       Gg,    Gs^Fp,       Rr,      Chs,       Rr,    Gs^Fp,       Hh,    Gg^Vh,    Gs^Fp,       Gg,       Ww,       Wo,       Wo,       Ww,       Ww,       Ww,       Rd,   Ss^Vhs,       Ss,       Ww,      Wwf,      Wwf,      Wwf
       Gg,       Gg,       Ch,    Gs^Fp,       Hh,    Gs^Fp,       Rd,       Gg,       Ww,       Ww,    Ww^Vm,       Wo,       Ww,       Ss,      Chs,    Gs^Fp,      Chr,       Rr,       Hh,       Rr,       Gg,       Rr,      Chr,       Gg,      Chw,       Gg,       Ww,       Ww,       Ww,       Ww,       Gg,       Gg,       Rd,       Hh,    Gs^Fp,       Hh,       Ch,       Gg,       Gg
       Gg,       Gg,       Ch,       Kh,       Rd,       Rd,       Hh,       Gg,       Ds,       Gg,       Ww,       Ww,       Ww,       Ww,       Kh,      Chw,    Gg^Ve,       Gg,       Gg,       Gg,       Mm,       Gg,    Gg^Vh,      Chw,       Kh,       Ww,       Ww,       Ww,       Ds,    Gg^Ve,       Rd,       Rd,       Gg,       Rd,       Rd,       Kh,       Ch,       Gg,       Gg
       Gg,       Gg,       Gg,       Ch,       Rd,       Mm,    Gs^Fp,    Gg^Ve,       Gg,       Gg,       Ch,       Ds,       Gg,   Ww^Bw/,       Ww,       Ww,       Hh,    Gs^Fp,       Hh,    Gs^Fp,       Hh,       Gg,       Hh,       Ww,       Ww,   Ww^Bw\,       Gg,       Gg,       Ch,       Gg,       Rd,    Gs^Fp,       Ww,       Gg,       Rd,       Ch,       Gg,       Gg,       Gg
       Ss,       Ss,       Ss,       Gg,       Rd,       Gg,       Rr,       Rr,       Rr,       Gg,       Kh,       Ch,       Gg,       Ww,       Ww,       Ww,       Ww,       Hh,       Gg,    Gg^Vh,    Gs^Fp,    Gs^Fp,       Ww,       Ww,       Ww,       Ww,       Gg,       Ch,       Kh,       Rd,    Gg^Ve,       Hh,       Mm,       Hh,       Rd,       Gg,    Gg^Vh,       Hh,       Hh
       Ss,       Ss,       Gg,       Gg,       Gg,       Rr,    Gs^Fp,       Gg,       Gg,       Rr,       Rd,       Ch,       Ww,    Gs^Fp,       Hh,       Ww,      Wwf,    Gs^Fp,       Gg,       Gg,       Hh,       Gg,      Wwf,       Ww,       Gg,    Gs^Fp,       Rd,       Ch,       Rd,       Rr,       Rr,       Rr,       Rr,       Mm,    Gs^Fp,       Rd,    Gs^Fp,       Ss,       Ss
       Ss,       Ss,       Mm,       Gg,       Rr,       Rr,    Uu^Uf,       Uh,   Aa^Fpa,  Ha^Vhha,       Rd,       Gg,       Rd,    Gs^Fp,    Gg^Ve,       Gg,      Wwf,       Ww,       Ww,      Wwf,       Ww,       Ww,      Wwf,       Gg,    Gg^Vh,       Rd,       Mm,       Rd,    Gs^Fp,       Hh,       Xu,       Uh,    Uu^Uf,       Rr,       Rd,       Rd,       Gg,       Ss,       Ss
       Ss,       Ss,       Gg,       Gg,       Rr,       Gg,       Uh,       Xu,       Xu,       Ha,       Aa,       Rd,       Aa,       Rd,       Rd,       Gg,       Gg,       Ww,       Ww,    Ww^Vm,       Ww,       Ww,       Gg,       Gg,       Gg,       Rd,       Rd,    Gs^Fp,       Gg,       Gg,       Xu,       Xu,       Uh,       Rr,    Gg^Vh,       Gg,       Gg,       Xu,       Xu
    Gs^Fp,    Gs^Fp,     3 Kud,       Rr,   Aa^Vea,       Rd,       Rd,       Xu,       Rd,       Rd,       Rd,       Rd,   Aa^Vha,       Ha,       Aa,       Rd,       Kh,       Ch,   Aa^Fpa,       Ww,   Aa^Fpa,       Ch,       Kh,       Rd,       Rd,       Gg,       Rd,       Gg,       Ha,       Rd,       Rd,       Rd,       Rd,       Rr,       Rr,       Rr,     1 Kud,       Uh,       Uh
      Cud,      Cud,      Cud,       Ha,   Aa^Fpa,   Aa^Fpa,       Ai,       Rd,       Uh,       Ai,       Rd,       Aa,   Aa^Fpa,   Aa^Fpa,       Aa,       Ch,   Aa^Fpa,       Ch,       Ha,       Ai,       Aa,       Ch,   Aa^Fpa,       Ch,       Ha,       Rd,   Aa^Fpa,   Aa^Vea,       Aa,       Aa,       Uh,       Ai,       Ha,       Aa,   Aa^Fpa,   Aa^Fpa,      Cud,      Cud,      Cud
      Cud,      Cud,       Uh,       Ai,       Uh,       Xu,       Xu,    Uu^Uf,       Xu,    Uu^Uf,       Xu,       Ha,       Ai,       Ai,   Aa^Fpa,   Aa^Fpa,       Ha,   Aa^Fpa,       Ai,   Aa^Fpa,       Ha,       Ha,       Ai,   Aa^Fpa,   Aa^Fpa,       Rd,       Mm,   Aa^Fpa,       Ai,       Xu,       Xu,    Uu^Uf,       Uh,       Xu,       Xu,       Uh,       Xu,      Cud,      Cud
      Cud,      Cud,       Uh,       Ai,       Uh,       Xu,       Xu,    Uu^Uf,       Xu,    Uu^Uf,       Xu,       Ha,       Ai,       Ai,   Aa^Fpa,   Aa^Fpa,       Ha,   Aa^Fpa,       Ai,   Aa^Fpa,       Ha,       Ha,       Ai,   Aa^Fpa,   Aa^Fpa,       Rd,       Mm,   Aa^Fpa,       Ai,       Xu,       Xu,    Uu^Uf,       Uh,       Xu,       Xu,       Uh,       Xu,      Cud,      Cud
