border_size=1
usage=map

_off^_usr   , _off^_usr   , _off^_usr   , _off^_usr   , _off^_usr   , _off^_usr   , _off^_usr   , _off^_usr   , _off^_usr   , _off^_usr   , _off^_usr   , _off^_usr   , _off^_usr   , _off^_usr   , _off^_usr   , _off^_usr   , _off^_usr   , _off^_usr   , _off^_usr   , _off^_usr   , _off^_usr   , _off^_usr   
_off^_usr   , _off^_usr   , _off^_usr   , _off^_usr   , _off^_usr   , _off^_usr   , _off^_usr   , _off^_usr   , _off^_usr   , _off^_usr   , _off^_usr   , _off^_usr   , _off^_usr   , _off^_usr   , _off^_usr   , _off^_usr   , _off^_usr   , _off^_usr   , _off^_usr   , _off^_usr   , _off^_usr   , _off^_usr   
_off^_usr   , _off^_usr   , _off^_usr   , _off^_usr   , _off^_usr   , _off^_usr   , _off^_usr   , _off^_usr   , _off^_usr   , _off^_usr   , _off^_usr   , _off^_usr   , _off^_usr   , _off^_usr   , _off^_usr   , _off^_usr   , _off^_usr   , _off^_usr   , _off^_usr   , _off^_usr   , _off^_usr   , _off^_usr   
_off^_usr   , _off^_usr   , _off^_usr   , _off^_usr   , _off^_usr   , _off^_usr   , _off^_usr   , _off^_usr   , Hh^Vhh      , Gg          , Ch          , 2 Kh        , Ch          , Hh          , Ss^Vhs      , _off^_usr   , _off^_usr   , _off^_usr   , _off^_usr   , _off^_usr   , _off^_usr   , _off^_usr   
_off^_usr   , _off^_usr   , _off^_usr   , _off^_usr   , _off^_usr   , _off^_usr   , _off^_usr   , _off^_usr   , Gs^Fp       , Hh          , Ww          , Ch          , Gg          , Gs^Fp       , Ss          , _off^_usr   , _off^_usr   , _off^_usr   , _off^_usr   , _off^_usr   , _off^_usr   , _off^_usr   
_off^_usr   , _off^_usr   , _off^_usr   , _off^_usr   , _off^_usr   , _off^_usr   , _off^_usr   , _off^_usr   , _off^_usr   , Gg          , Ww^Bw/      , Ch          , Gg          , Gg          , _off^_usr   , _off^_usr   , _off^_usr   , _off^_usr   , _off^_usr   , _off^_usr   , _off^_usr   , _off^_usr   
_off^_usr   , _off^_usr   , _off^_usr   , _off^_usr   , _off^_usr   , _off^_usr   , _off^_usr   , _off^_usr   , _off^_usr   , Gg          , Ww          , Ww          , Ww          , Ss          , _off^_usr   , _off^_usr   , _off^_usr   , _off^_usr   , _off^_usr   , _off^_usr   , _off^_usr   , _off^_usr   
_off^_usr   , _off^_usr   , _off^_usr   , _off^_usr   , _off^_usr   , _off^_usr   , _off^_usr   , _off^_usr   , Ds          , Gg^Ve       , Wwf         , Gg          , Hh          , Ss^Vhs      , Ss          , _off^_usr   , _off^_usr   , _off^_usr   , _off^_usr   , _off^_usr   , _off^_usr   , _off^_usr   
_off^_usr   , _off^_usr   , _off^_usr   , Ss^Vhs      , Ss          , _off^_usr   , Ww          , Gg          , Ww          , Wwf         , Ds          , Gg          , Gs^Fp       , Gs^Fp       , Gg          , Ww          , Ds          , _off^_usr   , Gs^Fp       , Hh^Vhh      , _off^_usr   , _off^_usr   
_off^_usr   , _off^_usr   , _off^_usr   , Gg          , Ss          , Ss          , Ss          , Ww^Vm       , Ds          , Gg          , Hh          , Gg          , Gg^Vh       , Gg          , Ds          , Wwf         , Gg^Ve       , Gg          , Gg          , Hh          , _off^_usr   , _off^_usr   
_off^_usr   , _off^_usr   , _off^_usr   , Ch          , Ch          , Gs^Fp       , Ss^Vhs      , Gg          , Hh          , Chs         , Gs^Uf       , Hh          , Gs^Fp       , Gg          , Gg          , Wwf         , Ww          , Gg          , Ch          , Ch          , _off^_usr   , _off^_usr   
_off^_usr   , _off^_usr   , _off^_usr   , 4 Kh        , Ch          , Hh          , Ww          , Gg          , Gg          , Gs^Fp       , Gs^Fp       , Ss          , Gs^Uf       , Gs^Fp       , Hh          , Gg          , Ss^Vhs      , Hh          , Ch          , 3 Kh        , _off^_usr   , _off^_usr   
_off^_usr   , _off^_usr   , _off^_usr   , Ch          , Gg          , Gg          , Gg^Ve       , Wwf         , Ds          , Gg          , Gg^Vh       , Hh          , Hh          , Chs         , Ds          , Gg          , Ss          , Gs^Fp       , Ss          , Ch          , _off^_usr   , _off^_usr   
_off^_usr   , _off^_usr   , _off^_usr   , Hh          , Gs^Fp       , Gg          , Ds          , Wwf         , Gg          , Gg          , Gs^Fp       , Gg          , Ds          , Gg          , Ww          , Ww^Vm       , Ww          , Ss          , Ss          , Gg          , _off^_usr   , _off^_usr   
_off^_usr   , _off^_usr   , _off^_usr   , Hh^Vhh      , _off^_usr   , _off^_usr   , _off^_usr   , Ww          , Ss          , Gs^Fp       , Hh          , Gg          , Wwf         , Wwf         , Ds          , Gg          , _off^_usr   , _off^_usr   , _off^_usr   , Ss^Vhs      , _off^_usr   , _off^_usr   
_off^_usr   , _off^_usr   , _off^_usr   , _off^_usr   , _off^_usr   , _off^_usr   , _off^_usr   , _off^_usr   , _off^_usr   , Ss^Vhs      , Ww          , Gg          , Ww          , Gg^Ve       , _off^_usr   , _off^_usr   , _off^_usr   , _off^_usr   , _off^_usr   , _off^_usr   , _off^_usr   , _off^_usr   
_off^_usr   , _off^_usr   , _off^_usr   , _off^_usr   , _off^_usr   , _off^_usr   , _off^_usr   , _off^_usr   , _off^_usr   , Ss          , Gg          , Ww          , Ww^Bw/      , Gg          , _off^_usr   , _off^_usr   , _off^_usr   , _off^_usr   , _off^_usr   , _off^_usr   , _off^_usr   , _off^_usr   
_off^_usr   , _off^_usr   , _off^_usr   , _off^_usr   , _off^_usr   , _off^_usr   , _off^_usr   , _off^_usr   , Ss          , Gg          , Gg          , Ch          , Ww          , Gg          , Gs^Fp       , _off^_usr   , _off^_usr   , _off^_usr   , _off^_usr   , _off^_usr   , _off^_usr   , _off^_usr   
_off^_usr   , _off^_usr   , _off^_usr   , _off^_usr   , _off^_usr   , _off^_usr   , _off^_usr   , _off^_usr   , Ss^Vhs      , Gs^Fp       , Ch          , Ch          , Ch          , Hh          , Hh^Vhh      , _off^_usr   , _off^_usr   , _off^_usr   , _off^_usr   , _off^_usr   , _off^_usr   , _off^_usr   
_off^_usr   , _off^_usr   , _off^_usr   , _off^_usr   , _off^_usr   , _off^_usr   , _off^_usr   , _off^_usr   , _off^_usr   , Hh          , _off^_usr   , 1 Kh        , _off^_usr   , Gg          , _off^_usr   , _off^_usr   , _off^_usr   , _off^_usr   , _off^_usr   , _off^_usr   , _off^_usr   , _off^_usr   
_off^_usr   , _off^_usr   , _off^_usr   , _off^_usr   , _off^_usr   , _off^_usr   , _off^_usr   , _off^_usr   , _off^_usr   , _off^_usr   , _off^_usr   , _off^_usr   , _off^_usr   , _off^_usr   , _off^_usr   , _off^_usr   , _off^_usr   , _off^_usr   , _off^_usr   , _off^_usr   , _off^_usr   , _off^_usr   
_off^_usr   , _off^_usr   , _off^_usr   , _off^_usr   , _off^_usr   , _off^_usr   , _off^_usr   , _off^_usr   , _off^_usr   , _off^_usr   , _off^_usr   , _off^_usr   , _off^_usr   , _off^_usr   , _off^_usr   , _off^_usr   , _off^_usr   , _off^_usr   , _off^_usr   , _off^_usr   , _off^_usr   , _off^_usr   
