border_size=1
usage=map

Md          , Md          , Dd          , Dd          , Dd          , Dd          , Dd          , Dd          , Hd          , Md          , Dd          , Dd          , Hd          , Dd          , Dd          , Dd          , Mm          , Hh          , Gs^Ft       , Gs^Ft       , Mm          , Hh          , Hh          , Rd          , Gg          , Gs^Fp       , Hh          , Mm          , Mm          , Hh          , Gs^Fp       , Mm          , Mm          , Mm^Xm       , Hh          , Wwf         , Wwf         , Wwf         
Md          , Md          , Dd          , Dd          , Dd          , Hd          , Rd          , Dd          , Rd          , Hd          , Dd          , Dd          , Dd          , Md          , Dd          , Dd          , Mm          , Hh          , Gs^Ft       , Gs^Ft       , Mm          , Hh          , Hh          , Rd          , Gg          , Gs^Fp       , Hh          , Mm          , Mm          , Hh          , Gs^Fp       , Mm          , Mm          , Mm^Xm       , Hh          , Wwf         , Wwf         , Wwf         
Rd          , Rd          , Rd          , Dd^Vda      , Rd          , Rd          , Dd          , Rd          , Ch          , Rd          , Rr          , Dd^Vda      , Rr          , Dd          , Dd          , Gs          , Gs          , Mm          , Mm          , Gs^Ft       , Gs^Ft       , Gs^Ft       , Gs          , Rd          , Gg          , Gg          , Rr          , Rr          , Rr          , Gs^Fp       , Hh^Vhh      , Hh          , Ds          , Ds          , Wwf         , Wwf         , Wwf         , Wwf         
Md          , Md          , Hd          , Rd          , Dd          , Dd          , Ch          , Ch          , Wwt         , Rr          , Ch          , Rr          , Dd          , Rr          , Rr          , Rr          , Rr          , Gs          , Hh          , Gs^Ft       , Gs          , Gs          , Rr          , Rr          , Rr          , Rr          , Gs^Fp       , Gs          , Gs          , Rr          , Ds          , Ds          , Wwf         , Ds          , Wwf         , Wwf         , Gs^Fp       , Gs^Fp       
Md          , Md          , Rd          , Rd          , Dd^Do       , Dd          , Ch          , Ch          , 1 Kh        , Ww^Bw/      , Rr          , Dd          , Gs          , Gs          , Hh          , Gs^Vht      , Gs^Ft       , Rr          , Rr          , Gs^Vht      , Rr          , Rr          , Gs^Fp       , Gg^Ve       , Rr          , Gs^Fp       , Mm          , Wwt         , Wwt         , Ww^Bw|      , Ww          , Ww          , Ww          , Wwf         , Wwf         , Wwf         , Ch          , Gd          
Dd          , Dd          , Dd^Vdt      , Dd          , Dd          , Dd          , Ch          , Wwt         , Ww^Bw|      , Ww^Bw\      , Ch          , Rr          , Gs          , Mm          , Mm          , Wwt         , Wwt         , Gs          , Gs          , Rr          , Gs          , Gs^Fp       , Hh          , Hh          , Ww^Bw|      , Gs          , Wwt         , Wwt         , Wwt         , Ww^Bw|      , Ww          , Ww          , Gg          , Ch          , Gg          , Gg          , Gs          , Gd          
Dd          , Dd          , Rd          , Dd          , Gs          , Gs          , Gll         , Rr          , Ch          , Wwt         , Rr          , Rr          , Rr          , Gs^Ft       , Hh          , Wwt         , Gs          , Gs          , Rr          , Rr          , Gs^Fp       , Gg          , Wwf         , Wwt         , Gg          , Wwt         , Ww^Vm       , Wwt         , Gg          , Gll         , Gg^Vh       , Gs^Fp       , Gg          , Gg          , Hh          , Gg^Fet      , Gg^Vh       , Gs          
Gs          , Gs          , Rd          , Rd          , Gs          , Gd          , Gs^Ft       , Rr          , Gs          , Wwf         , Gs          , Gs          , Gs^Vht      , Rr          , Rr          , Gs          , Rr          , Rr          , Gs^Fp       , Mm          , Hh          , Gg          , Wwt         , Gg          , Gs^Fp       , Gg          , Wwf         , Wwr         , Gg          , Gll         , Gs^Fp       , Hh          , Ch          , Ww          , Gg^Fet      , Hh          , Gg          , Gs          
Gs          , Gs          , Rd          , Gs          , Ww          , Gs          , Gs          , Rr          , Gs          , Wwf         , Mm          , Gs^Ft       , Hh          , Gs^Ft       , Gs          , Rr          , Rr          , Gs          , Gs^Fp       , Hh          , Gg^Vh       , Gs^Fp       , Ww^Bw/      , Gg          , Gg^Ve       , Gg          , Wwf         , Wwf         , Gg          , Gll         , Gg          , Ch          , 2 Kh        , Ww          , Ww          , Ww          , Gs          , Gs          
Hh          , Hh          , Rd          , Gs          , Gs^Ft       , Gs          , Rr          , Rr          , Gs^Ft       , Ww          , Ww          , Gs^Ft       , Gs          , Gs          , Gs^Ft       , Rr          , Gs^Vht      , Rr          , Rr          , Gg          , Rr          , Rr          , Hh          , Wwt         , Wwt         , Hh          , Wwf         , Wwf         , Hh          , Gll         , Gll         , Ch          , Ww          , Gg^Fet      , Kh          , Ch          , Gs^Fp       , Gs          
Gs^Ft       , Gs^Ft       , Rd          , Gs^Ft       , Hh          , Gs          , Rr          , Gs^Vht      , Gs          , Hh          , Wwf         , Gs          , Ds          , Mm          , Hh          , Rr          , Gs^Ft       , Hh          , Gs^Ft       , Rr          , Rr          , Ch          , Gg          , Wwt         , Wwt         , Wwt         , Hh          , Gg          , Gs^Fp       , Gg^Ve       , Gll         , Ww          , Gg^Fet      , Ww          , Ch          , Ch          , Hh          , Hh          
Gs^Ft       , Gs^Ft       , Gs^Vht      , Hh          , Mm          , Gs          , Rr          , Gs^Ft       , Hh          , Gs          , Wwf         , Ds          , Wwt         , Ds          , Ds          , Rr          , Gs          , Gs^Ft       , Mm          , Gs          , Ch          , Rr          , Ww^Bw\      , Wwt         , Wwt         , Wwr         , Mm          , Gs          , Gs          , Ch          , Gll         , Hh          , Hh          , Ww          , Gll         , Gs          , Gs^Fp       , Gs^Fp       
Ss          , Ss          , Ss          , Gs^Ft       , Ss          , Gs          , Rr          , Gs          , Gs^Ft       , Mm          , Wwr         , Wwt         , Wwt         , Wwt         , Wwt         , Rr          , Wwt         , Gs          , Ds          , Ds          , Ds          , Gs          , Wwt         , Ww^Bw\      , Gll         , Gg          , Hh          , Mm          , Hh          , Gs          , Gll         , Gg^Fet      , Gll         , Gll         , Gs          , Hh^Vhh      , Hh          , Hh          
Ss          , Ss          , Ss          , Ss          , Wwt         , Wwt         , Ww^Bw|      , Wwr         , Wwt         , Wwr         , Wwt         , Wwt         , Ds          , Wwt         , Wwt         , Ww^Bw|      , Wwt         , Wwt         , Wwt         , Wwf         , Wwt         , Wwt         , Wwr         , Wwt         , Gg          , Gll         , Gll         , Gs^Fp       , Gll         , Gll         , Ch          , Gll         , Gg          , Ch          , Gg          , Gs^Fp       , Mm          , Mm          
Wwt         , Wwt         , Wwt         , Wwt         , Wwt         , Wwt         , Ww^Bw|      , Wwt         , Wwt         , Wwt         , Mm          , Hh          , Mm          , Mm          , Gg          , Ww^Bw|      , Ds          , Ww^Vm       , Wwt         , Wwt         , Wwt         , Wwf         , Ds          , Ds          , Gg          , Gs^Fp       , Gg^Vh       , Gll         , Hh          , Gs^Fp       , Hh          , Gll         , Gs^Fp       , Gg          , Ww          , Gg          , Hh          , Hh          
Wwt         , Wwt         , Wwt         , Wwt         , Gs^Fp       , Gg          , Re          , Gs^Fp       , Hh^Vhh      , Hh          , Gs^Fp       , Mm          , Gs^Fp       , Hh          , Gg          , Re          , Gg          , Wwf         , Wwf         , Wwr         , Wwf         , Ww^Vm       , Gg          , Gg          , Hh          , Hh          , Gll         , Gll         , Gg          , Ww          , Gg          , Gll         , Gs^Fp       , Ww          , Ww          , Gg          , Gs^Fp       , Gs^Fp       
Ss          , Ss          , Ss          , Hh          , Re          , Re          , Gg          , Re          , Re          , Re          , Re          , Gg          , Gg          , Gg^Ve       , Re          , Re          , Gs^Fp       , Gg          , Wwf         , Wwf         , Ds          , Gg          , Gs^Fp       , Ww          , Ww          , Gg          , Gll         , Gs^Fp       , Mm          , Gs          , Gll         , Gll         , Gll         , Gg^Vh       , Hh          , Gg          , Mm          , Mm          
Gg^Efm      , Ss          , Gg^Efm      , Ss          , Ww^Bw|      , Ss          , Gg          , Gg          , Re          , Gs^Fp       , Hh          , Re          , Re          , Re          , Hh          , Gs^Fp       , Mm          , Gg          , Wwf         , Ds          , Mm          , Gg          , Gs^Fp       , Mm          , Hh          , Gs          , Gll         , Gs^Fp       , Hh          , Gs^Fp       , Gll         , Gg          , Gg          , Gll         , Gg          , Gg          , Mm          , Mm          
Gg          , Gg^Efm      , Ss          , Ss          , Re          , Ss          , Ss          , Ss          , Ww^Bw|      , Ss^Vhs      , Ss          , Gg          , Re          , Gg          , Ss          , Ss          , Ss          , Wwr         , Wwt         , Ds          , Ds          , Gg          , Gg          , Gs^Fp       , Gll         , Gll         , Hh          , Ss^Vhs      , Gs^Fp       , Gll         , Hh          , Gg          , Ss          , Ww^Bw|      , Ss          , Gs^Fp       , Gs^Fp       , Gs^Fp       
Ss          , Ss          , Ss^Vhs      , Hh          , Re          , Gs^Fp       , Mm          , Ss          , Re          , Ss          , Gg^Efm      , Ss          , Ss          , Ww^Bw\      , Re          , Ss          , Wwt         , Wwt         , Wwt         , Wwt         , Wwt         , Hh          , Gll         , Gll         , Gg          , Gg          , Ss          , Ss          , Ss          , Gll         , Ss          , Ss          , Gg          , Gg          , Gg          , Gs^Fp       , Gg^Efm      , Ss          
Gs^Fp       , Gs^Fp       , Hh          , Gg          , Re          , Gg          , Ss          , Gg          , Re          , Gg          , Mm          , Ss          , Gg^Vh       , Hh          , Re          , Re          , Ww^Bw\      , Wwt         , Gg^Fet      , Wwt         , Ww^Bw/      , Gll         , Gg          , Gg          , Ss^Vhs      , Ss          , Ss          , Gs^Fp       , Ss          , Ww^Bw|      , Ss          , Gg^Efm      , Gg^Efm      , Gg^Vh       , Ss          , Gg          , Ss          , Ss          
Hh          , Hh          , Mm          , Gs^Fp       , Re          , Hh          , Gs^Fp       , Gs^Fp       , Re          , Hh          , Hh          , Gs^Fp       , Gg          , Re          , Gs^Fp       , Wwt         , Wwt         , Re          , Re          , Re          , Hh          , Wwt         , Wwt         , Gs^Fp       , Hh          , Hh          , Ss          , Gg^Efm      , Gg          , Gll         , Chr         , Gg^Efm      , Ww^Bw|      , Ss          , Gs^Fp       , Ss          , Ss          , Gg^Efm      
Mm^Xm       , Mm^Xm       , Mm^Xm       , Mm          , Gs^Fp       , Re          , Re          , Re          , Gs^Fp       , Re          , Re          , Gg          , Gg          , Re          , Hh          , Wwt         , Hh          , Hh^Vhh      , Re          , Gg^Fet      , Gg^Ve       , Wwr         , Wwt         , Gs^Fp       , Gg          , Ss          , Ss          , Ss          , Gs^Fp       , Gll         , Hh          , Gs^Fp       , Gll         , Gg          , Hh          , Mm^Xm       , Mm^Xm       , Mm^Xm       
Mm^Xm       , Mm^Xm       , Ww          , Ww          , Ww          , Gg^Ve       , Re          , Gg          , Mm          , Gs^Fp       , Gg          , Re          , Re          , Re          , Gg          , Wwf         , Gg          , Gg          , Hh          , Re          , Re          , Wwt         , Gg          , Gg          , Gg          , Gs^Fp       , Gg^Ve       , Hh          , Gll         , Gll         , Mm          , Gs^Fp       , Gll         , Gg^Vh       , Gs^Fp       , Hh          , Gg          , Gg          
Mm          , Mm          , Gs^Fp       , Ww          , Ww          , Hh          , Re          , Gg          , Mm          , Hh          , Gs^Fp       , Gg^Vh       , Re          , Gg          , Gg          , Wwf         , Gg          , Gg^Fet      , Gg^Vh       , Re          , Wwt         , Ww^Bw\      , Gll         , Hh          , Mm          , Gg          , Gll         , Gll         , Gs^Fp       , Gg          , Gg          , Hh          , Gll         , Gg          , Gg          , Gg          , Gs^Fp       , Gs^Fp       
Gs^Fp       , Gs^Fp       , Re          , Gs          , Gs^Fp       , Gs          , Re          , Gs^Fp       , Gs^Fp       , Gg          , Re          , Hh          , Re          , Gg          , Hh          , Wwf         , Wwt         , Hh          , Re          , Re          , Ww^Bw\      , Wwt         , Gll         , Gs^Fp       , Hh          , Hh          , Gll         , Gs^Fp       , Ww          , Ww          , Gs^Fp       , Gll         , Gg          , Gg          , Mm          , Mm          , Xu          , Xu          
Re          , Re          , Gg          , Re          , Re          , Re          , Hh^Vhh      , Re          , Re          , Re          , Mm          , Re          , Gs^Fp       , Gs^Fp       , Gg          , Wwt         , Ww^Bw/      , Re          , Gg          , Wwt         , Gg          , Gll         , Gg^Vh       , Gll         , Gll         , Gg          , Gll         , Gg          , Ww          , Ww          , Mm          , Gll         , Hh          , Mm          , Mm^Xm       , Mm^Xm       , Xu          , Xu          
Hh          , Hh          , Hh          , Gg          , Re          , Gs^Fp       , Hh          , Gs^Fp       , Gg          , Hh          , Hh          , Re          , Gg^Vh       , Hh          , Re          , Re          , Wwt         , Wwt         , Wwt         , Wwf         , Ds          , Hh          , Gs^Fp       , Gs^Fp       , Gg          , Gll         , Gll         , Gg          , Gg          , Hh          , Gll         , Gll         , Gs^Fp       , Hh          , Xu          , Xu          , Xu          , Xu          
Mm          , Mm          , Gs^Fp       , Gg          , Re          , Gg          , Gs^Fp       , Mm          , Wwt         , Gs^Fp       , Gg          , Re          , Re          , Re          , Gs^Fp       , Gs^Fp       , Mm          , Wwt         , Wwt         , Wwf         , Ds          , Gg          , Gg          , Gg          , Gll         , Gll         , Gg^Vh       , Gll         , Gll         , Gg          , Gll         , Gg          , Gs          , Gs^Fp       , Uu^Uf       , Uh          , Uh          , Qxu         
Hh          , Hh          , Gg          , Re          , Mm          , Re          , Ww^Bw\      , Wwt         , Ch          , Wwt         , Ww^Bw/      , Re          , Re          , Hh          , Hh          , Mm          , Wwt         , Wwt         , Wwt         , Ds          , Gg          , Gg          , Gll         , Gll         , Mm          , Gs^Fp       , Hh          , Gg          , Gll         , Gll         , Wwf         , Ww          , Wwf         , Urb         , Urb         , Uu^Vud      , Uu^Uf       , Uu^Uf       
Gs^Fp       , Gs^Fp       , Gg          , Re          , Gs^Fp       , Hh          , Wwt         , Ch          , 4 Kh        , Ch          , Wwt         , Hh          , Re          , Gg          , Gs^Fp       , Wwt         , Wwt         , Wwr         , Gg          , Hh          , Gll         , Gs^Fp       , Gll         , Hh          , Gs^Fp       , Mm          , Mm          , Gll         , Wwf         , Wwf         , Cud         , Cud         , Wwf         , Urb         , Urb         , Urb         , Uh          , Uh          
Gs^Fp       , Gs^Fp       , Mm^Vhh      , Re          , Gg          , Hh          , Wwt         , Ch          , Ch          , Ch          , Wwt         , Wwt         , Ww^Bw|      , Wwt         , Wwt         , Wwt         , Wwt         , Gg          , Gll         , Gll         , Gg^Ve       , Gll         , Gll         , Gll         , Gll         , Mm          , Wwt         , Wwt         , Cud         , Cud         , 3 Kud       , Cud         , Wwt         , Wwt         , Uu^Uf       , Uu          , Qxu         , Qxu         
Hh          , Hh          , Ha          , Re          , Re          , Gg          , Aa          , Wwf         , Wwf         , Wwf         , Aa          , Gs^Fp       , Re          , Hh          , Gg          , Wwt         , Ww^Bw/      , Gll         , Gg          , Gs^Fp       , Wwt         , Hh          , Wwf         , Gg          , Gg          , Gll         , Ww^Bw\      , Gs^Fp       , Ur          , Cud         , Wwf         , Wwt         , Wwt         , Ww^Vm       , Uh          , Uu          , Uu^Uf       , Qxu         
Mm^Xm       , Mm^Xm       , Mm          , Aa^Fpa      , Aa          , Re          , Re          , Ha          , Wwf         , Re          , Re          , Aa          , Re          , Aa          , Re          , Ww^Bw/      , Wwt         , Wwt         , Wwt         , Wwt         , Hh          , Wwf         , Gll         , Wwf         , Wwt         , Wwt         , Xu          , Ur          , Uu          , Ur          , Urb         , Urb         , Urb         , Urb         , Ur          , Uu          , Uu^Uf       , Uu^Uf       
Mm^Xm       , Mm^Xm       , Mm          , Mm          , Re          , Re          , Aa          , Wwf         , Aa          , Aa^Vea      , Ha          , Re          , Aa          , Re          , Ha^Vhha     , Aa          , Ai          , Wwt         , Wwt         , Mm          , Hh          , Gg          , Gll         , Gg          , Gs^Fp       , Gs^Fp       , Xu          , Ur          , Ur          , Uu^Uf       , Uh          , Urb         , Urb         , Ur          , Ur          , Uh          , Uu^Vu       , Uu          
Aa^Fpa      , Aa^Fpa      , Re          , Re          , Aa          , Ha          , Mm          , Wwf         , Ai          , Aa^Fpa      , Aa^Fpa      , Mm          , Mm          , Aa^Fpa      , Ha          , Aa^Fpa      , Ai          , Wwr         , Wwf         , Wwf         , Gll         , Gll         , Hh^Vhh      , Gll         , Gll         , Gll         , Gll         , Urb         , Urb         , Uu^Vud      , Urb         , Urb         , Uu^Uf       , Urb         , Urb         , Urb         , Urb         , Urb         
Re          , Re          , Aa^Fpa      , Aa^Vha      , Ha          , Aa^Fpa      , Ha          , Mm^Xm       , Ha          , Ai          , Ai          , Ha          , Ha          , Aa^Fpa      , Ha          , Mm^Xm       , Ha          , Ai          , Wwf         , Wwf         , Gg          , Gs^Fp       , Xu          , Hh          , Xu          , Uh          , Uu          , Uu          , Uu          , Urb         , Uu^Uf       , Uu          , Uh          , Uu^Uf       , Uh          , Urb         , Uh          , Uh          
Re          , Re          , Aa^Fpa      , Aa          , Ha          , Aa^Fpa      , Ha          , Mm^Xm       , Ha          , Ai          , Ai          , Ai          , Ha          , Aa^Fpa      , Ha          , Ai          , Ha          , Ai          , Wwf         , Wwf         , Gg          , Gs^Fp       , Xu          , Xu          , Xu          , Xu          , Xu          , Uu^Uf       , Uh          , Urb         , Uu          , Uu          , Qxu         , Uu^Uf       , Uh          , Qxu         , Qxu         , Qxu         
