Xu, Xu, Xu, Xu, Xu, Xu, Tb^Tf, Uh, Uu, Uh, Ww, Wo, Wo, Wo, Wo, Ww, Gs^Fp, Hh, Ss, Hh, Gg^Efm, Hh, Gg, Hh, Mm^Xm, Mm^Xm
Xu, Xu, 2 Kud, Xu, Cud, Xu, Tb^Tf, Uh, Uu^Vu, Uh, Uu, Ww, Wo, Wo, Wo, Ww, Gs^Fp, Hh, Ss, Hh, Gs^Fp, Hh, Cv, Hh, Mm^Xm, Mm^Xm
Xu, Xu, Cud, Cud, Gll, Uh, Gg, Gg, Gll, Gs^Fp, Gs^Fp, Ww, Ww, Wo, Ww, Ww, Ss, Ss, Ss^Vhs, Ss, Gs, Cv, Cv, 3 Kv, Mm^Xm, Mm^Xm
Xu, Cud, Gll, Gll, Gs^Fp, Gll, Gll, Gll, Gg, Gll, Gll, Ww, Gg, Ww, Ss, Gs^Fp, Gs^Fp, Hh, Gll, Gs^Fp, Gll, Gll, Gll, Cv, Gg^Fet, Gs^Fp
Gll, Gll, Gg, Gs^Fp, Hh, Hh^Vhh, Gll, Gs^Fp, Gg, Gg, Ww, Ww^Bsb\, Rp, Chs, Gg^Efm, Ss, Gll, Gll, Gg, Gll, Gg^Vh, Hh, Gll, Gg^Efm, Gg^Efm, Gg^Efm
Gg^Efm, Gg^Efm, Gg^Efm, Mm, Gs^Fp, Gll, Gg, Gg, Wwf, Wwf, Gg^Vh, Gg, Rp, Gg, Rp, Ss^Bsb/, Ss, Gg, Gg, Gll, Gs^Fp, Hh, Gg, Gll, Gg, Gg
Gs^Fp, Gg^Fet, Gg^Efm, Gg^Efm, Gll, Gll, Khr, Wwf, Ww, Hh, Gs^Fp, Rp, Gg, Rp, Gg^Ve, Gg^Efm, Chs, Khs, Gll, Gll, Mm, Hh, Gg, Gll, Gg, Gg
Gg^Efm, Gg^Efm, Gll, Gll, Hh, Chw, Chw, Chw, Rp, Gg, Gg, Gg, Rp, Rp, Rp, Gg, Chr, Chs, Ss, Mm, Mm^Xm, Mm, Gll, Gll, Hh, Hh
Gg, Gg, Gll, Gs^Fp, Gg^Ve, Wwf, Ww, Ww, Hh, Rp, Rp, Rp, Mm, Mm^Xm, Mm, Rp, Gs, Gg^Efm, Gg^Efm, Ss, Ss, Gs^Fp, Gll, Hh^Vhh, Hh, Hh
Gll, Gll, Gg, Gll, Wwf, Wwf, Gs, Gg, Hh, Gg, Rp, Gs^Fp, Gg^Efm, Mm, Rp, Rp, Gs, Gs^Fp, Hh, Gg^Efm, Ss^Bsb/, Gll, Gs, Gs^Fp, Hh, Hh
Hh, Hh, Gs^Fp, Gg, Wwf, Gll, Gll, Gs, Gg, Gg, Gg, Rp, Gs^Fp, Hh, Rp, Gs^Fp, Gg^Efm, Gg, Gll, Gll, Ww, Ww, Mm, Gs^Fp, Hh, Hh
Mm, Mm, Gg, Gg, Wwf, Hh, Gs^Fp, Gll, Hh, Ss^Vhs, Rp, Rp, Rp, Rp, Gg^Efm, Rp, Rp, Ss^Vhs, Gll, Gg, Gs^Fp, Ww, Ww, Mm, Mm, Mm
Hh, Hh, Gg, Wwf, Ww, Ww, Gs, Gll, Gg, Gs^Fp, Ww^Bsb|, Gg, Gg, Gg^Vh, Gs^Fp, Hh, Hh, Rp, Gg, Gll, Gll, Ww, Ss, Gs^Fp, Hh, Hh
Gs^Fp, Gs^Fp, Gg, Wwf, Ww^Vm, Wwf, Wwf, Gll, Wwf, Ww, Rp, Ww, Wwf, Hh, Gs^Fp, Mm, Gs^Fp, Rp, Gg, Gg^Efm, Ss, Ss^Bsb\, Gll, Ss^Vhs, Gs^Fp, Gs^Fp
Gs^Fp, Gs^Fp, Gg, Wwf, Ww, Gg, Hh, Wwf, Hh^Vhh, Gg, Rp, Gg, Wwf, Hh, Gg^Efm, Hh, Rp, Rp, Rp, Chs, Gs^Fp, Ww, Gg, Gll, Hh, Hh
Hh, Hh, Gll, Gg, Ww, Gs^Fp, Chs, Rp, Rp, Rp, Hh, Gg^Efm, Hh, Wwf, Gg, Rp, Gg, Hh^Vhh, Wwf, Hh, Gg, Ww, Wwf, Gg, Gs^Fp, Gs^Fp
Gs^Fp, Gs^Fp, Ss^Vhs, Gll, Ss^Bsb\, Ss, Gg^Efm, Gg, Rp, Gs^Fp, Mm, Gs^Fp, Hh, Wwf, Ww, Rp, Ww, Wwf, Gll, Wwf, Wwf, Ww^Vm, Wwf, Gg, Gs^Fp, Gs^Fp
Hh, Hh, Gs^Fp, Ss, Ww, Gll, Gll, Gg, Rp, Hh, Hh, Gs^Fp, Gg^Vh, Gg, Gg, Ww^Bsb|, Gs^Fp, Gs, Gll, Gs, Ww, Ww, Wwf, Gg, Hh, Hh
Mm, Mm, Mm, Ww, Ww, Gs^Fp, Gg, Gll, Ss^Vhs, Rp, Rp, Gg^Efm, Rp, Rp, Rp, Rp, Ss^Vhs, Hh, Gll, Gs^Fp, Hh, Wwf, Gg, Gg, Mm, Mm
Hh, Hh, Gs^Fp, Mm, Ww, Ww, Gll, Gll, Gg, Gg^Efm, Gs^Fp, Rp, Hh, Gs^Fp, Rp, Gg, Gg, Gs, Gs, Gll, Gll, Wwf, Gg, Gs^Fp, Hh, Hh
Hh, Hh, Gs^Fp, Gg, Gll, Ss^Bsb/, Gg^Efm, Hh, Gs^Fp, Gg, Rp, Rp, Mm, Gg^Efm, Gs^Fp, Rp, Gg, Hh, Gg, Gs, Wwf, Wwf, Gll, Gg, Gll, Gll
Hh, Hh, Hh^Vhh, Gll, Gs^Fp, Ss, Ss, Gg^Efm, Gg^Efm, Gg, Rp, Mm, Mm^Xm, Mm, Rp, Rp, Rp, Hh, Ww, Ww, Wwf, Gg^Ve, Gs^Fp, Gll, Gg^Efm, Gg^Efm
Hh, Hh, Gll, Gll, Mm, Mm^Xm, Mm, Ss, Chs, Chr, Gg, Rp, Rp, Rp, Gg, Gg, Gg, Rp, Chw, Chw, Chw, Hh, Gll, Gll, Gg^Efm, Gg^Efm
Gs^Fp, Gs^Fp, Gll, Gg, Hh, Mm, Gll, Gll, Khs, Chs, Gg^Efm, Gg^Ve, Rp, Gg, Rp, Gs^Fp, Hh, Ww, Wwf, Khr, Gll, Gll, Gg, Gg^Efm, Gg^Fet, Gs^Fp
Gs^Fp, Gs^Fp, Gll, Gg, Hh, Gs^Fp, Gll, Gg, Gg, Ss, Ss^Bsb/, Rp, Gg, Rp, Gg, Gg^Vh, Wwf, Wwf, Gg, Gg, Gll, Gs^Fp, Mm, Gg^Efm, Gg^Efm, Gg^Efm
Gg^Efm, Gg^Efm, Gg^Efm, Gll, Hh, Gg^Vh, Gll, Gg, Gll, Gll, Ss, Gg^Efm, Chs, Rp, Ww^Bsb\, Ww, Gg, Gg, Gs^Fp, Gll, Hh^Vhh, Hh, Gs^Fp, Gg, Gll, Gll
Gs^Fp, Gg^Fet, Cv, Gll, Gll, Gll, Gs^Fp, Gll, Hh, Gs^Fp, Gs^Fp, Ss, Ww, Gg, Ww, Gll, Gll, Gg, Gll, Gll, Gll, Gs^Fp, Gll, Gll, Cud, Gll
Mm^Xm, Mm^Xm, 4 Kv, Cv, Cv, Gg, Ss, Ss^Vhs, Ss, Ss, Ww, Ww, Wo, Ww, Ww, Gs^Fp, Gs^Fp, Gll, Gg, Gg, Uh, Gll, Cud, Cud, Xu, Xu
Mm^Xm, Mm^Xm, Hh, Cv, Hh, Gs^Fp, Gg^Efm, Ss, Hh, Gs^Fp, Ww, Wo, Wo, Wo, Ww, Uu, Uh, Uu^Vu, Uh, Tb^Tf, Xu, Cud, Xu, 1 Kud, Xu, Xu
Mm^Xm, Mm^Xm, Hh, Gg, Hh, Gg^Efm, Hh, Ss, Hh, Gs^Fp, Ww, Wo, Wo, Wo, Wo, Ww, Uh, Uu, Uh, Tb^Tf, Xu, Xu, Xu, Xu, Xu, Xu
