border_size=1
usage=map

Xu          , Xu          , Cud         , Xu          , Cud         , Xu          , Uu^Uf       , Uh          , Uu          , Uh          , Ww          , Wo          , Wo          , Wo          , Wo          , Ww          , Gs^Fp       , Hh          , Ss          , Hh          , Gg^Efm      , Hh          , Gg          , Hh          , Mm^Xm       , Mm^Xm       
Xu          , Xu          , 2 Kud       , Xu          , Cud         , Xu          , Uu^Uf       , Uh          , Uu^Vu       , Uh          , Uu          , Ww          , Wo          , Wo          , Wo          , Ww          , Gs^Fp       , Hh          , Ss          , Hh          , Gs^Fp       , Hh          , Cv          , Hh          , Mm^Xm       , Mm^Xm       
Xu          , Xu          , Cud         , Cud         , Rd          , Uh          , Gg          , Gg          , Rd          , Gs^Fp       , Gs^Fp       , Ww          , Ww          , Wo          , Ww          , Ww          , Ss          , Ss          , Ss^Vhs      , Ss          , Gg          , Cv          , Cv          , 3 Kv        , Mm^Xm       , Mm^Xm       
Rd          , Cud         , Rd          , Rd          , Gs^Fp       , Rd          , Rd          , Rd          , Gg          , Rd          , Rd          , Ww          , Gg          , Ww          , Ss          , Gs^Fp       , Gs^Fp       , Hh          , Rd          , Gs^Fp       , Rd          , Rd          , Rd          , Cv          , Gg^Fet      , Gs^Fp       
Rd          , Rd          , Gg          , Gs^Fp       , Hh          , Hh^Vhh      , Rd          , Gs^Fp       , Gg          , Gg          , Ww          , Ww^Bw\      , Rp          , Chs         , Gg^Efm      , Ss          , Rd          , Rd          , Gg          , Rd          , Gg^Vh       , Hh          , Rd          , Gg^Efm      , Gg^Efm      , Gg^Efm      
Gg^Efm      , Gg^Efm      , Gg^Efm      , Mm          , Gs^Fp       , Rd          , Gg          , Gg          , Wwf         , Wwf         , Gg^Vh       , Gg          , Rp          , Gg          , Rp          , Ss^Bw/      , Ss          , Gg          , Gg          , Rd          , Gs^Fp       , Hh          , Gg          , Rd          , Gg          , Gg          
Gs^Fp       , Gg^Fet      , Gg^Efm      , Gg          , Rd          , Rd          , Khr         , Wwf         , Ww          , Hh          , Gs^Fp       , Rp          , Gg          , Rp          , Gg^Ve       , Gg^Efm      , Chs         , Khs         , Rd          , Rd          , Mm          , Hh          , Gg          , Rd          , Gg          , Gg          
Gg^Efm      , Gg^Efm      , Rd          , Rd          , Hh          , Chw         , Chw         , Chw         , Rp          , Gg          , Gg          , Gg          , Rp          , Rp          , Rp          , Gg          , Chr         , Chs         , Ss          , Mm          , Mm^Xm       , Mm          , Rd          , Rd          , Hh          , Hh          
Gg          , Gg          , Rd          , Gs^Fp       , Gg^Ve       , Wwf         , Ww          , Ww          , Hh          , Rp          , Rp          , Rp          , Mm          , Mm^Xm       , Mm          , Rp          , Gg          , Gg^Efm      , Gg^Efm      , Ss          , Ss          , Gs^Fp       , Rd          , Hh^Vhh      , Hh          , Hh          
Rd          , Rd          , Gg          , Rd          , Wwf         , Wwf         , Gg          , Gg          , Hh          , Gg          , Rp          , Gs^Fp       , Gg^Efm      , Mm          , Rp          , Rp          , Gg          , Gs^Fp       , Hh          , Gg^Efm      , Ss^Bw/      , Rd          , Gg          , Gs^Fp       , Hh          , Hh          
Hh          , Hh          , Gs^Fp       , Gg          , Wwf         , Rd          , Rd          , Gg          , Gg          , Gg          , Gg          , Rp          , Gs^Fp       , Hh          , Rp          , Gs^Fp       , Gg^Efm      , Gg          , Rd          , Rd          , Ww          , Ww          , Mm          , Gs^Fp       , Hh          , Hh          
Mm          , Mm          , Gg          , Gg          , Wwf         , Hh          , Gs^Fp       , Rd          , Hh          , Ss^Vhs      , Rp          , Rp          , Rp          , Rp          , Gg^Efm      , Rp          , Rp          , Ss^Vhs      , Rd          , Gg          , Gs^Fp       , Ww          , Ww          , Mm          , Mm          , Mm          
Hh          , Hh          , Gg          , Wwf         , Ww          , Ww          , Gg          , Rd          , Gg          , Gs^Fp       , Ww^Bw|      , Gg          , Gg          , Gg^Vh       , Gs^Fp       , Hh          , Hh          , Rp          , Gg          , Rd          , Rd          , Ww          , Ss          , Gs^Fp       , Hh          , Hh          
Gs^Fp       , Gs^Fp       , Gg          , Wwf         , Ww^Vm       , Wwf         , Wwf         , Rd          , Wwf         , Ww          , Rp          , Ww          , Wwf         , Hh          , Gs^Fp       , Mm          , Gs^Fp       , Rp          , Gg          , Gg^Efm      , Ss          , Ss^Bw\      , Rd          , Ss^Vhs      , Gs^Fp       , Gs^Fp       
Gs^Fp       , Gs^Fp       , Gg          , Wwf         , Ww          , Gg          , Hh          , Wwf         , Hh^Vhh      , Gg          , Rp          , Gg          , Wwf         , Hh          , Gg^Efm      , Hh          , Rp          , Rp          , Rp          , Chs         , Gs^Fp       , Ww          , Gg          , Rd          , Hh          , Hh          
Hh          , Hh          , Rd          , Gg          , Ww          , Gs^Fp       , Chs         , Rp          , Rp          , Rp          , Hh          , Gg^Efm      , Hh          , Wwf         , Gg          , Rp          , Gg          , Hh^Vhh      , Wwf         , Hh          , Gg          , Ww          , Wwf         , Gg          , Gs^Fp       , Gs^Fp       
Gs^Fp       , Gs^Fp       , Ss^Vhs      , Rd          , Ss^Bw\      , Ss          , Gg^Efm      , Gg          , Rp          , Gs^Fp       , Mm          , Gs^Fp       , Hh          , Wwf         , Ww          , Rp          , Ww          , Wwf         , Rd          , Wwf         , Wwf         , Ww^Vm       , Wwf         , Gg          , Gs^Fp       , Gs^Fp       
Hh          , Hh          , Gs^Fp       , Ss          , Ww          , Rd          , Rd          , Gg          , Rp          , Hh          , Hh          , Gs^Fp       , Gg^Vh       , Gg          , Gg          , Ww^Bw|      , Gs^Fp       , Gg          , Rd          , Gg          , Ww          , Ww          , Wwf         , Gg          , Hh          , Hh          
Mm          , Mm          , Mm          , Ww          , Ww          , Gs^Fp       , Gg          , Rd          , Ss^Vhs      , Rp          , Rp          , Gg^Efm      , Rp          , Rp          , Rp          , Rp          , Ss^Vhs      , Hh          , Rd          , Gs^Fp       , Hh          , Wwf         , Gg          , Gg          , Mm          , Mm          
Hh          , Hh          , Gs^Fp       , Mm          , Ww          , Ww          , Rd          , Rd          , Gg          , Gg^Efm      , Gs^Fp       , Rp          , Hh          , Gs^Fp       , Rp          , Gg          , Gg          , Gg          , Gg          , Rd          , Rd          , Wwf         , Gg          , Gs^Fp       , Hh          , Hh          
Hh          , Hh          , Gs^Fp       , Gg          , Rd          , Ss^Bw/      , Gg^Efm      , Hh          , Gs^Fp       , Gg          , Rp          , Rp          , Mm          , Gg^Efm      , Gs^Fp       , Rp          , Gg          , Hh          , Gg          , Gg          , Wwf         , Wwf         , Rd          , Gg          , Rd          , Rd          
Hh          , Hh          , Hh^Vhh      , Rd          , Gs^Fp       , Ss          , Ss          , Gg^Efm      , Gg^Efm      , Gg          , Rp          , Mm          , Mm^Xm       , Mm          , Rp          , Rp          , Rp          , Hh          , Ww          , Ww          , Wwf         , Gg^Ve       , Gs^Fp       , Rd          , Gg          , Gg          
Hh          , Hh          , Rd          , Rd          , Mm          , Mm^Xm       , Mm          , Ss          , Chs         , Chr         , Gg          , Rp          , Rp          , Rp          , Gg          , Gg          , Gg          , Rp          , Chw         , Chw         , Chw         , Hh          , Rd          , Rd          , Gg^Efm      , Gg^Efm      
Gs^Fp       , Gs^Fp       , Rd          , Gg          , Hh          , Mm          , Rd          , Rd          , Khs         , Chs         , Gg^Efm      , Gg^Ve       , Rp          , Gg          , Rp          , Gs^Fp       , Hh          , Ww          , Wwf         , Khr         , Rd          , Rd          , Gg          , Gg^Efm      , Gg^Fet      , Gs^Fp       
Gs^Fp       , Gs^Fp       , Rd          , Gg          , Hh          , Gs^Fp       , Rd          , Gg          , Gg          , Ss          , Ss^Bw/      , Rp          , Gg          , Rp          , Gg          , Gg^Vh       , Wwf         , Wwf         , Gg          , Gg          , Rd          , Gs^Fp       , Mm          , Gg^Efm      , Gg^Efm      , Gg^Efm      
Gg^Efm      , Gg^Efm      , Gg^Efm      , Rd          , Hh          , Gg^Vh       , Rd          , Gg          , Rd          , Rd          , Ss          , Gg^Efm      , Chs         , Rp          , Ww^Bw\      , Ww          , Gg          , Gg          , Gs^Fp       , Rd          , Hh^Vhh      , Hh          , Gs^Fp       , Gg          , Rd          , Rd          
Gs^Fp       , Gg^Fet      , Cv          , Rd          , Rd          , Rd          , Gs^Fp       , Rd          , Hh          , Gs^Fp       , Gs^Fp       , Ss          , Ww          , Gg          , Ww          , Rd          , Rd          , Gg          , Rd          , Rd          , Rd          , Gs^Fp       , Rd          , Rd          , Cud         , Rd          
Mm^Xm       , Mm^Xm       , 4 Kv        , Cv          , Cv          , Gg          , Ss          , Ss^Vhs      , Ss          , Ss          , Ww          , Ww          , Wo          , Ww          , Ww          , Gs^Fp       , Gs^Fp       , Rd          , Gg          , Gg          , Uh          , Rd          , Cud         , Cud         , Xu          , Xu          
Mm^Xm       , Mm^Xm       , Hh          , Cv          , Hh          , Gs^Fp       , Gg^Efm      , Ss          , Hh          , Gs^Fp       , Ww          , Wo          , Wo          , Wo          , Ww          , Uu          , Uh          , Uu^Vu       , Uh          , Uu^Uf       , Xu          , Cud         , Xu          , 1 Kud       , Xu          , Xu          
Mm^Xm       , Mm^Xm       , Hh          , Gg          , Hh          , Gg^Efm      , Hh          , Ss          , Hh          , Gs^Fp       , Ww          , Wo          , Wo          , Wo          , Wo          , Ww          , Uh          , Uu          , Uh          , Uu^Uf       , Xu          , Xu          , Xu          , Xu          , Xu          , Xu          
