border_size=1
usage=map

_off^_usr   , _off^_usr   , _off^_usr   , _off^_usr   , _off^_usr   , _off^_usr   , _off^_usr   , _off^_usr   , _off^_usr   , _off^_usr   , _off^_usr   , _off^_usr   , _off^_usr   , _off^_usr   , _off^_usr   , _off^_usr   , _off^_usr   , _off^_usr   , _off^_usr   , _off^_usr   , Xu          , Xu          , Xu          , Xu          , Xu          , _off^_usr   , _off^_usr   , _off^_usr   , _off^_usr   , _off^_usr   , _off^_usr   , _off^_usr   , _off^_usr   , _off^_usr   , _off^_usr   , _off^_usr   , _off^_usr   , _off^_usr   , _off^_usr   , _off^_usr   , _off^_usr   , _off^_usr   
_off^_usr   , _off^_usr   , _off^_usr   , _off^_usr   , _off^_usr   , _off^_usr   , _off^_usr   , _off^_usr   , _off^_usr   , _off^_usr   , _off^_usr   , _off^_usr   , _off^_usr   , _off^_usr   , _off^_usr   , _off^_usr   , _off^_usr   , _off^_usr   , Xu          , Xu          , Xu          , Xu          , Xu          , Xu          , Xu          , Xu          , Xu          , _off^_usr   , _off^_usr   , _off^_usr   , _off^_usr   , _off^_usr   , _off^_usr   , _off^_usr   , _off^_usr   , _off^_usr   , _off^_usr   , _off^_usr   , _off^_usr   , _off^_usr   , _off^_usr   , _off^_usr   
_off^_usr   , _off^_usr   , _off^_usr   , _off^_usr   , _off^_usr   , _off^_usr   , _off^_usr   , _off^_usr   , _off^_usr   , _off^_usr   , _off^_usr   , _off^_usr   , _off^_usr   , _off^_usr   , _off^_usr   , _off^_usr   , Xu          , Xu          , Xu          , Xu          , Xu          , Xu          , Xu          , Xu          , Xu          , Xu          , Xu          , Xu          , Xu          , _off^_usr   , _off^_usr   , _off^_usr   , _off^_usr   , _off^_usr   , _off^_usr   , _off^_usr   , _off^_usr   , _off^_usr   , _off^_usr   , _off^_usr   , _off^_usr   , _off^_usr   
_off^_usr   , _off^_usr   , _off^_usr   , _off^_usr   , _off^_usr   , _off^_usr   , _off^_usr   , _off^_usr   , _off^_usr   , _off^_usr   , _off^_usr   , _off^_usr   , _off^_usr   , _off^_usr   , Xu          , Xu          , Xu          , Xu          , Xu          , Xu          , Ke          , Xu          , Xu          , Xu          , Xu          , Xu          , Xu          , Xu          , Xu          , Xu          , Xu          , _off^_usr   , _off^_usr   , _off^_usr   , _off^_usr   , _off^_usr   , _off^_usr   , _off^_usr   , _off^_usr   , _off^_usr   , _off^_usr   , _off^_usr   
_off^_usr   , _off^_usr   , _off^_usr   , _off^_usr   , _off^_usr   , _off^_usr   , _off^_usr   , _off^_usr   , _off^_usr   , _off^_usr   , _off^_usr   , _off^_usr   , Xu          , Xu          , Xu          , Xu          , Xu          , Xu          , Aa^Fpa      , Ce          , Hhd         , Ce          , Ha          , Xu          , Xu          , Xu          , Xu          , Xu          , Xu          , Xu          , Xu          , Xu          , Xu          , _off^_usr   , _off^_usr   , _off^_usr   , _off^_usr   , _off^_usr   , _off^_usr   , _off^_usr   , _off^_usr   , _off^_usr   
_off^_usr   , _off^_usr   , _off^_usr   , _off^_usr   , _off^_usr   , _off^_usr   , _off^_usr   , _off^_usr   , _off^_usr   , _off^_usr   , Xu          , Xu          , Xu          , Xu          , Xu          , Xu          , Aa^Vea      , Ha          , Rd          , Rd          , Hhd^Vhh     , Rd          , Rd          , Aa          , Aa^Vha      , Xu          , Xu          , Xu          , Xu          , Xu          , Xu          , Xu          , Xu          , Xu          , Xu          , _off^_usr   , _off^_usr   , _off^_usr   , _off^_usr   , _off^_usr   , _off^_usr   , _off^_usr   
_off^_usr   , _off^_usr   , _off^_usr   , _off^_usr   , _off^_usr   , _off^_usr   , _off^_usr   , _off^_usr   , Xu          , Xu          , Xu          , Xu          , Xu          , Xu          , Ha          , Aa^Fpa      , Rd          , Rd          , Gd          , Hhd         , Mm^Xm       , Gd^Fp       , Gd          , Rd          , Rd          , Aa          , Ha          , Xu          , Xu          , Xu          , Xu          , Xu          , Xu          , Xu          , Xu          , Xu          , Xu          , _off^_usr   , _off^_usr   , _off^_usr   , _off^_usr   , _off^_usr   
_off^_usr   , _off^_usr   , _off^_usr   , _off^_usr   , _off^_usr   , _off^_usr   , Xu          , Xu          , Xu          , Xu          , Xu          , Xu          , Cv          , Ai          , Ww^Bw/      , Rd          , Aa          , Aa          , Gd          , Mm          , Mm^Xm       , Mm          , Gd          , Aa^Fpa      , Rd          , Aa          , Aa^Fpa      , Aa^Fpa      , Cv          , Xu          , Xu          , Xu          , Xu          , Xu          , Xu          , Xu          , Xu          , Xu          , Xu          , _off^_usr   , _off^_usr   , _off^_usr   
_off^_usr   , _off^_usr   , _off^_usr   , _off^_usr   , Xu          , Xu          , Xu          , Xu          , Xu          , Xu          , Aa^Fpa      , Cv          , Cv          , 5 Kv        , Ww          , Gs          , Gd          , Gd          , Gd^Fp       , Gd^Fp       , Gd^Fp       , Mm          , Rd          , Rd          , Hhd         , Rd          , Rd          , Cv          , Cv          , Cv          , Ai          , Xu          , Xu          , Xu          , Xu          , Xu          , Xu          , Xu          , Xu          , Xu          , Xu          , _off^_usr   
_off^_usr   , _off^_usr   , Xu          , Xu          , Xu          , Xu          , Xu          , Xu          , Aa          , Ha          , Aa^Fpa      , Cv          , Cv          , Wwf         , Wwf         , Gs          , Rd          , Gd          , Gd          , Hhd         , Gd^Vh       , Rd          , Gd          , Gd          , Mm          , Gd^Fp       , Rd          , Cv          , Wwf         , 6 Kv        , Ww^Bw\      , Ha          , Aa^Fpa      , Xu          , Xu          , Xu          , Xu          , Xu          , Xu          , Xu          , Xu          , Xu          
Xu          , Xu          , Xu          , Xu          , Xu          , Xu          , Aa          , Aa^Vha      , Rd          , Aa          , Rd          , Rd          , Rd          , Rd          , Wwf         , Rd          , Hhd         , Rd          , Rd          , Rd          , Hhd         , Gd^Fp       , Gd          , Gd          , Rd          , Rd          , Gs          , Rd          , Wwf         , Ww          , Gs          , Rd          , Rd          , Aa^Vea      , Ha          , Xu          , Xu          , Xu          , Xu          , Xu          , Xu          , Xu          
Xu          , Xu          , Xu          , Xu          , Ce          , Ha          , Rd          , Rd          , Aa^Fpa      , Rd          , Hhd         , Gs^Fp       , Rd          , Gs          , Wwf         , Wwf         , Ww          , Ss^Vhs      , Rd          , Mm          , Mm^Xm       , Gd^Fp       , Rd          , Rd          , Gs          , Gs          , Wwf         , Wwf         , Rd          , Gs          , Gd          , Aa          , Aa          , Rd          , Rd          , Aa^Fpa      , Ce          , Xu          , Xu          , Xu          , Xu          , Xu          
Xu          , Xu          , Xu          , Ke          , Hhd         , Rd          , Gs^Fp       , Gd          , Gd          , Rd          , Gd          , Mm          , Rd          , Gs          , Wwf         , Ww          , Ww          , Gs^Fp       , Rd          , Mm          , Mm^Xm       , Mm          , Rd          , Gd^Vh       , Gs          , Wwf         , Ww          , Wwf         , Hhd         , Rd          , Gd          , Gd          , Gd          , Gd          , Hhd         , Rd          , Hhd         , Ke          , Xu          , Xu          , Xu          , Xu          
Xu          , Xu          , Xu          , Ce          , Rd          , Hhd^Vhh     , Mm^Xm       , Mm          , Mm          , Rd          , Gd          , Gd          , Rd          , Gs          , Gs          , Wwf         , Ww          , Gs          , Rd          , Gd          , Hhd         , Rd          , Gs          , Gs          , Wwf         , Wwf         , Ww          , Ww          , Ss^Vhs      , Rd          , Gd          , Gd^Fp       , Gd^Fp       , Mm          , Mm^Xm       , Hhd^Vhh     , Rd          , Ce          , Xu          , Xu          , Xu          , Xu          
Xu          , Xu          , Xu          , Aa^Fpa      , Rd          , Hhd         , Mm          , Mm^Xm       , Gd^Fp       , Rd          , Gd^Fp       , Gd          , Rd          , Gd^Vh       , Gs          , Wwf         , Ww^Vm       , Gs^Fp       , Rd          , Gs^Fp       , Ss^Vhs      , Rd          , Wwf         , Wwf         , Ww^Vm       , Ww          , Gs          , Gs^Fp       , Rd          , Rd          , Rd          , Hhd         , Gd^Fp       , Mm^Xm       , Mm          , Gd^Fp       , Rd          , Ha          , Xu          , Xu          , Xu          , Xu          
Xu          , Xu          , Xu          , Ha          , Rd          , Gd          , Gd          , Gd^Fp       , Hhd         , Gd^Vh       , Hhd         , Gd^Fp       , Mm          , Rd          , Gs          , Wwf         , Hhd         , Rd          , Chw         , Rd          , Ww          , Ww          , Gs          , Hhd         , Rd          , Gs^Fp       , Rd          , Rd          , Mm          , Mm          , Hhd         , Gd^Vh       , Rd          , Mm          , Gd          , Gd          , Rd          , Aa          , Xu          , Xu          , Xu          , Xu          
Xu          , Xu          , Xu          , Aa^Vea      , Rd          , Aa          , Gd          , Gd^Fp       , Gd          , Rd          , Mm          , Mm^Xm       , Mm^Xm       , Rd          , Rd          , Wwf         , Gs          , Rd          , Ww          , Wwf         , Hhd         , Ss          , Ss^Bsb/     , Rd          , Chw         , Rd          , Gd^Fp       , Gd          , Mm^Xm       , Mm^Xm       , Gd^Fp       , Gd^Fp       , Gd          , Rd          , Rd          , Aa^Fpa      , Rd          , Aa^Vha      , Xu          , Xu          , Xu          , Xu          
Xu          , Xu          , Xu          , Aa^Fpa      , Rd          , Aa          , Gd          , Gd          , Rd          , Rd          , Rd          , Mm          , Gd          , Hhd         , Ss^Vhs      , Ww          , Ss          , Ss^Bsb|     , Ss^Vhs      , Hhd         , Mm          , Re          , Ss^Vhs      , Ww          , Wwf         , Rd          , Ss^Vhs      , Hhd         , Rd          , Mm          , Rd          , Gd          , Gd          , Gd          , Hhd         , Rd          , Aa          , Aa          , Xu          , Xu          , Xu          , Xu          
Xu          , Xu          , Xu          , Ha          , Ww^Bw|      , Gd          , Gs          , Rd          , Hhd         , Ss^Vhs      , Gs^Fp       , Rd          , Rd          , Gd^Fp       , Rd          , Ww          , Hhd         , Re          , Re          , Gll^Fdf     , Re          , Re          , Gll^Fdf     , Hhd         , Hhd         , Ww          , Ww          , Rd          , Gs          , Rd          , Gd^Vh       , Rd          , Rd          , Mm          , Gd^Fp       , Rd          , Aa^Fpa      , Ha          , Xu          , Xu          , Xu          , Xu          
Xu          , Xu          , Xu          , Ai          , 4 Kv        , Ww          , Wwf         , Rd          , Wwf         , Ww          , Ww          , Gs          , Gs^Fp       , Rd          , Chw         , Wwf         , Hhd         , Mm          , Re          , Hhd         , Re          , Hhd         , Re          , Mm          , Re          , Ss          , Gs          , Wwf         , Wwf         , Gs          , Gs          , Gs          , Gs          , Rd          , Rd          , Rd          , Cv          , Aa^Fpa      , Xu          , Xu          , Xu          , Xu          
Xu          , Xu          , Xu          , Cv          , Cv          , Wwf         , Rd          , Wwf         , Wwf         , Ww          , Wwf         , Ww          , Ww^Vm       , Rd          , Rd          , Ww          , Ss^Vhs      , Gll^Fdf     , Hhd         , Re          , Gd^Ve       , Re          , Hhd         , Re          , Ss^Vhs      , Ss^Bsb\     , Rd          , Hhd         , Ww^Vm       , Wwf         , Wwf         , Wwf         , Wwf         , Gs          , Rd          , Cv          , Cv          , Cv          , Xu          , Xu          , Xu          , Xu          
Xu          , Xu          , Xu          , Cv          , Cv          , Cv          , Rd          , Gs          , Gs          , Wwf         , Gs          , Wwf         , Wwf         , Hhd         , Gs          , Ss^Bsb\     , Re          , Re          , Re          , Re          , Re          , Re          , Re          , Gll^Fdf     , Hhd         , Ww          , Chw         , Rd          , Gs^Fp       , Ww          , Ww          , Ww          , Wwf         , Wwf         , Wwf         , Wwf         , 3 Kv        , Cv          , Xu          , Xu          , Xu          , Xu          
Xu          , Xu          , Xu          , Aa^Fpa      , Aa^Fpa      , Rd          , Gs^Fp       , Rd          , Rd          , Gs          , Gd^Vh       , Gs          , Gs          , Wwf         , Ww          , Ss          , Hhd         , Mm          , Gll^Fdf     , Hhd         , Re          , Hhd         , Re          , Mm          , Hhd         , Wwf         , Rd          , Rd          , Rd          , Gg          , Gs^Fp       , Ww          , Hh          , Rd          , Gs          , Ww          , Ww^Bw|      , Ai          , Xu          , Xu          , Xu          , Xu          
Xu          , Xu          , Xu          , Ha          , Aa          , Rd          , Hhd         , Mm          , Gd          , Rd          , Rd          , Rd          , Rd          , Rd          , Ss^Vhs      , Ww          , Wwf         , Hhd         , Ss^Vhs      , Re          , Mm          , Gll^Fdf     , Ss^Vhs      , Re          , Ss          , Ww          , Ss^Vhs      , Gs^Fp       , Gd          , Rd          , Rd          , Ss^Vhs      , Rd          , Rd          , Gd          , Gs          , Rd          , Ha          , Xu          , Xu          , Xu          , Xu          
Xu          , Xu          , Xu          , Aa          , Rd          , Rd          , Rd          , Gd          , Gd          , Gd          , Gd^Fp       , Mm          , Mm^Xm       , Hhd         , Gs^Fp       , Rd          , Chw         , Ww          , Ss^Bsb/     , Re          , Hhd         , Hhd         , Ww          , Ss^Bsb|     , Gs          , Ww          , Rd          , Hhd         , Mm^Xm       , Mm          , Mm          , Rd          , Gd          , Gd          , Gd          , Aa          , Rd          , Aa^Fpa      , Xu          , Xu          , Xu          , Xu          
Xu          , Xu          , Xu          , Aa^Vha      , Rd          , Aa^Fpa      , Gd          , Rd          , Rd          , Gd^Fp       , Hhd         , Mm^Xm       , Mm          , Gd          , Rd          , Rd          , Rd          , Rd          , Gs          , Ss          , Ww          , Wwf         , Chw         , Rd          , Hhd         , Wwf         , Gs          , Rd          , Mm          , Mm^Xm       , Hhd         , Rd          , Hhd         , Gd^Fp       , Gd          , Aa          , Rd          , Aa^Vea      , Xu          , Xu          , Xu          , Xu          
Xu          , Xu          , Xu          , Aa          , Rd          , Gd          , Mm          , Mm          , Gd^Fp       , Gd^Vh       , Rd          , Mm          , Rd          , Rd          , Gs          , Gs^Fp       , Ww^Vm       , Hhd         , Wwf         , Ww          , Ss^Vhs      , Rd          , Rd          , Rd          , Ww^Vm       , Wwf         , Gs          , Rd          , Rd          , Gd^Fp       , Gd^Fp       , Gd^Vh       , Gd^Fp       , Gd^Fp       , Mm          , Gd          , Rd          , Ha          , Xu          , Xu          , Xu          , Xu          
Xu          , Xu          , Xu          , Ha          , Rd          , Gd^Fp       , Mm^Xm       , Mm^Xm       , Gd^Fp       , Hhd         , Gd          , Rd          , Ss^Vhs      , Gs^Fp       , Ww          , Ww          , Wwf         , Wwf         , Gs          , Rd          , Hhd         , Gs^Fp       , Rd          , Gs^Fp       , Ww          , Wwf         , Gs          , Gd^Vh       , Rd          , Gd          , Gd          , Rd          , Mm          , Mm^Xm       , Mm^Xm       , Hhd         , Rd          , Aa^Fpa      , Xu          , Xu          , Xu          , Xu          
Xu          , Xu          , Xu          , Ce          , Hhd         , Hhd^Vhh     , Hhd         , Mm          , Gd          , Gd^Fp       , Gd          , Rd          , Hhd         , Ww          , Ww          , Wwf         , Gs          , Gs          , Rd          , Rd          , Mm^Xm       , Gd          , Rd          , Gs          , Ww          , Wwf         , Wwf         , Gs          , Rd          , Gd          , Gd          , Rd          , Gd          , Mm          , Gd^Fp       , Hhd^Vhh     , Hhd         , Ce          , Xu          , Xu          , Xu          , Xu          
Xu          , Xu          , Xu          , Ke          , Ce          , Rd          , Rd          , Gd          , Aa          , Gd          , Gd          , Rd          , Rd          , Wwf         , Wwf         , Wwf         , Gs          , Gd^Vh       , Rd          , Mm          , Mm^Xm       , Mm          , Rd          , Gs^Fp       , Ww          , Ww          , Wwf         , Gs          , Rd          , Mm          , Hhd         , Rd          , Aa^Fpa      , Gd          , Rd          , Rd          , Ce          , Ke          , Xu          , Xu          , Xu          , Xu          
Xu          , Xu          , Xu          , Xu          , Xu          , Aa^Fpa      , Ha          , Rd          , Rd          , Aa          , Gs          , Gs          , Wwf         , Wwf         , Gs          , Gs          , Rd          , Rd          , Gd          , Gd^Fp       , Hhd         , Mm          , Rd          , Ss^Vhs      , Hh          , Wwf         , Wwf         , Gs          , Rd          , Gd^Fp       , Rd          , Rd          , Rd          , Rd          , Aa          , Ha          , Xu          , Xu          , Xu          , Xu          , Xu          , Xu          
_off^_usr   , Xu          , Xu          , Xu          , Xu          , Xu          , Xu          , Aa^Vea      , Aa^Fpa      , Rd          , Ww^Bw\      , Ww          , Wwf         , Rd          , Rd          , Rd          , Mm          , Gd          , Gd          , Gd^Fp       , Gd^Vh       , Rd          , Gd          , Rd          , Rd          , Rd          , Wwf         , Rd          , Cv          , Rd          , Aa^Fpa      , Aa          , Aa          , Aa^Vha      , Xu          , Xu          , Xu          , Xu          , Xu          , Xu          , Xu          , Xu          
_off^_usr   , _off^_usr   , _off^_usr   , Xu          , Xu          , Xu          , Xu          , Xu          , Xu          , Ha          , Ai          , 1 Kv        , Cv          , Cv          , Rd          , Gd^Fp       , Hhd         , Gd          , Rd          , Rd          , Gd^Fp       , Hhd         , Gd^Fp       , Gd          , Gd          , Gs          , Ww          , Wwf         , Cv          , Cv          , Aa^Fpa      , Ha          , Xu          , Xu          , Xu          , Xu          , Xu          , Xu          , Xu          , Xu          , _off^_usr   , _off^_usr   
_off^_usr   , _off^_usr   , _off^_usr   , _off^_usr   , _off^_usr   , Xu          , Xu          , Xu          , Xu          , Xu          , Xu          , Cv          , Cv          , Cv          , Aa^Fpa      , Rd          , Rd          , Rd          , Gd          , Mm          , Mm^Xm       , Gd^Fp       , Gd          , Gd          , Aa          , Gs          , Ww^Bw/      , 2 Kv        , Cv          , Cv          , Xu          , Xu          , Xu          , Xu          , Xu          , Xu          , Xu          , Xu          , _off^_usr   , _off^_usr   , _off^_usr   , _off^_usr   
_off^_usr   , _off^_usr   , _off^_usr   , _off^_usr   , _off^_usr   , _off^_usr   , _off^_usr   , Xu          , Xu          , Xu          , Xu          , Xu          , Xu          , Aa^Fpa      , Ha          , Aa          , Rd          , Aa^Fpa      , Gd          , Mm          , Mm^Xm       , Mm          , Gd          , Aa          , Rd          , Rd          , Ha          , Ai          , Xu          , Xu          , Xu          , Xu          , Xu          , Xu          , Xu          , Xu          , _off^_usr   , _off^_usr   , _off^_usr   , _off^_usr   , _off^_usr   , _off^_usr   
_off^_usr   , _off^_usr   , _off^_usr   , _off^_usr   , _off^_usr   , _off^_usr   , _off^_usr   , _off^_usr   , _off^_usr   , Xu          , Xu          , Xu          , Xu          , Xu          , Xu          , Aa          , Aa^Vha      , Rd          , Rd          , Gd^Fp       , Hhd^Vhh     , Hhd         , Rd          , Rd          , Aa^Vea      , Aa^Fpa      , Xu          , Xu          , Xu          , Xu          , Xu          , Xu          , Xu          , Xu          , _off^_usr   , _off^_usr   , _off^_usr   , _off^_usr   , _off^_usr   , _off^_usr   , _off^_usr   , _off^_usr   
_off^_usr   , _off^_usr   , _off^_usr   , _off^_usr   , _off^_usr   , _off^_usr   , _off^_usr   , _off^_usr   , _off^_usr   , _off^_usr   , _off^_usr   , Xu          , Xu          , Xu          , Xu          , Xu          , Xu          , Aa          , Ha          , Rd          , Hhd         , Rd          , Aa^Fpa      , Ha          , Xu          , Xu          , Xu          , Xu          , Xu          , Xu          , Xu          , Xu          , _off^_usr   , _off^_usr   , _off^_usr   , _off^_usr   , _off^_usr   , _off^_usr   , _off^_usr   , _off^_usr   , _off^_usr   , _off^_usr   
_off^_usr   , _off^_usr   , _off^_usr   , _off^_usr   , _off^_usr   , _off^_usr   , _off^_usr   , _off^_usr   , _off^_usr   , _off^_usr   , _off^_usr   , _off^_usr   , _off^_usr   , Xu          , Xu          , Xu          , Xu          , Xu          , Xu          , Ce          , Ke          , Ce          , Xu          , Xu          , Xu          , Xu          , Xu          , Xu          , Xu          , Xu          , _off^_usr   , _off^_usr   , _off^_usr   , _off^_usr   , _off^_usr   , _off^_usr   , _off^_usr   , _off^_usr   , _off^_usr   , _off^_usr   , _off^_usr   , _off^_usr   
_off^_usr   , _off^_usr   , _off^_usr   , _off^_usr   , _off^_usr   , _off^_usr   , _off^_usr   , _off^_usr   , _off^_usr   , _off^_usr   , _off^_usr   , _off^_usr   , _off^_usr   , _off^_usr   , _off^_usr   , Xu          , Xu          , Xu          , Xu          , Xu          , Xu          , Xu          , Xu          , Xu          , Xu          , Xu          , _off^_usr   , Xu          , _off^_usr   , _off^_usr   , _off^_usr   , _off^_usr   , _off^_usr   , _off^_usr   , _off^_usr   , _off^_usr   , _off^_usr   , _off^_usr   , _off^_usr   , _off^_usr   , _off^_usr   , _off^_usr   
_off^_usr   , _off^_usr   , _off^_usr   , _off^_usr   , _off^_usr   , _off^_usr   , _off^_usr   , _off^_usr   , _off^_usr   , _off^_usr   , _off^_usr   , _off^_usr   , _off^_usr   , _off^_usr   , _off^_usr   , _off^_usr   , Xu          , Xu          , Xu          , Xu          , Xu          , Xu          , Xu          , Xu          , _off^_usr   , _off^_usr   , _off^_usr   , _off^_usr   , _off^_usr   , _off^_usr   , _off^_usr   , _off^_usr   , _off^_usr   , _off^_usr   , _off^_usr   , _off^_usr   , _off^_usr   , _off^_usr   , _off^_usr   , _off^_usr   , _off^_usr   , _off^_usr   
_off^_usr   , _off^_usr   , _off^_usr   , _off^_usr   , _off^_usr   , _off^_usr   , _off^_usr   , _off^_usr   , _off^_usr   , _off^_usr   , _off^_usr   , _off^_usr   , _off^_usr   , _off^_usr   , _off^_usr   , _off^_usr   , _off^_usr   , Xu          , Xu          , Xu          , Xu          , Xu          , _off^_usr   , _off^_usr   , _off^_usr   , _off^_usr   , _off^_usr   , _off^_usr   , _off^_usr   , _off^_usr   , _off^_usr   , _off^_usr   , _off^_usr   , _off^_usr   , _off^_usr   , _off^_usr   , _off^_usr   , _off^_usr   , _off^_usr   , _off^_usr   , _off^_usr   , _off^_usr   
_off^_usr   , _off^_usr   , _off^_usr   , _off^_usr   , _off^_usr   , _off^_usr   , _off^_usr   , _off^_usr   , _off^_usr   , _off^_usr   , _off^_usr   , _off^_usr   , _off^_usr   , _off^_usr   , _off^_usr   , _off^_usr   , _off^_usr   , _off^_usr   , Xu          , Xu          , Xu          , Xu          , _off^_usr   , _off^_usr   , _off^_usr   , _off^_usr   , _off^_usr   , _off^_usr   , _off^_usr   , _off^_usr   , _off^_usr   , _off^_usr   , _off^_usr   , _off^_usr   , _off^_usr   , _off^_usr   , _off^_usr   , _off^_usr   , _off^_usr   , _off^_usr   , _off^_usr   , _off^_usr   
