border_size=1
usage=map

_off^_usr, _off^_usr, _off^_usr, _off^_usr, _off^_usr, _off^_usr, _off^_usr, _off^_usr, _off^_usr, _off^_usr, _off^_usr, _off^_usr, _off^_usr, _off^_usr, _off^_usr, _off^_usr, _off^_usr, _off^_usr, _off^_usr, _off^_usr, _off^_usr, _off^_usr, _off^_usr, _off^_usr, _off^_usr, _off^_usr, _off^_usr, _off^_usr, _off^_usr, _off^_usr, _off^_usr, _off^_usr, _off^_usr, _off^_usr, _off^_usr, _off^_usr, _off^_usr
_off^_usr, _off^_usr, _off^_usr, _off^_usr, _off^_usr, _off^_usr, _off^_usr, _off^_usr, _off^_usr, _off^_usr, _off^_usr, _off^_usr, _off^_usr, _off^_usr, _off^_usr, _off^_usr, _off^_usr, _off^_usr, Mm, _off^_usr, _off^_usr, _off^_usr, _off^_usr, _off^_usr, _off^_usr, _off^_usr, _off^_usr, _off^_usr, _off^_usr, _off^_usr, _off^_usr, _off^_usr, _off^_usr, _off^_usr, _off^_usr, _off^_usr, _off^_usr
_off^_usr, _off^_usr, _off^_usr, _off^_usr, _off^_usr, _off^_usr, _off^_usr, _off^_usr, _off^_usr, _off^_usr, _off^_usr, _off^_usr, _off^_usr, _off^_usr, _off^_usr, _off^_usr, Mm, Gs, Gg, Hh, Gs^Fp, _off^_usr, _off^_usr, _off^_usr, _off^_usr, _off^_usr, _off^_usr, _off^_usr, _off^_usr, _off^_usr, _off^_usr, _off^_usr, _off^_usr, _off^_usr, _off^_usr, _off^_usr, _off^_usr
_off^_usr, _off^_usr, _off^_usr, _off^_usr, _off^_usr, _off^_usr, _off^_usr, _off^_usr, _off^_usr, _off^_usr, _off^_usr, _off^_usr, _off^_usr, _off^_usr, Hh, Mm, Gg, Gg, Ww, Gg, Gg, Gs, Hh, _off^_usr, _off^_usr, _off^_usr, _off^_usr, _off^_usr, _off^_usr, _off^_usr, _off^_usr, _off^_usr, _off^_usr, _off^_usr, _off^_usr, _off^_usr, _off^_usr
_off^_usr, _off^_usr, _off^_usr, _off^_usr, _off^_usr, _off^_usr, _off^_usr, _off^_usr, _off^_usr, _off^_usr, _off^_usr, _off^_usr, Hh, Gs^Fp, Gg, Gg, Ww^Vm, Ww, Wo, Ww, Ww, Gg, Wwf, Hh, Gs^Fp, _off^_usr, _off^_usr, _off^_usr, _off^_usr, _off^_usr, _off^_usr, _off^_usr, _off^_usr, _off^_usr, _off^_usr, _off^_usr, _off^_usr
_off^_usr, _off^_usr, _off^_usr, _off^_usr, _off^_usr, _off^_usr, _off^_usr, _off^_usr, _off^_usr, _off^_usr, Gs^Fp, Gs^Fp, Ch, Ch, Ch, Gs^Fp, Ww, Ww, Ww, Ww, Ww^Vm, Ww, Ww, Gg, Gg, Gs^Fp, Gs, _off^_usr, _off^_usr, _off^_usr, _off^_usr, _off^_usr, _off^_usr, _off^_usr, _off^_usr, _off^_usr, _off^_usr
_off^_usr, _off^_usr, _off^_usr, _off^_usr, _off^_usr, _off^_usr, _off^_usr, _off^_usr, Hh, Gs, Gll, Gll, Ch, 6 Kh, Ch, Wwf, Gs^Fp, Ww, Ww, Ds, Hh, Gg, Gs^Fp, Gg, Ch, Ch, Ch, Hh, Mm, _off^_usr, _off^_usr, _off^_usr, _off^_usr, _off^_usr, _off^_usr, _off^_usr, _off^_usr
_off^_usr, _off^_usr, _off^_usr, _off^_usr, _off^_usr, _off^_usr, Gs, Gs^Fp, Gll, Gll, Gs, Gs, Gs, Ch, Hh, Gg, Gg, Gg, Wwf, Gg, Gg, Hh^Vhh, Gg, Hh, Ch, 3 Kh, Ch, Gs^Fp, Mm, Mm, Mm, _off^_usr, _off^_usr, _off^_usr, _off^_usr, _off^_usr, _off^_usr
_off^_usr, _off^_usr, _off^_usr, _off^_usr, Gd, Gs, Gll, Gll, Ss^Vhs, Gs^Fp, Mm, Hh, Gg, Rr, Gs^Fp, Gg^Ve, Re, Re, Wwf, Gg, Gs^Fp, Gg, Gs^Fp, Gg, Rr, Ch, Ss, Gg, Gs^Fp, Mm, Hh, Ww, Ww, _off^_usr, _off^_usr, _off^_usr, _off^_usr
_off^_usr, _off^_usr, Dd, Hd, Gd^Ftd, Gs, Gll, Hhd, Ss, Gs, Gs, Gs^Fp, Rr, Rr, Re, Re, Mm, Gg, Wwf, Gg, Gs, Hh, Rr, Rr, Gs^Fp, Re, Re, Gg, Hh, Gs^Fp, Gg, Gs^Fp, Ww^Vm, Ww, Wo, _off^_usr, _off^_usr
_off^_usr, _off^_usr, Hd, Dd^Vda, Gll, Gll, Hhd, Gs^Fp, Ss, Gs^Fp, Hh, Hh^Vhh, Rr, Gg, Re, Hh, Gg, Gs^Fp, Ww, Ds, Gg^Vh, Rr, Gs^Fp, Hh, Mm, Gg, Re, Ss^Vhs, Ss, Gg, Gs^Fp, Gg, Ww, Wo, Ww, _off^_usr, _off^_usr
_off^_usr, _off^_usr, Dd, Gd^Ftd, Gll, Mm^Xm, Mm^Xm, Mm, Chs, Gs^Fp, Gll, Gs, Rr, Hh, Re, Gs^Fp, Ss^Vhs, Ss, Ww, Hh, Gs^Fp, Rr, Gs, Mm, Gg, Gs^Fp, Re, Gs^Fp, Ss, Ss, Ww, Ww, Ww, Ww, Ww, _off^_usr, _off^_usr
_off^_usr, _off^_usr, Dd, Gd, Gll, Hhd, Gd^Fp, Mm^Xm, Gs, Gd, Gs, Gg, Rr, Gg, Gs^Fp, Re, Hh, Ss, Ww, Mm, Gg, Rr, Hh, Gg, Ds, Gg, Re, Gg, Ww, Ww, Hh, Ww^Vm, Wwf, Ds, Ds, _off^_usr, _off^_usr
_off^_usr, _off^_usr, Dd, Dd, Gd, Gll, Hhd, Gs^Vh, Rr, Rr, Rr, Rr, Gg^Vh, Gs^Fp, Hh, Re, Re, Ss, Ww, Gg, Gs, Rr, Gg^Ve, Ds, Ww, Ww, Ww, Ww^Bw\, Rr, Gs^Fp, Gs^Fp, Gg, Ch, Hh, Mm, _off^_usr, _off^_usr
_off^_usr, _off^_usr, Gs, Gs, Gll, Gs, Mm, Rr, Gs, Gs, Rr, Gg, Mm^Xm, Hh, Mm, Gs^Fp, Gg, Ww^Bw\, Ch, Hh, Rr, Rr, Gs^Fp, Ww, Ww, Ww, Hh, Gg, Hh^Vhh, Rr, Gs^Fp, Ch, 2 Kh, Ch, Gs^Fp, _off^_usr, _off^_usr
_off^_usr, _off^_usr, Gd^Ftd, Gd^Vht, Gll, Gg, Hhd, Rr, Gs, Gs, Gg, Ch, Hh, Mm^Xm, Mm^Xm, Gs^Fp, Ww, Ww, Hh, Rr, Rr, Gg, Ww, Ww, Ww, Gg, Mm, Hh, Rr, Rr, Rr, Ch, Ch, Ch, Gs, _off^_usr, _off^_usr
_off^_usr, _off^_usr, Gd^Ftd, Hhd, Gll, Gs^Fp, Gs^Fp, Rr, Gs^Vh, Gg, Gs^Fp, Gs^Fp, Mm, Mm, Gs^Fp, Hh, Wwf, Gs^Fp, Gs, Rr, Gg, Chw, Ww^Bw\, Ww, Gg, Gg, Gg, Gs^Fp, Rr, Hh, Gs, Gs, Gs^Fp, Gs, Hh, _off^_usr, _off^_usr
_off^_usr, _off^_usr, Ww, Mm, Hh, Gll, Gll, Rr, Rr, Gg, Gg, Hh, Gs^Fp, Gs, Gg, Ww, Gg^Vh, Gg, Rr, Rr, Gg^Vh, Ww, Gg, Gg, Gs^Fp, Gg^Ve, Gg, Gs, Rr, Gs, Gll, Gs, Hh, Gs^Fp, Ww, _off^_usr, _off^_usr
_off^_usr, _off^_usr, Hh, Gs^Fp, Gs^Fp, Gs, Gs, Gs, Rr, Gg, Gg, Gg^Ve, Gg, Gg, Ww^Bw\, Ww, Gg, Rr, Gs, Gg, Wwf, Ww, Gs^Fp, Gs, Mm, Hh, Gs^Fp, Gs, Gs^Vh, Rr, Gs^Fp, Gll, Gll, Mm, Gd^Ftd, _off^_usr, _off^_usr
_off^_usr, _off^_usr, Gs, Gs, Ch, Gs, Gs, Hh, Rr, Gs^Fp, Mm, Gg, Ww, Ww, Ww, Chw, Rr, Rr, Hh, Gs^Fp, Ww, Hh, Mm^Xm, Mm, Hh, Gs^Fp, Gs, Gs, Gs, Rr, Hh, Gs^Fp, Gll, Hhd, Gd^Ftd, _off^_usr, _off^_usr
_off^_usr, _off^_usr, Gs^Fp, Ch, 1 Kh, Ch, Gs^Fp, Rr, Hh^Vhh, Hh, Hh, Gg, Ww, Ww, Gs^Fp, Gg, Rr, Rr, Ch, Ww, Gg, Gs^Fp, Mm, Mm^Xm, Mm^Xm, Ch, Rr, Gs, Gs, Rr, Mm, Gll, Gs, Gd^Vht, Gd, _off^_usr, _off^_usr
_off^_usr, _off^_usr, Mm, Ch, Ch, Ch, Gs^Fp, Rr, Rr, Gg, Ww, Ww, Ww, Ww, Gg^Ve, Rr, Gs, Hh, Ww, Ww^Bw\, Re, Gs^Fp, Hh, Hh, Gg^Vh, Gg, Rr, Gs, Rr, Rr, Hhd, Gll, Gs, Gs, Dd, _off^_usr, _off^_usr
_off^_usr, _off^_usr, Ds, Hh, Wwf, Gg, Hh, Gs^Fp, Ww, Ww^Bw\, Re, Ww, Ds, Ds, Hh, Rr, Gs, Gg, Ww, Ss, Hh, Re, Gs^Fp, Gs^Fp, Rr, Rr, Gs, Rr, Gs, Gs^Vh, Gs^Fp, Gll, Gll, Dd, Dd, _off^_usr, _off^_usr
_off^_usr, _off^_usr, Ww, Ds, Ww, Ww^Vm, Ww, Ww, Ss, Gg, Re, Gg, Gg, Gg, Gg, Rr, Gs^Fp, Mm, Ww, Ss, Ss^Vhs, Re, Re, Gs, Rr, Gg, Gd, Gll, Chs, Mm^Xm, Mm^Xm, Hhd, Gll, Gd, Dd, _off^_usr, _off^_usr
_off^_usr, _off^_usr, Ww, Ww, Ww, Ww, Gs^Fp, Ss, Ss, Gs^Fp, Re, Gs^Fp, Mm, Mm, Gs^Fp, Rr, Gg^Vh, Hh, Ww, Ss, Gg, Gs^Fp, Re, Hh, Rr, Gs, Hh, Gs^Fp, Ss, Mm, Hhd, Mm^Xm, Gll, Gd^Ftd, Hd, _off^_usr, _off^_usr
_off^_usr, _off^_usr, Wo, Wo, Ww^Vm, Gg, Gg, Gg, Hh, Ss^Vhs, Re, Gg, Gs^Fp, Hh, Rr, Rr, Gg, Ds, Wwf, Gs^Fp, Mm, Hh, Re, Gs, Rr, Hh^Vhh, Gs, Gs^Fp, Ss, Gs^Fp, Gll, Gll, Gd^Ftd, Dd^Vda, Dd, _off^_usr, _off^_usr
_off^_usr, _off^_usr, _off^_usr, Ww, Ww, Gs^Fp, Hh, Gs^Fp, Gs^Fp, Gg, Ss, Re, Rr, Rr, Gs^Fp, Hh, Gs^Fp, Gg, Wwf, Gg, Re, Re, Gs^Fp, Rr, Gs, Gs^Fp, Mm, Gs, Ss^Vhs, Hh, Gll, Gs, Gd, Hd, _off^_usr, _off^_usr, _off^_usr
_off^_usr, _off^_usr, _off^_usr, _off^_usr, _off^_usr, Ww, Mm, Mm, Mm, Gg, Ch, Ch, Ch, Gg, Gg, Gg, Gg, Gg, Wwf, Re, Gg, Gg^Ve, Hh, Rr, Gs, Hh, Gs, Gs^Fp, Gll, Gll, Gs, Gd, _off^_usr, _off^_usr, _off^_usr, _off^_usr, _off^_usr
_off^_usr, _off^_usr, _off^_usr, _off^_usr, _off^_usr, _off^_usr, _off^_usr, Mm, Mm, Gs^Fp, Ch, 4 Kh, Ch, Hh, Gs^Fp, Hh^Vhh, Hh, Gg, Ww, Gg, Gs^Fp, Gg, Ch, Ch, Ch, Gs, Gll, Gll, Hh, Gs^Fp, _off^_usr, _off^_usr, _off^_usr, _off^_usr, _off^_usr, _off^_usr, _off^_usr
_off^_usr, _off^_usr, _off^_usr, _off^_usr, _off^_usr, _off^_usr, _off^_usr, _off^_usr, _off^_usr, Hh, Gs, Ch, Gg, Gg, Ww, Gg, Ww^Vm, Ds, Ww, Ww, Ww, Wwf, Ch, 5 Kh, Ch, Gll, Gs^Fp, Gs, _off^_usr, _off^_usr, _off^_usr, _off^_usr, _off^_usr, _off^_usr, _off^_usr, _off^_usr, _off^_usr
_off^_usr, _off^_usr, _off^_usr, _off^_usr, _off^_usr, _off^_usr, _off^_usr, _off^_usr, _off^_usr, _off^_usr, _off^_usr, Gs^Fp, Gs^Fp, Gg, Wwf, Ww, Ww, Ww, Wo, Ww, Ww^Vm, Gs^Fp, Gg, Ch, Hh, Gs^Fp, _off^_usr, _off^_usr, _off^_usr, _off^_usr, _off^_usr, _off^_usr, _off^_usr, _off^_usr, _off^_usr, _off^_usr, _off^_usr
_off^_usr, _off^_usr, _off^_usr, _off^_usr, _off^_usr, _off^_usr, _off^_usr, _off^_usr, _off^_usr, _off^_usr, _off^_usr, _off^_usr, _off^_usr, Hh, Hh, Gg, Gg, Ww, Ww, Ww, Gg, Gg, Hh, Gs^Fp, _off^_usr, _off^_usr, _off^_usr, _off^_usr, _off^_usr, _off^_usr, _off^_usr, _off^_usr, _off^_usr, _off^_usr, _off^_usr, _off^_usr, _off^_usr
_off^_usr, _off^_usr, _off^_usr, _off^_usr, _off^_usr, _off^_usr, _off^_usr, _off^_usr, _off^_usr, _off^_usr, _off^_usr, _off^_usr, _off^_usr, _off^_usr, _off^_usr, Gs, Gs^Fp, Gg, Gg, Gg, Mm, Mm, _off^_usr, _off^_usr, _off^_usr, _off^_usr, _off^_usr, _off^_usr, _off^_usr, _off^_usr, _off^_usr, _off^_usr, _off^_usr, _off^_usr, _off^_usr, _off^_usr, _off^_usr
_off^_usr, _off^_usr, _off^_usr, _off^_usr, _off^_usr, _off^_usr, _off^_usr, _off^_usr, _off^_usr, _off^_usr, _off^_usr, _off^_usr, _off^_usr, _off^_usr, _off^_usr, _off^_usr, _off^_usr, Hh, Mm, Gs, _off^_usr, _off^_usr, _off^_usr, _off^_usr, _off^_usr, _off^_usr, _off^_usr, _off^_usr, _off^_usr, _off^_usr, _off^_usr, _off^_usr, _off^_usr, _off^_usr, _off^_usr, _off^_usr, _off^_usr
_off^_usr, _off^_usr, _off^_usr, _off^_usr, _off^_usr, _off^_usr, _off^_usr, _off^_usr, _off^_usr, _off^_usr, _off^_usr, _off^_usr, _off^_usr, _off^_usr, _off^_usr, _off^_usr, _off^_usr, _off^_usr, _off^_usr, _off^_usr, _off^_usr, _off^_usr, _off^_usr, _off^_usr, _off^_usr, _off^_usr, _off^_usr, _off^_usr, _off^_usr, _off^_usr, _off^_usr, _off^_usr, _off^_usr, _off^_usr, _off^_usr, _off^_usr, _off^_usr
_off^_usr, _off^_usr, _off^_usr, _off^_usr, _off^_usr, _off^_usr, _off^_usr, _off^_usr, _off^_usr, _off^_usr, _off^_usr, _off^_usr, _off^_usr, _off^_usr, _off^_usr, _off^_usr, _off^_usr, _off^_usr, _off^_usr, _off^_usr, _off^_usr, _off^_usr, _off^_usr, _off^_usr, _off^_usr, _off^_usr, _off^_usr, _off^_usr, _off^_usr, _off^_usr, _off^_usr, _off^_usr, _off^_usr, _off^_usr, _off^_usr, _off^_usr, _off^_usr