Gs^Fp       , Hh          , Hh          , Gs^Fp       , Gs^Fp       , Gg          , Hh          , Mm          , Mm          , Mm          , Hd          , Dd^Do       , Hd          , Md          , Hd          , Dd          , Hd          , Md          , Hh          , Mm          , Mm          , Mm          , Hh          , Hh          , Re          , Gg          , Gg          , Wwf         , Wwf         , Gg          , Gs^Fp       , Gg          , Gg          , Gg          , Hh          , Gs^Fp       , Mm          , Hh          , Hh          , Mm^Vhh      
Re          , Re          , Re          , Re          , Re          , Re          , Gg          , Hh          , Mm          , Gs          , Dd          , Dd          , Dd          , Dd          , Dd          , Dd          , Dd          , Dd          , Hh          , Ww          , Mm          , Gs^Fp       , Gs^Fp       , Re          , Re          , Ds          , Ds          , Ww          , Wwf         , Hh          , Gg          , Ww          , Ds          , Gg          , Gg          , Gg          , Gg          , Gs^Fp       , Gs^Fp       , Rd          
Gg^Ve       , Gg          , Gg          , 2 Kh        , Ch          , Ch          , Re          , Gs^Fp       , Hh          , Gg          , Gs          , Rd          , Rd          , Rd          , Rd          , Rd          , Rd          , Rd          , Gs          , Gg          , Gg          , Re          , Re          , Gs^Fp       , Gg^Ve       , Hh          , Ww          , Wo          , Ww          , Ww          , Ww          , Ww          , Ww          , Ww          , Gg          , Ch          , Ch          , Ch          , Rd          , Hh          
Ss          , Ss          , Ch          , Ch          , Ch          , Rr          , Re          , Re          , Gg^Vh       , Rd          , Rd          , Hd          , Dd          , Hd          , Dd^Vda      , Rd          , Md          , Gs          , Rd          , Re          , Re          , Gg          , Hh          , 3 Kh        , Gs^Fp       , Ww          , Ww          , Wo          , Ww          , Wo          , Wo          , Wo          , Ww^Vm       , Ww          , Ds          , Ch          , 6 Kh        , Ch          , Rd          , Gs^Fp       
Ss          , Ss          , Ch          , Rr          , Rr          , Gg          , Gg          , Gs^Fp       , Re          , Gg          , Gs          , Md          , Dd          , Dd          , Dd          , Rd          , Hd          , Dd          , Gs          , Re          , Gg          , Hh          , Ch          , Ch          , Ch          , Ww          , Ww          , Ww^Vm       , Wo          , Wo          , Wo          , Wo          , Ww          , Ww          , Ds          , Rr          , Ch          , Rr          , Rd          , Gg          
Ss          , Ss          , Gg          , Re          , Gg          , Gs^Fp       , Hh          , Mm          , Re          , Re          , Gs          , Dd          , Dd          , Hd          , Rd          , Dd          , Dd          , Dd          , Gs          , Re          , Gs^Fp       , Gs^Fp       , Ch          , Ch          , Ch          , Ds          , Ww          , Ww          , Ww          , Wo          , Wo          , Ww          , Ww          , Gg          , Gg          , Gg^Vh       , Rr          , Gg          , Gs^Fp       , Gs^Fp       
Ww          , Ss          , Gg          , Gg          , Re          , Hh          , Mm          , Mm          , Mm          , Re          , Gs          , Dd          , Dd          , Dd          , Rd          , Dd^Vdt      , Dd          , Dd          , Gs          , Hh          , Re          , Re          , Rr          , Rr          , Rr          , Rd          , Ds          , Ds          , Ww          , Ww          , Ww          , Gg          , Gg          , Gs^Fp       , Gg          , Re          , Re          , Gs^Fp       , Gg          , Ss          
Ww          , Ss          , Ss          , Ss^Vhs      , Re          , Re          , Gs^Fp       , Ww          , Mm          , Re          , Gs          , Gs          , Hd          , Dd          , Rd          , Hd          , Hd          , Dd          , Hh          , Gs^Fp       , Gg^Vh       , Re          , Gg          , Gs^Fp       , Gg          , Gg          , Rd          , Rd          , Ds          , Ww          , Ww          , Gg          , Hh          , Hh          , Re          , Gg          , Hh          , Mm          , Mm          , Ss          
Ww          , Ww          , Ss          , Ss          , Gs^Fp       , Re          , Gg          , Hh          , Hh          , Gg          , Re          , Hh          , Mm          , Rd          , Rd          , Gs          , Hd          , Mm          , Mm          , Gs^Fp       , Re          , Gg          , Hh          , Mm          , Mm          , Mm          , Gg          , Gg^Vh       , Rd          , Ww^Bw\      , Ww          , Gg          , Mm          , Gs^Fp       , Re          , Hh          , Mm          , Gs^Fp       , Hh          , Gg^Ve       
Wo          , Wo          , Ww          , Ss          , Gg          , Re          , Gg          , Mm          , Gs^Fp       , Gg          , Re          , Hh^Vhh      , Gs^Fp       , Re          , Hh          , Gg          , Mm          , Re          , Hh          , Gg          , Re          , Gg          , Gs^Fp       , Hh          , Mm          , Gs^Fp       , Gg          , Ww          , Ww          , Ww          , Rd          , Rd          , Hh          , Rd          , Re          , Re          , Gg          , Rd          , Rd          , Gs^Fp       
Wo          , Ww          , Ww          , Gg          , Gg          , Re          , Gg          , Rd          , Gs^Fp       , Rd          , Re          , Re          , Re          , Gg          , Re          , Re          , Re          , Gs^Fp       , Re          , Re          , Re          , Re          , Gg          , Gg          , Gs^Fp       , Ww          , Ww          , Ww          , Ww          , Ss          , Gg          , Gg          , Rd          , Gs^Fp       , Gg          , Hh          , Re          , Gg          , Hh          , Mm          
Ww          , Ds          , Ww          , Re          , Re          , Gg^Ve       , Rd          , Gg          , Rd          , Mm          , Gg          , Re          , Gg          , Gs^Fp       , Hh          , Gg          , Gg^Ve       , Hh          , Mm          , Gg          , Gg          , Gs^Fp       , Re          , Ww^Bw\      , Ww          , Ww          , Ww          , Gg          , Ss          , Ss          , Ss          , Ss          , Gg^Vh       , Hh          , Mm          , Gg          , Re          , Gg          , Hh          , Mm          
Ds          , Re          , Ww^Bw/      , Ww          , Gg          , Gs^Fp       , Hh          , Gs^Fp       , Gg          , Hh          , Gs^Fp       , Re          , Gg          , Gs^Fp       , Mm          , Gg          , Gg          , Ds          , Ww          , Ww          , Gg          , Hh          , Gg^Vh       , Ww          , Ww^Bw\      , Re          , Gg          , Gg          , Ss          , Ss          , Ww          , Ww          , Gg          , Gg          , Gs^Fp       , Rd          , Re          , Re          , Gs^Fp       , Hh          
Gg          , Re          , Gg          , Ww          , Gs^Fp       , Hh          , Mm          , Hh          , Gs^Fp       , Gg          , Gg^Vh       , Re          , Gg          , Hh          , Hh          , Gg          , Gg          , Wwf         , Ww          , Ww^Vm       , Gs^Fp       , Mm          , Gg          , Ww          , Ww          , Gg          , Re          , Re          , Ss^Vhs      , Hh          , Ss          , Gg          , Wwf         , Wwf         , Rd          , Gg          , Gg          , Gg^Vh       , Re          , Gs^Fp       
Gg          , Re          , Gg          , Gs^Fp       , Ww          , Ww          , Ds          , Gg          , Gg          , Rd          , Rd          , Gg          , Re          , Mm          , Ds          , Wwf         , Wwf         , Wwf         , Ww          , Wo          , Ww          , Ww          , Gg          , Wwf         , Ww          , Ds          , Hh          , Re          , Gs^Fp       , Gs^Fp       , Gg          , Rd          , Rd          , Wwf         , Gg          , Mm          , Gs^Fp       , Hh          , Re          , Gg          
Gg          , Re          , Hh          , Gs^Fp       , Mm          , Gg          , Wwf         , Rd          , Rd          , Gg          , Gs^Fp       , Gs^Fp       , Re          , Hh          , Ds          , Ww          , Wwf         , Gg          , Ww          , Ww          , Wo          , Ww          , Wwf         , Wwf         , Wwf         , Ds          , Mm          , Re          , Gg          , Rd          , Rd          , Gg          , Gg          , Ds          , Ww          , Ww          , Gs^Fp       , Gg          , Re          , Gg          
Gs^Fp       , Re          , Gg^Vh       , Gg          , Gg          , Rd          , Wwf         , Wwf         , Gg          , Ss          , Hh          , Ss^Vhs      , Re          , Re          , Gg          , Ww          , Ww          , Gg          , Mm          , Gs^Fp       , Ww^Vm       , Ww          , Wwf         , Gg          , Gg          , Hh          , Hh          , Gg          , Re          , Gg^Vh       , Gg          , Gs^Fp       , Hh          , Mm          , Hh          , Gs^Fp       , Ww          , Gg          , Re          , Gg          
Hh          , Gs^Fp       , Re          , Re          , Rd          , Gs^Fp       , Gg          , Gg          , Ww          , Ww          , Ss          , Ss          , Gg          , Gg          , Re          , Ww^Bw\      , Ww          , Gg^Vh       , Hh          , Gg          , Ww          , Ww          , Ds          , Gg          , Gg          , Mm          , Gs^Fp       , Gg          , Re          , Gs^Fp       , Hh          , Gg          , Gs^Fp       , Hh          , Gs^Fp       , Gg          , Ww          , Ww^Bw/      , Re          , Ds          
Mm          , Hh          , Gg          , Re          , Gg          , Mm          , Hh          , Gg^Vh       , Ss          , Ss          , Ss          , Ss          , Gg          , Ww          , Ww          , Ww          , Re          , Re          , Gs^Fp       , Gg          , Gg          , Mm          , Hh          , Gg^Ve       , Gg          , Hh          , Gs^Fp       , Gg          , Re          , Gg          , Mm          , Rd          , Gg          , Rd          , Gg^Ve       , Re          , Re          , Ww          , Ds          , Ww          
Mm          , Hh          , Gg          , Re          , Hh          , Gg          , Gs^Fp       , Rd          , Gg          , Gg          , Ss          , Ww          , Ww          , Ww          , Ww          , Gs^Fp       , Gg          , Gg          , Re          , Re          , Re          , Re          , Gs^Fp       , Re          , Re          , Re          , Gg          , Re          , Re          , Re          , Rd          , Gs^Fp       , Rd          , Gg          , Re          , Gg          , Gg          , Ww          , Ww          , Wo          
Gs^Fp       , Rd          , Rd          , Gg          , Re          , Re          , Rd          , Hh          , Rd          , Rd          , Ww          , Ww          , Ww          , Gg          , Gs^Fp       , Mm          , Hh          , Gs^Fp       , Gg          , Re          , Gg          , Hh          , Re          , Mm          , Gg          , Hh          , Re          , Gs^Fp       , Hh^Vhh      , Re          , Gg          , Gs^Fp       , Mm          , Gg          , Re          , Gg          , Ss          , Ww          , Wo          , Wo          
Gg^Ve       , Hh          , Gs^Fp       , Mm          , Hh          , Re          , Gs^Fp       , Mm          , Gg          , Ww          , Ww^Bw\      , Rd          , Gg^Vh       , Gg          , Mm          , Mm          , Mm          , Hh          , Gg          , Re          , Gs^Fp       , Mm          , Mm          , Hd          , Gs          , Rd          , Rd          , Mm          , Hh          , Re          , Gg          , Hh          , Hh          , Gg          , Re          , Gs^Fp       , Ss          , Ss          , Ww          , Ww          
Ss          , Mm          , Mm          , Hh          , Gg          , Re          , Hh          , Hh          , Gg          , Ww          , Ww          , Ds          , Rd          , Rd          , Gg          , Gg          , Gs^Fp       , Gg          , Re          , Gg^Vh       , Gs^Fp       , Hh          , Dd          , Hd          , Hd          , Rd          , Dd          , Hd          , Gs          , Gs          , Re          , Mm          , Ww          , Gs^Fp       , Re          , Re          , Ss^Vhs      , Ss          , Ss          , Ww          
Ss          , Gg          , Gs^Fp       , Re          , Re          , Gg          , Gs^Fp       , Gg          , Gg          , Ww          , Ww          , Ww          , Ds          , Ds          , Rd          , Rr          , Rr          , Rr          , Re          , Re          , Hh          , Gs          , Dd          , Dd          , Dd^Vdt      , Rd          , Dd          , Dd          , Dd          , Gs          , Re          , Mm          , Mm          , Mm          , Hh          , Re          , Gg          , Gg          , Ss          , Ww          
Gs^Fp       , Gs^Fp       , Gg          , Rr          , Gg^Vh       , Gg          , Gg          , Ww          , Ww          , Wo          , Wo          , Ww          , Ww          , Ww          , Ds          , Ch          , Ch          , Ch          , Gs^Fp       , Gs^Fp       , Re          , Gs          , Dd          , Dd          , Dd          , Rd          , Hd          , Dd          , Dd          , Gs          , Re          , Re          , Mm          , Hh          , Gs^Fp       , Gg          , Re          , Gg          , Ss          , Ss          
Gg          , Rd          , Rr          , Ch          , Rr          , Ds          , Ww          , Ww          , Wo          , Wo          , Wo          , Wo          , Ww^Vm       , Ww          , Ww          , Ch          , Ch          , Ch          , Hh          , Gg          , Re          , Gs          , Dd          , Hd          , Rd          , Dd          , Dd          , Dd          , Md          , Gs          , Gg          , Re          , Gs^Fp       , Gg          , Gg          , Rr          , Rr          , Ch          , Ss          , Ss          
Gs^Fp       , Rd          , Ch          , 5 Kh        , Ch          , Ds          , Ww          , Ww^Vm       , Wo          , Wo          , Wo          , Ww          , Wo          , Ww          , Ww          , Gs^Fp       , 4 Kh        , Hh          , Gg          , Re          , Re          , Rd          , Gs          , Md          , Rd          , Dd^Vda      , Hd          , Dd          , Hd          , Rd          , Rd          , Gg^Vh       , Re          , Re          , Rr          , Ch          , Ch          , Ch          , Ss          , Ss          
Hh          , Rd          , Ch          , Ch          , Ch          , Gg          , Ww          , Ww          , Ww          , Ww          , Ww          , Ww          , Wo          , Ww          , Hh          , Gg^Ve       , Gs^Fp       , Re          , Re          , Gg          , Gg          , Gs          , Rd          , Rd          , Rd          , Rd          , Rd          , Rd          , Rd          , Gs          , Gg          , Hh          , Gs^Fp       , Re          , Ch          , Ch          , 1 Kh        , Gg          , Gg          , Gg^Ve       
Rd          , Gs^Fp       , Gs^Fp       , Gg          , Gg          , Gg          , Gg          , Ds          , Ww          , Gg          , Hh          , Wwf         , Ww          , Ds          , Ds          , Re          , Re          , Gs^Fp       , Gs^Fp       , Mm          , Ww          , Hh          , Dd          , Dd          , Dd          , Dd          , Dd          , Dd          , Dd          , Dd          , Gs          , Mm          , Hh          , Gg          , Re          , Re          , Re          , Re          , Re          , Re          
Mm^Vhh      , Hh          , Hh          , Mm          , Gs^Fp       , Hh          , Gg          , Gg          , Gg          , Gs^Fp       , Gg          , Wwf         , Wwf         , Gg          , Gg          , Re          , Hh          , Hh          , Mm          , Mm          , Mm          , Hh          , Md          , Hd          , Dd          , Hd          , Md          , Hd          , Dd^Do       , Hd          , Mm          , Mm          , Mm          , Hh          , Gg          , Gs^Fp       , Gs^Fp       , Hh          , Hh          , Gs^Fp       

