border_size=1
usage=map

_off^_usr   , _off^_usr   , _off^_usr   , _off^_usr   , _off^_usr   , _off^_usr   , _off^_usr   , _off^_usr   , _off^_usr   , _off^_usr   , _off^_usr   , _off^_usr   , _off^_usr   , _off^_usr   , _off^_usr   , _off^_usr   , _off^_usr   , _off^_usr   , _off^_usr   , _off^_usr   , _off^_usr   , _off^_usr   , _off^_usr   , _off^_usr   , _off^_usr   , _off^_usr   , _off^_usr   , _off^_usr   , _off^_usr   , _off^_usr   , _off^_usr   , _off^_usr   , _off^_usr   
_off^_usr   , _off^_usr   , _off^_usr   , _off^_usr   , _off^_usr   , _off^_usr   , _off^_usr   , _off^_usr   , _off^_usr   , _off^_usr   , _off^_usr   , _off^_usr   , _off^_usr   , _off^_usr   , _off^_usr   , _off^_usr   , _off^_usr   , _off^_usr   , _off^_usr   , _off^_usr   , _off^_usr   , _off^_usr   , _off^_usr   , _off^_usr   , _off^_usr   , _off^_usr   , _off^_usr   , _off^_usr   , _off^_usr   , _off^_usr   , _off^_usr   , _off^_usr   , _off^_usr   
_off^_usr   , _off^_usr   , _off^_usr   , _off^_usr   , _off^_usr   , _off^_usr   , _off^_usr   , _off^_usr   , _off^_usr   , _off^_usr   , _off^_usr   , _off^_usr   , _off^_usr   , _off^_usr   , _off^_usr   , _off^_usr   , _off^_usr   , _off^_usr   , _off^_usr   , _off^_usr   , _off^_usr   , _off^_usr   , _off^_usr   , _off^_usr   , _off^_usr   , _off^_usr   , _off^_usr   , _off^_usr   , _off^_usr   , _off^_usr   , _off^_usr   , _off^_usr   , _off^_usr   
_off^_usr   , _off^_usr   , _off^_usr   , _off^_usr   , _off^_usr   , _off^_usr   , _off^_usr   , _off^_usr   , _off^_usr   , _off^_usr   , _off^_usr   , _off^_usr   , _off^_usr   , _off^_usr   , Hh          , Gg^Fet      , 6 Kv        , Hh          , Gs^Fp       , _off^_usr   , _off^_usr   , _off^_usr   , _off^_usr   , _off^_usr   , _off^_usr   , _off^_usr   , _off^_usr   , _off^_usr   , _off^_usr   , _off^_usr   , _off^_usr   , _off^_usr   , _off^_usr   
_off^_usr   , _off^_usr   , _off^_usr   , _off^_usr   , _off^_usr   , _off^_usr   , _off^_usr   , _off^_usr   , _off^_usr   , _off^_usr   , _off^_usr   , _off^_usr   , Dd^Vda      , Re          , Re^Gvs      , Cv          , Cv          , Cv          , Ggf         , Ggf         , Gg^Ve       , _off^_usr   , _off^_usr   , _off^_usr   , _off^_usr   , _off^_usr   , _off^_usr   , _off^_usr   , _off^_usr   , _off^_usr   , _off^_usr   , _off^_usr   , _off^_usr   
_off^_usr   , _off^_usr   , _off^_usr   , _off^_usr   , _off^_usr   , _off^_usr   , _off^_usr   , _off^_usr   , _off^_usr   , _off^_usr   , Md          , Re          , Gs^Ft       , Ds          , Gs          , Re^Gvs      , Rr          , Ggf         , Gg          , Ggf         , Hh          , Gs          , Ds          , _off^_usr   , _off^_usr   , _off^_usr   , _off^_usr   , _off^_usr   , _off^_usr   , _off^_usr   , _off^_usr   , _off^_usr   , _off^_usr   
_off^_usr   , _off^_usr   , _off^_usr   , _off^_usr   , _off^_usr   , _off^_usr   , _off^_usr   , _off^_usr   , Md          , Md          , Dd          , Dd          , Gs          , Hh          , Re          , Re          , Re          , Rr          , Rr          , Ggf         , Hh          , Gg^Fet      , Mm          , Dd          , Ds          , _off^_usr   , _off^_usr   , _off^_usr   , _off^_usr   , _off^_usr   , _off^_usr   , _off^_usr   , _off^_usr   
_off^_usr   , _off^_usr   , _off^_usr   , _off^_usr   , _off^_usr   , _off^_usr   , Dd^Vdt      , Re          , Dd          , Dd          , Hh          , Gs          , Re          , Re          , Hh          , Gs          , Re          , Gg^Fet      , Gg^Vh       , Rr          , Rr          , Gs^Fp       , Hh          , Gg^Fet      , Hh          , Gs          , Gg^Ve       , _off^_usr   , _off^_usr   , _off^_usr   , _off^_usr   , _off^_usr   , _off^_usr   
_off^_usr   , _off^_usr   , _off^_usr   , _off^_usr   , Gs^Ft       , Re          , Ds          , Hd          , Gs          , Gs^Ft       , Re          , Re          , Gs          , Gs^Ft       , Gs^Vht      , Gs          , Re          , Hh          , Gs^Fp       , Ggf         , Rd          , Rr          , Rr          , Gs^Fp       , Gg          , Gg          , Gg          , Hh          , Ww          , _off^_usr   , _off^_usr   , _off^_usr   , _off^_usr   
_off^_usr   , _off^_usr   , _off^_usr   , Hh          , Ch          , Re          , Gs          , Gs^Ft       , Re          , Re          , Gs          , Gs          , Gs^Ft       , Gs          , Wwf         , Gs          , Rd          , Rd          , Rd          , Rd          , Hh          , Gs^Fp       , Hh          , Rr          , Rr          , Gg          , Gs^Fp       , Wwf         , Chw         , Gg^Fet      , _off^_usr   , _off^_usr   , _off^_usr   
_off^_usr   , _off^_usr   , Gg^Fet      , 2 Kh        , Ch          , Re          , Re          , Re          , Hh          , Gs          , Gs          , Hh          , Wwf         , Wwf         , Ww          , Hh          , Rd          , Gs^Fp       , Ggf         , Rd          , Rd          , Gs^Fp       , Rd          , Rd          , Gg^Vh       , Rr          , Rr          , Wwf         , Chw         , 3 Khw       , Hh          , _off^_usr   , _off^_usr   
_off^_usr   , _off^_usr   , Hh          , Ch          , Re^Gvs      , Re          , Re          , Gs          , Gs^Ft       , Gs^Vht      , Gs          , Wwf         , Ww          , Ww          , Gs          , Gs^Ft       , Rd          , Hh          , Rd          , Rd          , Gs^Fp       , Rd          , Rd          , Gg          , Gg          , Hh          , Rr          , Ww^Bw/      , Ds          , Chs         , Gs^Fp       , _off^_usr   , _off^_usr   
_off^_usr   , _off^_usr   , Re^Gvs      , Re^Gvs      , Gg          , Rr          , Gg          , Re          , Re          , Re          , Hh          , Gs^Ft       , Ww          , Ss^Vhs      , Rd          , Rd          , Rd          , Rd          , Gg          , Gg^Vh       , Hh          , Ggf         , Ss          , Chs         , Rr          , Rr          , Gg          , Wwf         , Ds          , Ds          , Gs^Ft       , _off^_usr   , _off^_usr   
_off^_usr   , _off^_usr   , Uu^Vu       , Ss          , Gg          , Rr          , Hh          , Gs^Fp       , Rr          , Re          , Rd          , Wwf         , Wwf         , Wwf         , Gs          , Gs          , Cud         , Gg          , Gg          , Gs^Fp       , Mm          , Ggf         , Rr          , Rr          , Rr          , Hh          , Gg^Ve       , Wwf         , Ww          , Ss^Vhs      , Uu^Uf       , _off^_usr   , _off^_usr   
_off^_usr   , _off^_usr   , Uu^Ii       , Ss          , Gg          , Rr          , Gg          , Gg^Ve       , Rr          , Hh          , Gg          , Rd          , Rd          , Gs          , Cud         , 7 Kud       , Xu          , Cud         , Xu          , Xu          , Wwf         , Rr          , Wwf         , Gs^Fp       , Ww^Bw|      , Gs^Fp       , Wwf         , Wwf         , Rr          , Ss          , Uu^Ii       , _off^_usr   , _off^_usr   
_off^_usr   , _off^_usr   , Uu^Uf       , Ss          , Hh          , Rr          , Gs^Fp       , Gg          , Rr          , Gs^Fp       , Gg          , Rd          , Gg          , Cud         , Xu          , Xu          , Uu^Ii       , Xu          , Ww^Bw/      , Ww^Bw/      , Gg^Fet      , Wwf         , Hh          , Wwf         , Chw         , Wwf         , Gg          , Rr          , Gg          , Ss          , Uu^Uf       , _off^_usr   , _off^_usr   
_off^_usr   , _off^_usr   , Uu^Ii       , Ss          , Gs^Fp       , Rr          , Hh          , Gg          , Rr          , Gg          , Gg^Vh       , Rd          , Gg          , Uu^Vud      , Xu          , Wo          , Ww^Vm       , Wwf         , Xu          , Uh          , Gg          , Rd          , Gg^Vh       , Gg          , Rr          , Gg          , Hh          , Rr          , Gs^Fp       , Ss          , Uu^Ii       , _off^_usr   , _off^_usr   
_off^_usr   , _off^_usr   , Uu^Uf       , Ss          , Gg          , Rr          , Gg          , Gg          , Chw         , Gg          , Hh          , Rd          , Gg^Fet      , Uh          , Ww^Bw/      , Wwf         , Uu^Ii       , Wo          , Xu          , Uu^Vud      , Gg          , Rd          , Gg          , Gg          , Rr          , Gg          , Gs^Fp       , Rr          , Hh          , Ss          , Uu^Uf       , _off^_usr   , _off^_usr   
_off^_usr   , _off^_usr   , Uu^Ii       , Ss          , Gg          , Rr          , Wwf         , Wwf         , Ww^Bw|      , Wwf         , Wwf         , Wwf         , Wwf         , Ww^Bw/      , Xu          , Xu          , Xu          , Xu          , Cud         , Cud         , Rd          , Rd          , Gg          , Gs^Fp       , Rr          , Gg          , Gg          , Rr          , Gg          , Ss          , Uu^Ii       , _off^_usr   , _off^_usr   
_off^_usr   , _off^_usr   , Uu^Uf       , Ss          , Ww          , Wwf         , Gg^Vh       , Gs^Fp       , Rr          , Gs^Fp       , Rr          , Rr          , Mm          , Xu          , Gg          , Cud         , Cud         , 8 Kud       , Gs          , Gs          , Wwf         , Rd          , Rd          , Hh          , Rr          , Gg^Vh       , Hh          , Rr          , Gg          , Ss          , Uu^Vu       , _off^_usr   , _off^_usr   
_off^_usr   , _off^_usr   , Gs^Ft       , Ss^Vhs      , Ds          , Wwf         , Gg          , Hh          , Rr          , Rr          , Ss          , Ggf         , Hh          , Gs^Fp       , Gg          , Gg          , Rd          , Gs          , Rd          , Wwf         , Ww          , Wwf         , Hh          , Re          , Re          , Gs^Fp       , Gg          , Rr          , Gg          , Ss          , Re^Gvs      , _off^_usr   , _off^_usr   
_off^_usr   , _off^_usr   , Gs^Fp       , Ds          , Ds          , Wwf         , Rr          , Rr          , Gg          , Chs         , Rd          , Ggf         , Gs^Fp       , Gg^Vh       , Rd          , Rd          , Rd          , Rd          , Gs          , Ss^Vhs      , Ww          , Gs^Ft       , Gs          , Re          , Gs^Ft       , Re          , Re          , Rr          , Re^Gvs      , Re^Gvs      , Hh          , _off^_usr   , _off^_usr   
_off^_usr   , _off^_usr   , Hh          , Chs         , Chw         , Ww^Bw/      , Rr          , Hh          , Gg^Ve       , Gg          , Rd          , Rd          , Rd          , Rd          , Ggf         , Hh          , Rd          , Gs^Ft       , Ww          , Ww          , Wwf         , Wwf         , Gs          , Gs^Vht      , Hh          , Gs          , Re          , Re          , Ch          , Ch          , Gg^Fet      , _off^_usr   , _off^_usr   
_off^_usr   , _off^_usr   , _off^_usr   , 4 Khw       , Chw         , Wwf         , Gs^Fp       , Rr          , Rr          , Rd          , Hh          , Gs^Fp       , Hh          , Rd          , Rd          , Gs^Fp       , Rd          , Hh          , Wwf         , Wwf         , Gs^Ft       , Hh          , Gs          , Gs          , Re          , Re          , Gs          , Re          , Ch          , 1 Kh        , _off^_usr   , _off^_usr   , _off^_usr   
_off^_usr   , _off^_usr   , _off^_usr   , Gg^Fet      , Ww          , Wwf         , Gg          , Gg          , Gg          , Rr          , Rr          , Gs^Fp       , Rd          , Rd          , Gg^Fet      , Rd          , Re          , Gs          , Gs^Vht      , Gs          , Gs          , Gs          , Re          , Re          , Gs          , Gs^Ft       , Ds          , Re          , Gs^Ft       , Hh          , _off^_usr   , _off^_usr   , _off^_usr   
_off^_usr   , _off^_usr   , _off^_usr   , _off^_usr   , _off^_usr   , Hh          , Gg^Vh       , Gg          , Hh          , Gs^Fp       , Hh          , Rr          , Rr          , Ggf         , Gg^Ve       , Hh          , Re          , Gs          , Gs^Ft       , Hh          , Re          , Re          , Hh          , Gs^Ft       , Dd          , Hd          , Dd^Vdt      , Re          , _off^_usr   , _off^_usr   , _off^_usr   , _off^_usr   , _off^_usr   
_off^_usr   , _off^_usr   , _off^_usr   , _off^_usr   , _off^_usr   , _off^_usr   , _off^_usr   , Gs          , Ds          , Gg^Fet      , Mm          , Gs^Fp       , Hh          , Rr          , Rr          , Gs^Fp       , Re          , Gs          , Re          , Re          , Hh          , Gs          , Dd          , Dd          , Md          , Re          , _off^_usr   , _off^_usr   , _off^_usr   , _off^_usr   , _off^_usr   , _off^_usr   , _off^_usr   
_off^_usr   , _off^_usr   , _off^_usr   , _off^_usr   , _off^_usr   , _off^_usr   , _off^_usr   , _off^_usr   , _off^_usr   , Dd          , Ds          , Gg^Fet      , Hh          , Ggf         , Gg          , Rr          , Rr          , Re          , Gs          , Gs          , Gs^Ft       , Dd          , Md          , Md          , _off^_usr   , _off^_usr   , _off^_usr   , _off^_usr   , _off^_usr   , _off^_usr   , _off^_usr   , _off^_usr   , _off^_usr   
_off^_usr   , _off^_usr   , _off^_usr   , _off^_usr   , _off^_usr   , _off^_usr   , _off^_usr   , _off^_usr   , _off^_usr   , _off^_usr   , _off^_usr   , Gs          , Gg^Ve       , Ggf         , Ggf         , Ggf         , Cv          , Re^Gvs      , Re^Gvs      , Ds          , Dd^Vda      , Re          , _off^_usr   , _off^_usr   , _off^_usr   , _off^_usr   , _off^_usr   , _off^_usr   , _off^_usr   , _off^_usr   , _off^_usr   , _off^_usr   , _off^_usr   
_off^_usr   , _off^_usr   , _off^_usr   , _off^_usr   , _off^_usr   , _off^_usr   , _off^_usr   , _off^_usr   , _off^_usr   , _off^_usr   , _off^_usr   , _off^_usr   , _off^_usr   , Ggf         , Gg^Fet      , Cv          , 5 Kv        , Cv          , Hh          , Re          , _off^_usr   , _off^_usr   , _off^_usr   , _off^_usr   , _off^_usr   , _off^_usr   , _off^_usr   , _off^_usr   , _off^_usr   , _off^_usr   , _off^_usr   , _off^_usr   , _off^_usr   
_off^_usr   , _off^_usr   , _off^_usr   , _off^_usr   , _off^_usr   , _off^_usr   , _off^_usr   , _off^_usr   , _off^_usr   , _off^_usr   , _off^_usr   , _off^_usr   , _off^_usr   , _off^_usr   , _off^_usr   , Hh          , _off^_usr   , Gs^Fp       , _off^_usr   , _off^_usr   , _off^_usr   , _off^_usr   , _off^_usr   , _off^_usr   , _off^_usr   , _off^_usr   , _off^_usr   , _off^_usr   , _off^_usr   , _off^_usr   , _off^_usr   , _off^_usr   , _off^_usr   
_off^_usr   , _off^_usr   , _off^_usr   , _off^_usr   , _off^_usr   , _off^_usr   , _off^_usr   , _off^_usr   , _off^_usr   , _off^_usr   , _off^_usr   , _off^_usr   , _off^_usr   , _off^_usr   , _off^_usr   , _off^_usr   , _off^_usr   , _off^_usr   , _off^_usr   , _off^_usr   , _off^_usr   , _off^_usr   , _off^_usr   , _off^_usr   , _off^_usr   , _off^_usr   , _off^_usr   , _off^_usr   , _off^_usr   , _off^_usr   , _off^_usr   , _off^_usr   , _off^_usr   
_off^_usr   , _off^_usr   , _off^_usr   , _off^_usr   , _off^_usr   , _off^_usr   , _off^_usr   , _off^_usr   , _off^_usr   , _off^_usr   , _off^_usr   , _off^_usr   , _off^_usr   , _off^_usr   , _off^_usr   , _off^_usr   , _off^_usr   , _off^_usr   , _off^_usr   , _off^_usr   , _off^_usr   , _off^_usr   , _off^_usr   , _off^_usr   , _off^_usr   , _off^_usr   , _off^_usr   , _off^_usr   , _off^_usr   , _off^_usr   , _off^_usr   , _off^_usr   , _off^_usr   
