Ww, Ww, Ww, _s, Ms, Ha, Aa, Aa, Ss, Ss, Ss, Ss, Ss, Ds, Ds, Ss, Mm^Xm, Ai, Ai, Ai, Ai
Ww, Ww^Vm, Ww, Aa^Fpa, Mm, Ha, Aa^Fpa, Aa, Gs^Fp, Ss, Ss, Ss, Ss, Ds, Ds, Ss, Mm^Xm, Xu, Xu, Ai, Ai
Ha, Ww, Ww, Mm, Mm, Mm, Re, Re, Gg, Ss^Vhs, Aa^Fpa, Gs^Fp, Ds, Ds, Aa, Ss, Mm^Xm, Xu, Cud, Xu, Ai
Hh, Mm, Gs^Fp, Ww, Ww, Aa, Gg, Re, Aa, Ha, Aa^Fpa, Ha, Gg, Aa^Vha, Aa, Re^Tf, Mm^Xm, Xu, Cud, Xu, Ai
Gg, Hh, Gs, Gs^Ft, Aa, Ai, Ai, Gg, Gg, Ha, Aa, Gg, Gg, Gg, Re, Re, Mm^Xm, Xu, Cud, Xu, Ai
Gg, Gs^Vht, Re, Gs, Gs^Ft, Aa, Ss^Vhs, Aa, Hh, Gg, Gg, Gg, Re, Re, Ch, Ch, Mm^Xm, Xu, Cud, Xu, Ai
Gg, Re, Re, Re, Gs^Ft, Aa, Ss, Ai, Gg, Gg, Re, Re, Ch, Ch, Re^Gvs, Ch, Mm^Xm, Xu, Cud, Xu, Ai
Aa, Aa, Ha, Re, Re, Ha, Aa^Fpa, Ai, Gg, Gg, Re, Ch, Aa, Re^Gvs, Aa, Kh, Mm^Xm, Xu, Cud, Xu, Ai
Gg, Aa, Aa^Vha, Re^Tf, Re, Gg, Gg, Gg, Ww, Aa, Aa, Aa^Vea, Re^Gvs, Aa, Re^Gvs, Aa^Vha, Mm^Xm, Xu, Cud, Xu, Ai
Aa, Gg, Aa^Fpa, Ha, Re, Re, Gg, Mm, Ww, Aa, Re, Ch, Ch, Re^Gvs, Aa, Kh, Mm^Xm, Xu, Cud, Xu, Ai
Aa, Gg, Gg, Gg, Mm, Re, Gg, Ds, Ww, Aa^Fpa, Gg, Re, Re, Ch, Ch, Ch, Mm^Xm, Xu, Cud, Xu, Ai
Aa, Aa, Gg, Aa^Fpa, Ha, Re, Gg^Ve, Gs^Fp, Mm, Ai, Gg, Gg, Gs^Fp, Re, Re, Ch, Mm^Xm, Xu, Cud, Xu, Ai
Aa, Aa, Gs^Ft, Gg, Gg, Re, Re, Gg, Gs^Fp, Ww, Gg, Gs^Fp, Gg, Aa, Aa, Re, Mm^Xm, Xu, Cud, Xu, Ai
Aa^Fpa, Gs^Ft, Hd, Dd, Dd, Gg, Gg, Re, Ss^Bw\, Ss, Gg, Gg, Hh, Gg, Gg, Ha, Mm^Xm, Xu, Cud, Xu, Ai
Aa, Dd, Md, Dd^Do, Dd, Dd, Dd, Gs^Ft, Ss, Re, Gg, Mm, Ww, Ai, Gg, Hh, Mm^Xm, Xu, Xu, Xu, Ai
Ms, Md, Dd^Dc, Hd, Dd, Dd^Vda, Gs^Ft, Hh, Ss, Re, Re, Mm, Ww, Aa^Vha, Aa^Fpa, Gg^Fet, Mm^Xm, Xu, Ai, Ai, Ai
Md, Md, Dd, Dd, Dd, Dd, Aa, Aa, Ss, Ss, Re, Ww, Ww, Ww, Aa, Aa^Fpa, Mm^Xm, Ai, Ai, Ai, Ai
