Wwf, Wwf, Wwf, Re, Mm, Hh, Re, Re, Re, Re^Uf, Re^Uf, Re, Ds, Ds, Ds, _s, Mm^Xm, Ai, Ai, Ai, Ai
Wwf, Ww^Vm, Wwf, Gs^Fp, Mm, Hh, Re^Uf, Re, Re^Uf, Re, Re, Re, Dd^Do, Ds, Ds, Re, Mm^Xm, Xu, Xu, Ai, Ai
Hh, Wwf, Wwf, Mm, Mm, Mm, Re, Re, Re, Ss^Vhs, Re^Uf, Re^Uf, Ds, Ds, Re^Uf, Re, Mm^Xm, Xu, Cud, Xu, Ai
Hh, Mm, Gs^Fp, Wwf, Wwf, Ds, Re, Re, Gs, Hh, Gs^Fp, Hh, Gs, Gg^Vh, Ds, Re^Uf, Mm^Xm, Xu, Cud, Xu, Ai
Re, Hh, Re, Re^Uf, Re, Wwf, Wwf, Gs, Gs, Hh, Gs, Gs, Re, Ds, Re, Re, Mm^Xm, Xu, Cud, Xu, Ai
Re, Gs^Vht, Re, Re, Re^Uf, Re, Ss^Vhs, Ds, Hh, Gs, Re, Re, Re, Re, Ch, Ch, Mm^Xm, Xu, Cud, Xu, Ai
Dd, Re, Re, Re, Re^Uf, Ds, Re, Ds, Gs, Re, Re, Re, Ch, Ch, Re, Ch, Mm^Xm, Xu, Cud, Xu, Ai
Dd, Ds, Hd, Re, Re, Hh, Re^Uf, Ds, Gs, Re, Re, Ch, Re, Re, Re, Kh, Mm^Xm, Xu, Cud, Xu, Ai
Dd, Dd, Gg^Vh, Re^Uf, Re, Re, Re, Gs, Wwf, Re, Re, Gg^Ve, Re, Re, Re, Gg^Vh, Mm^Xm, Xu, Cud, Xu, Ai
Dd, Dd, Dd^Dr, Hd, Rd, Re, Re, Mm, Wwf, Re, Re, Ch, Ch, Re, Re, Kh, Mm^Xm, Xu, Cud, Xu, Ai
Dd^Dr, Dd, Rd, Rd, Md, Re, Re, Ds, Wwf, Re^Uf, Re, Re, Re, Ch, Ch, Ch, Mm^Xm, Xu, Cud, Xu, Ai
Dd, Dd, Rd, Dd^Dr, Hd, Re, Gg^Ve, Gs^Fp, Mm, Wwf, Gs, Re, Re^Uf, Re, Re, Ch, Mm^Xm, Xu, Cud, Xu, Ai
Dd, Dd, Rd, Dd, Dd, Rd, Rd, Rd, Gs^Fp, Wwf, Gs, Gs^Fp, Gs, Re, Re, Re, Mm^Xm, Xu, Cud, Xu, Ai
Dd, Dd^Dr, Hd, Rd, Dd, Dd, Rd, Dd, Dd^Do, Re, Gs, Gs, Hh, Gs, Gs, Hh, Mm^Xm, Xu, Cud, Xu, Ai
Dd^Ftd, Dd, Md, Dd^Do, Dd, Dd, Dd, Dd, Dd, Re, Gs, Mm, Wwf, Ds, Gs, Hh, Mm^Xm, Xu, Xu, Xu, Ai
Md, Md, Dd^Dc, Hd, Dd, Dd^Vda, Dd^Dr, Hd, Dd, Re, Re, Mm, Wwf, Gg^Ve, Gs^Fp, Re^Uf, Mm^Xm, Xu, Ai, Ai, Ai
Md, Md, Dd, Dd, Dd, Dd, Dd, Dd, Dd, Dd, Re, Wwf, Wwf, Wwf, Re^Uf, Gs^Fp, Mm^Xm, Ai, Ai, Ai, Ai
