       Mm,       Mm,       Hh,       Hh,       Gg,       Gg,       Gg,       Re,       Re,    Gs^Fp,       Re,       Re,       Gg,       Gg,       Hh,       Hh,       Mm,       Hh,       Mm,       Mm
       Mm,       Hh,       Hh,       Hh,       Gg,       Re,       Re,       Re,       Re,       Re,       Re,       Re,       Gg,       Gg,       Hh,       Hh,       Hh,       Hh,       Hh,       Mm
       Hh,       Hh,       Hh,       Gg,       Gg,       Re,       Re,       Re,       Re,       Ss,       Ss,       Ce,       Re,       Re,       Gg,       Gg,       Gg,       Gg,       Hh,       Mm
       Hh,       Hh,       Gg,       Gg,       Re,       Re,       Re,       Re,       Ww,       Ss,       Ce,     2 Ke,       Ce,       Ss,       Re,       Gg,       Gg,       Hh,       Hh,       Hh
       Mm,       Hh,       Gg,       Gg,       Re,    Gs^Fp,       Re,       Re,       Ww,       Ww,       Ce,       Ce,       Ce,   Ww^Bw\,       Re,       Gg,       Hh,       Gg,       Hh,       Gg
       Hh,       Hh,       Hh,       Gg,       Re,       Re,       Re,       Re,       Re,       Re,   Ww^Bw/,       Ww,       Ww,       Re,       Gg,       Re,       Gg,       Re,       Gg,       Gg
       Hh,       Hh,       Hh,       Re,       Re,       Re,    Gs^Fp,       Re,       Re,       Re,       Re,       Re,       Re,       Re,       Re,       Re,       Re,    Gs^Fp,       Re,       Re
       Re,       Re,       Re,    Gs^Fp,    Gs^Fp,       Re,       Re,       Re,       Re,    Gs^Fp,       Re,    Gs^Fp,       Re,       Re,       Re,       Re,       Re,    Gs^Fp,    Gs^Fp,       Re
       Re,       Re,    Gs^Fp,       Re,    Gs^Fp,       Re,       Re,       Re,    Gs^Fp,    Gs^Fp,    Gs^Fp,       Re,       Re,       Re,    Gs^Fp,       Re,    Gs^Fp,    Gs^Fp,    Gs^Fp,       Re
       Re,    Gs^Fp,       Re,       Re,       Re,    Gs^Fp,       Re,       Re,    Gs^Fp,    Gs^Fp,    Gs^Fp,       Re,       Re,       Re,       Re,       Re,       Re,       Re,       Re,       Re
       Re,    Gs^Fp,       Re,       Re,    Gs^Fp,    Gs^Fp,    Gs^Fp,       Re,       Re,       Re,       Re,    Gs^Fp,       Re,       Re,    Gs^Fp,    Gs^Fp,       Re,       Re,    Gs^Fp,       Re
       Re,       Re,       Re,       Re,    Gs^Fp,       Gg,       Gg,       Gg,       Re,       Re,    Gs^Fp,    Gs^Fp,    Gs^Fp,    Gs^Fp,    Gs^Fp,    Gs^Fp,       Re,       Re,       Re,       Re
       Gg,       Gg,       Re,    Gs^Fp,    Gs^Fp,       Gg,       Gg,       Gg,       Re,       Re,    Gs^Fp,    Gs^Fp,    Gs^Fp,    Gs^Fp,    Gs^Fp,       Re,       Re,       Gg,       Gg,       Gg
       Gg,       Gg,       Re,       Gg,    Gs^Fp,    Gs^Fp,       Gg,    Gs^Fp,    Gs^Fp,    Gs^Fp,       Re,       Re,       Re,       Re,       Re,       Re,       Re,    Gs^Fp,    Gs^Fp,    Gs^Fp
       Gg,    Gs^Fp,    Gs^Fp,    Gs^Fp,       Gg,       Gg,       Gg,    Gs^Fp,    Gs^Fp,    Gs^Fp,       Re,       Re,       Re,    Gs^Fp,    Gs^Fp,    Gs^Fp,       Gg,    Gs^Fp,    Gs^Fp,    Gs^Fp
       Gg,    Gs^Fp,    Gs^Fp,    Gs^Fp,       Gg,       Gg,    Gs^Fp,    Gs^Fp,    Gs^Fp,       Gg,       Gg,       Gg,       Re,    Gs^Fp,    Gs^Fp,    Gs^Fp,       Gg,       Gg,    Gs^Fp,    Gs^Fp
       Gg,    Gs^Fp,    Gs^Fp,    Gs^Fp,    Gs^Fp,    Gs^Fp,    Gs^Fp,    Gs^Fp,    Gs^Fp,       Gg,       Gg,       Gg,    Gs^Fp,    Gs^Fp,    Gs^Fp,       Gg,       Gg,       Ce,    Gs^Fp,    Gs^Fp
    Gs^Fp,    Gs^Fp,    Gs^Fp,    Gs^Fp,    Gs^Fp,    Gs^Fp,       Gg,       Gg,       Gg,    Gs^Fp,       Gg,    Gs^Fp,    Gs^Fp,    Gs^Fp,    Gs^Fp,       Gg,       Ce,     1 Ke,       Ce,       Gg
    Gs^Fp,    Gs^Fp,    Gs^Fp,    Gs^Fp,    Gs^Fp,    Gs^Fp,       Gg,       Gg,    Gs^Fp,    Gs^Fp,       Gg,       Gg,       Gg,    Gs^Fp,    Gs^Fp,    Gs^Fp,       Ce,       Ce,       Ce,    Gs^Fp
    Gs^Fp,    Gs^Fp,    Gs^Fp,    Gs^Fp,    Gs^Fp,    Gs^Fp,    Gs^Fp,       Gg,    Gs^Fp,    Gs^Fp,    Gs^Fp,    Gs^Fp,       Gg,    Gs^Fp,    Gs^Fp,    Gs^Fp,       Gg,       Gg,    Gs^Fp,    Gs^Fp
