Mm, Mm, Mm, Mm, Mm, Mm, Mm, Mm, Mm, Mm, Hh^Fms, Mm, Hh^Fds, Mm, Mm, Mm, Mm, Mm, Mm, Mm, Mm, Mm, Mm, Mm, Mm, Mm, Mm, Mm
Mm, Mm, Mm, Mm, Mm, Mm, Mm, Mm, Hh^Fds, Hh^Fms, Hh^Fms, Hh^Fds, Hh^Fds, Hh^Fms, Gs^Fds, Gs^Fds, Mm, Mm, Hh^Fds, Hh^Fds, Hh^Fds, Mm, Mm, Mm, Mm, Mm, Mm, Mm
Hh^Fds, Hh^Fds, Mm, Mm, Hh^Fp, Hh, Hh^Fds, Mm, Mm, Hh^Fp, Gg, Gg, Gg^Qov, Gg^Qov, Gg^Qov, Gs^Fds, Hh, Gs^Fds, Gs^Fms, Gs^Fds, Hh^Fds, Hh^Fds, Hh^Fp, Mm, Hh, Mm, Mm, Mm
Hh^Fds, Hh^Fds, Hh^Fds, Hh^Fds, Hh^Fms, Hh^Fp, Hh^Fds, Hh^Fds, Hh, Hh, Gg^Qov, Gg^Qov, Gg, Gg, Gg, Gg^Qov, Gg^Qov, Hh, Hh, Gs^Fds, Gs^Fds, Hh^Fms, Gs^Fms, Hh^Fp, Hh^Fp, Hh, Hh, Mm
Gs^Fds, Gg^Fms, Gs^Fms, Gg^Fms, Hh^Fds, Hh^Fds, Hh^Fds, Gg, Gg^Qov, Gg^Qov, Gg^Gryv, Gg, Rd, Rd, Rd, Gg, Gg, Gg^Qov, Gg^Qov, Gs^Fds, Gs^Fds, Gs^Fds, Gs^Fds, Gs^Fms, Hh^Fds, Hh^Fds, Hh^Fds, Mm
Hh, Gs^Fds, Gg, Gs^Fds, Gg, Hh^Fds, Gg^Qov, Gg^Qov, Gg^Gryv, Gg^Gryv, Rd, Rd, Gg, Gg, Gg, Rd, Rd, Gg, Gg, Gg^Qov, Gg^Qov, Gs^Fds, Gs^Fds, Gs^Fds, Gs^Fds, Hh^Fds, Hh^Fds, Mm
Hh, Hh, Gg, Gg, Gg^Qov, Gg^Qov, Gg, Gg, Rd, Rd, Gg^Gryv, Gg, Gg, Gg, Gg, Gg^Gryv, Gg^Gryv, Rd, Rd, Gg, Gg, Gg^Qov, Gg^Qov, Gs^Fds, Hh, Gs^Fds, Hh^Fds, Hh^Fds
Hh, Hh, Gg^Qov, Gg^Qov, Gg^Gryv, Gg^Gryv, Rd, Rd, Gg^Gryv, Gg^Gryv, Gg, Gg, Gs^Fds, Gs^Fds, Gs^Fds, Gg^Vov, Gg, Gg^Gryv, Gg^Gryv, Rd, Rd, Gg, Gg, Gg^Qov, Gg^Qov, Hh, Hh, Hh
Hh, Gg^Qov, Gg^Qov, Gg, Gg, Rd, Rd, Gg, Gg, Gg^Gryv, Gg, Gs^Fds, Gs^Fds, Wwt, Wwt, Gs^Fds, Gs^Fds, Gg, Gg^Gryv, Gg^Gryv, Gg^Gryv, Rd, Rd, Gg, Gg, Gg^Qov, Gg^Qov, Hh
Hh, Hh, Hh, Gg^Qov, Gg^Qov, Gg, Gg^Gryv, Rd, Rd, Gg, Gg, Gg, Gg, Gs^Fds, Gs^Fds, Gs^Fds, Gg, Gg, Gg^Gryv, Gg^Gryv, Rd, Rd, Gg, Gg, Gg^Qov, Gg^Qov, Gg, Gg
Hh, Hh, Xv, Gg, Gg^Nhyr, Gg^Qov, Gg^Qov, Gg, Gg, Rd, Rd, Gg^Gryv, Gg^Gryv, Gg, Gg, Gg, Gg, Gg^Gryv, Rd, Rd, Gg, Gg, Gg^Qov, Gg^Qov, Gg, Gg, Gg, Gg
Hh, Xv, 1 Xv, Xv, Gg^Nhyr, Gg^Nhyr, Gg^Nhyr, Gg^Qov, Rd^Qov, Rd, Gg^Vhh, Rd, Rd, Gg, Gg^Gryv, Gg, Rd, Rd, Gg^Gryv, Gg^Gryv, Gg^Qov, Gg^Qov, Gg, Gg, Gg, Gg, Rrc, Rrc
Gg, Xv, Xv, Xv, Hh^Nhyr, Gg^Nhyr, Rd^Nhyr, Rd^Nhyr, Gg^Nhyr, Gg^Qov, Gg^Qov, Gg, Gg, Rd, Rd, Rd, Gg, Gg, Gg^Qov, Gg^Qov, Gg, Gg, Gg, Gg, Rrc, Rrc, Rd, Gg
Rrc, Gg, Gg, Gg, Rd^Nhyr, Rd^Nhyr, Hh^Nhyr, Gg^Nhyr, Hh^Nhyr, Gg^Nhyr, Gg^Nhyr, Gg^Qov, Gg^Qov, Gg, Gg^Fnzt, Gg, Gg^Qov, Gg^Qov, Gg, Gg, Gg, Gg, Rrc, Rrc, Gg, Gg, Gs^Vh, Gg
Gg, Rrc, Rrc, Rd, Gg^Nhyr, Hh^Nhyr, Hh^Nhyr, Hh^Nhyr, Hh^Nhyr, Hh^Nhyr, Hh^Nhyr, Gg^Nhyr, Gg^Nhyr, Gg^Qov, Gg^Fnzb, Gg^Qov, Gg^Nhyr, Gg, Gg, Gg, Rrc, Rrc, Gg, Rd, Gg, Gg, Hh, Gg
Gs^Vh, Rd, Gg, Rrc, Rrc, Gg^Nhyr, Rrc^Nhyr, Hh^Nhyr, Hh^Nhyr, Hh^Nhyr, Rrc^Nhyr, Hh^Nhyr, Hh^Nhyr, Gg^Nhyr, Hh^Nhyr, Gg^Nhyr, Hh, Hh, Rrc, Rrc, Rd, Gg, Gg, Gs^Vh, Gg, Hh, Hh, Hh
Hh, Gg, Hh, Gg, Rd, Rrc, Gg, Rrc^Nhyr, Rrc^Nhyr, Rrc^Nhyr, Hh^Nhyr, Rrc^Nhyr, Rrc^Nhyr, Hh^Nhyr, Hh, Hh, Rrc, Rrc, Hh, Hh, Gg, Gs^Vh, Gg, Gg, Hh, Hh, Hh, Hh
Hh, Hh, Gg, Gs^Vh, Gg, Gg, Gg, Gg, Hh, Hh, Hh, Hh, Hh, Rrc, Rrc, Rrc, Gg, Gg, Gg, Hh, Hh, Hh, Hh, Hh, Hh, Hh, Hh, Hh
