border_size=1
usage=map

Ds, Wwt, Wwt, Wwt, Wwt, Wwt, Wwt, Wwt, Wwt, Wwt, Wwt, Wwt, Wwt, Wot, Wwt, Wot, Wwt, Wwt, Wwt, Wwt, Wwt, Wwt, Wwt, Wwt, Wwt, Wwt, Wwt
Gg, Ds, Gg, Gg, Gg, Gg, Gg, Wwt, Ds, Wwt, Wwt, Wwt, Wwt, Wwt, Wwt, Wwt, Wwt, Wwt, Wwt, Wwt, Wwt, Wwt, Gg, Gg, Gg, Wwt, Gg
Gg, Gg, Gg, Gg, Gg, Gg, Gg, Gg, Gg, Ds, Ds, Wwt, Wwt, Wwt, Wwt, Wwt, Wwt, Wwt, Gg, Gg, Gg, Gg, Gg, Gg, Gg, Gg, Gg
Gs, Gg, Gg, Gg, Gg, Gg^Vc, Gg, Gg, Gg, Gg, Ds^Es, Ds, Ds, Wwt^Es, Ds, Wwt, Ds, Ds, Gg, Gg, Gs, Gg, Gg, Gg, Gg, Gg, Gg
Gs, Gg, Gg, Gg, Gg, Gg, Gg, Gg, Gg, Gg, Gg, Ds^Es, Ds, Ds, Ds^Es, Ds, Ds, Gg, Gg, Gg^Efm, Gg, Gs, Gg, Gs, Gs, Gg, Gg
Gs, Gg, Gg, Gg^Efm, Gg^Efm, Gg^Efm, Gs, Gg, Wwt, Wwt, Wwt, Gg, Gg, Ds^Es, Gg, Ds^Es, Gg, Gg, Gg, Gg, Re, Gg, Gg, Gg, Gs, Gg, Gg
Gg, Gs, Gg, Gg, Gg, Gs, Gs, Gs, Gg, Wwt, Gg, Gg, Gs^Vht, Gg, Gg, Gg, Gg^Fms, Gg, Gg, Re, Gg, Gg, Gg, Gg^Efm, Gg^Efm, Gg, Gg
Gg, Gg, Gg, Gg, Ce, Ce, Gg, Gs, Wwt, Gg, Gs, Gg, Gs, Gs, Gs, Gg, Gs, Gs^Fp, Re, Gg, Gg, Gs, Gs, Gg, Gg, Gg, Gg
Gg, Gg, Gs, Gs, Ce, Ce, Gg, Wwt, Wwt^Bw/r, Gs, Gs^Vc, Gg, Gg, Gg, Gs^Fms, Gs, Gg, Gs^Fms, Gg, Re, Gg, Gg, Gg, Gg^Efm, Gs, Gs, Gg
Gg, Gg, 1 Ke, Gs, Ce, Ce, Gg, Gg^Efm, Wwt, Wwt, Gs, Gg, Gs^Fds, Gs^Fp, Gs^Fds, Gg^Efm, Gs, Gg, Gs, Gg, Re, Re, Gg, Gs, Gs, Gs, Gg
Gg, Gs, Gg, Gs^Cov, Ce, Ce, Gg, Gg, Gg, Gg, Gg, Gg, Gs, Gs, Gs, Gs, Gg, Gs, Gg, Gg, Gg, Re, Re, Re, Re, Gg, Gs
Gs, Gs, Gs, Gg, Ce, Ce, Gs, Gg, Gg, Gg, Gg, Gs, Gs^Vl, Gg, Gs^Fds, Gs^Fms, Gs^Fds, Gg, Re, Re, Gg, Gg, Gg, Gg, Gg, Gs, Gs
Gg, Gs, Gg, Gg, Gg, Gg, Gg, Gg^Efm, Gg, Gg, Gs^Fp, Gg^Efm, Gs^Fms, Gs^Fds, Gg^Efm, Gg^Efm, Gs^Fms, Gs^Fds, Gs^Fds, Gg, Gg^Efm, Gg, Gg, Gg, Gg, Gs, Gs
Gg, Gg, Gg, Gg, Gg, Gg, Gg, Gg, Gs^Fds, Gs^Fds, Gll^Fp, Gs^Fms, Gs^Fds, Gs^Fds, Gs^Fds, Gs^Fds, Gs^Fds, Gll^Fp, Gs^Fds, Gs^Fms, Gs^Fms, Gg, Gg, Gg, Gg, Gg, Gg
