border_size=1
usage=map

Xue, Xue, Xue, Xue, Xue, Xue, Xue, Xue, Xue, Xue, Xue, Xu, Xu, Xu, Xu, Xu, Xu, Xu, Xu, Xu, Xu, Ai, Xu, Xu, Xu, Xu, Xu, Xu, Xu, Xu, Xu, Xu, Xu, Xu, Xu, Xu, Xu, Xu, Xu, Xu, Xu, Xu, Xu, Xu, Xu, Xu, Ai^Es, Xu, Xu, Xu, Xu, Xu, Xu, Xu, Xu
Xue, Xue, Xue, Xue, Xue, Xue, Xue, Xue, Xue, Xue, Xue, Xue, Xue, Xu, Xu, Xu, Xu, Xu, Xu, Xu, Xu, Ai, Xu, Xu, Uh^Wyb, Xu, Xu, Xu, Uh^Vu, Xu, Xu, Xu, Xu, Xu, Xu, Xu, Xu, Xu, Xu, Xu, Xu, Xu, Xu, Xu, Xu, Xu, Xu, Ai^Es, Ai, Xu, Xu, Xu, Xu, Xu, Xu
Xue, Xue, Xue, Xue, Xue, Xue, Xue, Xue, Xue, Xue, Xue, Xue, Xue, Xu, Xu, Xu, Xu, Xu, Xu, Xu, Xu, Ai, Uu, Uue^Uf, Rb^Es, Uu^Em, Uh, Uu^Es, Uu^Es, Xu, Xu, Xu, Xu, Xu, Xu, Xu, Uh^Vud, Xu, Rb^Es, Xu, Xu, Xu, Rb^Es, Uh^Vud, Uh, Xu, Xu, Xu, Xu, Ai, Ai, Xu, Xu, Xu, Uu
Xue, Xue, Xue, Xue, Xue, Xue, Xue, Xue, Xue, Xue, Xue, Xue, Xue, Xu, Xu, Xu, Xu, Xu, Uh^Es, Xu, Ai^Es, Ai, Xu, Uu^Es, Uu^Es, Ur^Es, Ur^Es, Uue^Uf, Xu, Xu, Uh, Xu, Uh^Wyb, Xu, Xu, Xu, Xu, Uu, Xu, Rb^Es, Uu, Ur^Es, Xu, Rb^Es, Ur^Es, Xu, Xu, Xu, Xu, Xu, Xu, Ai^Es, Ur, Uu, Xu
Xue, Xue, Xue, Xue, Xue, Xue, Xue, Uue^Wyb, Rb^Es, Rb^Es, Uue^Vu, Xue, Xue, Xue, Xu, Uh^Wyb, Uu^Vud, Uh^Es, Ww^Es, Ww^Es, Xu, Xu, Uh^Wyb, Uh^Vu, Uh, Xu, Ur^Es, Uu^Es, Uu^Em, Uh, Xu, Uh, Rb^Es, Xu, Xu, Xu, Xu, Rb^Es, Xu, Xu, Xu, Xu, Xu, Xu, Uu^Es, Xu, Uu, Cud^Wyb, Cud, Xu, Uu, Ww, Ww^Es, Xu, Xu
Xue, Xue, Xue, Xue, Xue, Xue, Xue, Uue, Xue, Xue, Xue, Uue^Dr, Uue^Uf, Xue, Xue, Uh, Uu, Uh^Es, Ww, Uu^Es, Xu, Xu, Xu, Uh, Uh, Xu, Uu^Vud, Ur^Em, Qxu^Wyb, Uh^Uf, Uh, Rb^Es, Uh^Uf, Xu, Xu, Xu, Rb^Es, Ur^Es, Uh, Xu, Xu, Uu^Wyb, Urb, Uu^Vud, Uu, Ur, Ur, Uu, Uu, Cud, Cud, Ur, Ai^Es, Xu, Xu
Xue, Xue, Xue, Xue, Xue, Xue, Xue, Rb^Es, Xue, Xue, Xue, Xue, Uue^Uf, Xue, Rb^Wyb, Xue, Xu, Uu, Ai^Es, Xu, Uu^Es, Uh^Wyb, Uh, Xu, Uh, Uu, Uh, Uh^Em, Ur^Em, Qxu^Wyb, Uh, Rb^Es, Xu, Uh, Xu, Xu, Ur^Em, Xu, Xu, Xu, Urb, Urb, Urb, Urb, Cud, Uu, Uu, Uu, Ur, Ur, Cud^Dr, Xu, Xu, Ai^Es, Xu
Xue, Xue, Xue, Xue, Uue^Vu, Uue^Wyb, Uue^Uf, Uue^Uf, Uue, Xue, Xue, Uue^Dr, Uue, Uue, Uue^Uf, Xue, Xue, Xu, Uh, Ww^Es, Ur^Es, Uu^Es, Cud, Kud, Ur^Es, Ur, Rb^Es, Uh^Em, Uh, Rb^Es, Rb^Em, Uu^Em, Ur^Em, Ur^Es, Uu^Vud, Uu, Xu, Xu, Xu, Urb, Urb^Es, Urb, Urb, Cud^Es, Cud, Cud^Qov, Cud, Uu, Uu^Es, Uu, Uu^Vud, Xu, Xu, Ai, Ai
Xu, Xue, Xue, Xue, Rb^Es, Uue, Rb^Es, Uue, Rb^Es, Rb^Es, Uue, Xue, Uue^Uf, Rb^Es, Uue^Dr, Uue^Uf, Uue^Dr, Rb^Es, Uue, Ww, Ww^Es, Uh, Cud^Es, Uu, Uu, Xu, Xu, Xu, Uh, Rb^Es, Uh, Uh, Xu, Uu^Em, Uu^Em, Ur^Es, Uh, Xu, Xu, Cud^Es, Cud^Es, Urb, Urb, Urb^Es, Urb^Es, Cud, Cud, Cud^Dr, Urb, Uu^Es, Uu^Dr, Xu, Xu, Xu, Ai
Uu, Xu, Rb^Es, Uue, Xu, Uue^Dr, Uh^Es, Rb^Es, Rb^Es, Uue, Uue, Rb^Es, Uue, Uue^Uf, Uue, Uue, Qxe, Rb^Es, Uue^Dr, Rb^Es, Ai^Es, Xu, Xu, Ur^Es, Uh, Xu, Xu, Uh, Ur^Em, Uh^Uf, Uh, Xu, Rb^Es, Ur^Es, Xu, Xu, Xu, Xu, Cud^Es, 1 Kud, Cud^Es, Urb^Es, Urb^Es, Urb^Es, Urb^Es, Urb, Urb, Urb, Urb, Urb, Uu^Wyb, Xu, Xu, Xu, Xu
Xu, Ur^Es, Xue, Xu, Xue, Xu, Xue, Uh^Es, Uh^Es, Rb^Es, Uh^Es, Uue, Xue, Xue, Uue^Uf, Uue^Uf, Uue^Dr, Uue^Uf, Uue^Wyb, Xue, Xue, Ww^Es, Xu, Uh^Wyb, Uh, Uh, Rb^Es, Rb^Es, Uu^Dr, Uh, Uu, Ur^Es, Uu^Wyb, Ur^Wyb, Xu, Xu, Xu, Cud, Urb^Es, Cud^Es, Urb^Es, Cud^Dr, Cud, Urb, Cud, Urb, Urb, Urb, Urb^Dr, Uu^Es, Xu, Xu, Xu, Xu, Xu
Xue, Xue, Xue, Xue, Uue^Vu, Xue, Uue^Wyb, Xue, Xue, Uh^Wyb, Xu, Uh^Es, Rb^Es, Xue, Uue^Uf, Uue^Dr, Uue, Uue^Uf, Xue, Xue, Ai^Es, Ai^Es, Xu, Xu, Xu, Uu^Dr, Rb^Es, Uu^Dr, Rb^Es, Xu, Xu, Xu, Xu, Xu, Uh^Wyb, Xu, Cud^Dr, Cud, Urb, Urb^Es, Urb, Urb^Es, Urb, Cud, Kud, Cud, Urb^Es, Urb^Es, Uu^Es, Uu^Es, Uu^Wyb, Xu, Xu, Xu, Xu
Xue, Xue, Xue, Xue, Uue^Dr, Uue, Rb^Es, Xue, Rb^Es, Xue, Uue, Uh^Es, Xu, Uue^Vu, Xue, Uue^Wyb, Xue, Xue, Xue, Ai, Xu, Xu, Xu, Xu, Xu, Xu, Xu, Uh, Uu, Xu, Uu^Vu, Uh, Uh^Es, Uh, Ur^Es, Uu^Es, Ur, Ur, Ur^Es, Urb, Urb, Urb^Es, Cud^Dr, Cud, Cud, Cud, Cud^Dr, Uu^Es, Uu^Vud, Uu, Xu, Xu, Uh^Wyb, Xu, Xu
Xue, Xue, Xue, Rb^Es, Rb^Es, Qxe, Uue, Rb^Es, Uue^Wyb, Uue, Xue, Xue, Xue, Xue, Xue, Xue, Ai, Xue, Ai, Ai^Es, Xu, Xu, Xu, Xu, Xu, Xu, Xu, Uu^Dr, Ur^Es, Ur^Es, Ur^Es, Uu, Ur^Es, Ur, Uu^Es, Uu^Es, Uh, Uu, Uh, Ur^Es, Cud^Es, Cud^Dr, Xu, Xu, Xu, Xu, Xu, Xu, Ur, Ur, Xu, Uh, Uu^Vud, Xu, Xu
Xue, Xue, Xue, Uue^Dr, Uue^Dr, Qxe, Uue^Vu, Xue, Xue, Xue, Xue, Xue, Ai, Ai, Ai^Es, Ai^Es, Xu, Ai^Es, Xu, Xu, Xu, Xu, Xu, Xu, Xu, Xu, Xu, Xu, Uh^Wyb, Uu, Ur^Es, Uu, Uh, Uu^Es, Uh, Uh, Uu, Uh^Es, Xu, Cud^Es, Xu, Xu, Xu, Xu, Uh^Vud, Ur^Wyb, Ur, Uu, Xu, Uu, Uu, Ur, Uu^Wyb, Uu^Wyb, Xu
Xue, Xue, Xue, Xue, Xue, Uue^Wyb, Xue, Xue, Xue, Xue, Ai, Ai, Xue, Xu, Xu, Xu, Xu, Xu, Xu, Xu, Xu, Xu, Xu, Xu, Xu, Xu, Xu, Xu, Xu, Uu, Xu, Uu, Xu, Uh, Xu, Uh^Wyb, Xu, Xu, Xu, Xu, Xu, Xu, Xu, Xu, Xu, Uh, Xu, Xu, Xu, Xu, Xu, Xu, Xu, Xu, Xu
Xue, Xu, Xue, Xu, Xue, Xu, Xu, Xue, Ai, Ai, Xue, Xu, Xue, Xu, Xu, Xu, Xu, Xu, Xu, Xu, Xu, Xu, Xu, Xu, Xu, Xu, Xu, Xu, Xu, Xu, Xu, Xu, Xu, Xu, Xu, Xu, Xu, Xu, Xu, Xu, Xu, Xu, Xu, Xu, Xu, Xu, Xu, Xu, Xu, Xu, Xu, Xu, Xu, Xu, Xu
