Dd, Dd, Dd, Dd, Dd, Dd, Dd, Dd, Dd, Dd, Dd, Dd, Dd, Dd, Dd, Dd, Dd, Dd, Dd, Dd, Dd, Dd, Dd, Dd, Dd, Dd, Dd, Dd, Dd, Dd, Dd, Dd, Dd, Dd, Dd, Dd, Dd, Dd, Dd, Dd, Dd
Dd, Dd, Dd, Dd, Dd, Dd, Dd, Dd, Dd, Dd, Dd, Dd, Dd, Dd, Dd, Dd, Dd, Dd, Dd, Dd, Dd, Dd, Dd, Dd, Dd, Dd, Dd, Dd, Dd, Dd, Dd, Dd, Dd, Dd, Dd, Dd, Dd, Dd, Dd, Dd, Dd
Dd, Dd, Dd, Dd, Hd, Dd, Dd, Dd, Dd, Dd, Dd, Dd, Hd, Dd, Dd, Dd, Dd, Dd, Dd, Hd, Dd, Dd, Hd, Hd, Dd, Dd, Dd, Dd, Hd, Dd, Dd, Dd, Hd, Dd, Dd, Dd, Hd, Hd, Dd, Dd, Dd
Dd, Dd, Dd, Dd, Dd^Edp, Hd, Hd, Dd, Dd, Dd, Dd, Dd, Dd, Dd, Dd, Hd, Hd, Dd, Hd, Dd, Hd, Hd, Hd, Dd, Hd, Dd, Dd, Dd, Hd, Hd, Dd, Dd, Dd, Dd, Dd, Hd, Hd, Hd, Dd, Dd, Dd
Dd, Dd, Dd, Dd, Dd, Hd, Hd, Dd, Dd, Hd, Hd, Dd, Dd, Dd, Dd, Dd, Dd, Dd, Hd, Hd, Ce, Ce, Ce, Hd, Hd, Hd, Dd, Dd, Dd, Hd, Dd, Dd, Dd, Dd, Dd, Dd, Dd, Dd, Dd, Dd, Dd
Dd, Dd, Hd, Hd, Dd, Dd, Dd, Dd, Dd, Hd, Dd, Dd, Dd, Hd, Dd, Dd, Hd, Hd, Hd, Hd, Ce, Wwg, Wwg, Ce, Hd, Hd, Hd, Dd, Dd, Dd, Dd, Hd, Dd, Dd, Hd, Dd, Dd, Hd, Dd, Dd, Dd
Dd, Dd, Dd, Hd, Dd, Dd, Dd, Dd, Dd, Dd, Dd, Dd, Dd, Dd, Dd, Dd, Hd, Hd, Hd, Hd, Ce, Ce, 2 Ke, Ce, Hd, Hd, Hd, Hd, Hd, Dd, Dd, Dd^Edp, Dd, Dd, Dd, Dd, Dd, Dd, Dd, Dd, Dd
Dd, Dd, Dd, Hd, Dd, Dd, Hd, Dd, Dd, Dd^Edp, Dd, Dd, Dd, Dd, Dd, Hd, Hd, Dd^Vdt, Hd, Hd, Hd, Ce, Ce, Ce, Hd, Hd, Hd, Dd^Vdt, Hd, Dd, Dd, Dd, Hd, Dd, Dd, Dd, Dd, Dd, Hd, Dd, Dd
Dd, Dd, Dd, Dd, Dd, Hd, Hd, Dd, Dd, Dd, Dd, Hd, Hd, Dd, Dd, Hd, Hd, Hd, Hd, Hd, Hd, Hd, Hd, Hd, Hd, Hd, Hd, Hd, Dd, Dd, Dd, Dd, Dd, Dd, Hd, Dd, Dd, Hd, Hd, Dd, Dd
Dd, Dd, Dd, Dd, Dd, Hd, Dd, Hd, Dd, Dd, Dd, Dd, Dd, Dd, Hd, Dd, Dd, Hd, Hd, Hd, Md, Md, Md, Hd, Hd, Hd, Hd, Dd, Dd, Dd, Hd, Dd, Dd, Dd, Dd, Hd, Dd, Dd, Dd, Dd, Dd
Dd, Dd, Dd, Dd, Dd, Dd, Dd, Dd, Dd, Dd, Dd^Edp, Dd, Dd, Dd, Dd, Dd, Dd, Hd, Hd, Dd^Vdt, Hd, Md, Hd, Hd, Dd^Vdt, Hd, Hd, Hd, Dd, Dd, Hd, Hd, Dd, Dd, Dd, Dd, Dd, Dd, Dd, Dd, Dd
Dd, Dd, Hd, Dd, Dd, Dd, Dd, Dd, Hd, Dd, Dd, Dd, Hd, Dd, Dd, Dd, Dd, Dd, Hd, Hd, Hd, Hd, Dd, Hd, Hd, Hd, Hd, Hd, Dd, Dd, Dd, Dd, Dd, Dd, Hd, Dd, Dd, Dd, Dd, Dd, Dd
Dd, Dd, Dd, Hd, Dd, Dd, Dd, Hd, Dd, Dd, Dd, Dd, Hd, Dd, Dd, Dd, Dd, Dd, Dd, Hd, Hd, Hd, Dd, Dd, Hd, Dd, Dd, Dd, Dd, Dd, Dd, Dd, Dd, Dd, Dd, Hd, Dd, Dd, Dd, Dd, Dd
Dd, Dd, Dd, Dd, Dd, Dd, Dd, Dd, Dd, Dd, Rd, Dd, Dd^Edp, Dd, Dd, Hd, Hd, Dd, Dd, Dd, Dd, Dd, Dd, Dd, Hd, Hd, Dd, Dd, Dd, Hd, Dd, Dd, Dd, Dd, Dd, Dd, Dd, Hd, Hd, Dd, Dd
Dd, Dd, Dd, Dd, Dd, Dd, Hd, Dd, Dd^Edp, Rd, Wwt, Dd, Dd, Dd, Dd, Dd, Dd, Dd, Dd, Dd, Dd, Dd, Dd, Dd, Dd, Hd, Dd, Dd, Dd, Dd, Dd, Dd, Hd, Hd, Dd, Dd, Dd, Dd, Dd, Dd, Dd
Dd, Dd, Hd, Dd, Dd, Hd, Dd, Dd, Dd, Rd, Wwt, Wwt, Wwt, Rd, Rd, Dd, Dd^Edp, Dd, Hd, Hd, Dd, Dd, Hd, Dd, Dd, Dd, Dd, Dd, Hd, Dd, Dd, Dd, Dd, Hd, Dd, Dd, Dd, Dd, Dd, Dd, Dd
Dd, Dd, Hd, Hd, Dd, Dd, Dd, Dd, Dd, Dd^Edp, Gs^Ftd, Wwt, Wwt, Dd^Es, Dd, Dd, Dd, Dd, Dd, Dd, Dd, Dd, Hd, Hd, Dd, Dd, Dd, Dd, Hd, Dd, Dd, Dd, Dd, Dd, Dd, Dd, Hd, Dd, Dd, Dd, Dd
Dd, Dd, Dd, Dd, Dd, Dd, Hd, Dd, Dd^Edp, Dd, Dd, Wwt, Dd, Dd^Edp, Dd, Dd, Dd, Dd, Rd, Dd, Dd, Dd, Dd, Hd, Dd, Dd, Dd, Dd, Dd, Dd, Dd, Dd, Dd, Dd, Dd, Hd, Hd, Hd, Dd, Dd, Dd
Dd, Dd, Dd, Dd, Dd, Hd, Dd, Dd, Dd, Dd, Dd, Dd, Dd, Dd, Dd, Hd, Dd, Dd, Rd, Dd, Dd, Dd, Dd, Dd, Dd, Dd, Dd, Dd, Dd, Dd, Dd, Dd, Dd, Dd, Dd, Dd, Dd, Dd, Dd, Dd, Dd
Dd, Dd, Dd, Dd, Dd, Dd, Dd, Dd, Dd, Dd, Hd, Dd, Dd, Dd, Dd, Dd, Dd, Dd, Dd, Rd, Dd, Dd, Dd, Dd, Dd, Dd^Es, Dd, Dd, Dd, Dd, Dd, Dd, Dd, Dd, Dd, Dd, Dd, Dd, Dd, Dd, Dd
Dd, Dd, Hd, Dd, Dd, Dd, Dd, Dd, Dd, Dd, Dd, Dd, Dd, Hd, Dd, Dd, Dd, Dd, Dd, Dd, Dd, Dd, Rd, Dd, Dd, Dd, Dd, Dd, Dd, Dd, Dd, Dd, Dd, Dd, Dd, Dd, Dd, Dd, Dd, Dd, Dd
Dd, Dd, Dd, Dd, Dd, Hd, Dd, Dd, Hd, Dd, Dd, Dd, Dd, Dd, Dd, Dd, Dd, Dd, Dd, Dd, Dd, Dd, Dd, Rd, Rd, Dd, Dd, Dd, Dd, Dd, Dd^Edp, Dd, Dd, Dd, Dd, Dd, Dd, Dd, Dd, Dd, Dd
Dd, Dd, Dd, Dd, Dd, Dd, Dd, Hd, Hd, Dd, Dd, Hd, Dd, Dd, Dd, Dd, Dd, Dd, Dd, Dd^Es, Dd, Dd, Dd, Dd, Dd, Dd, Dd, Dd, Dd, Dd, Dd, Dd, Dd, Dd, Dd, Dd, Dd, Dd, Dd, Dd, Dd
Dd, Dd, Dd, Dd, Dd, Dd, Dd, Hd, Dd, Dd, Hd, Dd, Dd, Dd, Dd, Dd, Dd, Dd, Dd, Dd, Dd, Dd, Dd, Dd, Dd, Dd, Dd, Dd, Dd, Dd, Dd, Dd, Dd, Dd^Es, Dd, Dd, Dd, Dd, Dd, Dd, Dd
Dd, Dd, Dd, Dd, Hd, Dd, Dd, Dd, Dd, Dd, Dd, Dd, Hd, Dd, Dd, Dd, Dd, Dd, Dd, Dd, Dd, Dd, Dd, Dd, Dd, Dd, Dd, Dd, Dd, Rd, Rd, Dd, Dd^Es, Dd, Chr, Dd, Dd^Es, Dd, Dd, Dd, Dd
Dd, Dd, Dd, Hd, Hd, Dd, Dd, Dd, Hd, Dd, Dd, Dd, Dd, Dd, Dd, Dd, Dd, Dd, Dd, Dd, Hd, Dd, Hd, Dd, Hd, Dd, Dd, Dd, Dd, Dd, Dd^Es, Rd, Dd^Dr, Chr, 3 Khr, Chr^Es, Chr^Es, Dd, Dd^Es, Dd, Dd
Hd, Hd, Dd, Dd, Dd, Dd, Dd, Hd, Dd, Dd, Hd, Dd, Dd, Dd, Dd, Dd, Dd, Dd, Hd, Hd, Hd, Hd, Hd, Hd, Dd, Dd, Dd, Dd, Dd^Edp, Dd, Dd^Es, Dd^Dr, Chr, Dd^Dr, Chr^Es, Chr, Wwg, Chr, Dd, Dd, Dd
Hd, Hd, Hd, Dd, Dd, Dd, Dd, Dd, Dd, Dd, Dd, Dd, Dd, Dd, Dd, Dd, Dd, Hd, Hd, Hd, Hd, Hd, Dd, Dd, Hd, Dd, Dd^Es, Dd, Dd, Dd, Dd^Es, Chr^Es, Rd^Es, Rd, Re, Wwg, Wwg, Chr^Es, Dd, Dd^Es, Dd
Hd, Hd, Hd, Dd, Hd, Dd, Dd, Dd, Hd, Dd, Dd, Dd, Dd, Dd, Dd, Dd, Dd, Hd, Hd, Hd, Hd, Dd, Dd, Hd, Hd, Dd, Dd, Dd, Dd, Dd, Dd^Es, Chr, Dd, Rd^Es, Rd^Es, Re^Es, Dd^Dr, Chr, Dd^Es, Dd^Es, Dd
Hd, Hd, Hd, Dd, Dd, Dd, Dd, Hd, Dd, Dd, Dd, Hd, Dd, Dd, Dd, Dd, Dd, Hd, Hd, Hd, Hd, Dd, Dd, Dd, Dd, Dd, Dd, Dd, Rd, Dd^Es, Dd, Dd, Dd, Chr^Es, Chr, Dd^Dr, Dd, Dd^Es, Dd, Dd, Dd
Hd, Hd, Hd, Hd, Dd, Dd, Dd, Dd, Dd, Dd, Dd, Dd, Dd, Dd, Dd, Dd, Dd, Hd, Hd, Hd, Hd, Hd, Hd, Dd, Dd, Dd, Hd, Hd, Dd, Dd, Dd, Dd, Dd^Es, Dd, Dd, Dd^Es, Dd, Dd, Dd, Dd, Dd
Hd, Hd, Hd, Hd, Hd, Dd, Hd, Dd, Dd, Hd, Dd, Dd, Dd, Dd, Dd, Dd, Dd, Dd, Dd, Hd, Hd, Hd, Hd, Hd, Hd, Dd, Dd, Dd, Dd, Dd, Dd, Dd, Dd, Dd, Dd, Dd, Dd, Dd, Dd, Dd, Dd
Hd, Hd, Hd, Hd, Hd, Dd, Hd, Dd, Dd, Dd, Dd, Dd, Dd, Dd^Es, Dd, Dd, Dd, Dd, Dd, Dd, Dd, Hd, Hd, Hd, Hd, Dd, Dd, Dd, Dd, Dd, Dd, Dd, Dd, Dd, Dd, Dd, Dd, Dd, Dd, Dd, Dd
Hd, Hd, Hd, Hd, Dd, Dd, Dd, Dd, Dd, Hd, Dd^Es, Dd, Hd, Dd, Dd, Dd, Dd, Dd, Dd, Dd, Rd, Rd, Dd, Hd, Hd, Hd, Dd, Dd, Dd, Dd, Dd, Dd, Dd, Dd, Dd, Dd, Dd, Dd, Dd, Dd, Dd
Hd, Hd, Hd, Hd, Dd, Dd, Dd, Dd, Dd, Dd, Dd, Dd, Dd, Dd, Dd, Dd, Dd, Dd, Dd, Dd, Dd, Dd, Dd, Dd, Dd, Hd, Dd, Dd, Dd, Dd^Edp, Dd, Dd, Dd, Dd, Dd, Dd, Dd, Dd, Dd, Dd, Dd
Hd, Hd, Hd, Dd, Dd, Dd, Hd, Dd, Dd, Hd, Hd, Dd, Dd, Dd, Hd, Dd, Dd, Dd, Dd, Dd, Dd, Dd, Dd, Dd, Dd, Dd, Dd, Dd, Dd, Dd, Dd, Dd, Dd, Dd, Dd, Dd, Dd, Dd, Dd, Dd, Dd
Hd, Hd, Dd, Dd, Dd, Dd, Dd, Hd, Dd, Hd, Dd, Dd, Dd, Dd, Dd, Dd, Dd, Dd, Dd, Dd, Dd^Edp, Dd, Dd, Dd, Dd, Dd, Dd, Dd, Dd, Dd, Dd, Dd, Dd, Dd, Dd, Dd, Dd, Dd, Dd, Dd, Dd
Dd, Dd, Dd, Dd, Dd, Dd^Edp, Dd, Dd, Dd, Dd, Dd, Hd, Dd, Dd, Dd, Dd, Dd, Dd, Dd, Dd, Dd, Dd, Dd, Dd, Dd, Dd, Dd, Dd, Dd, Dd, Dd, Dd, Dd, Dd, Dd, Dd, Hd, Dd, Dd, Dd, Dd
Hd, Hd, Hd, Dd, Dd, Dd, Dd, Dd, Hd, Dd, Dd^Edp, Dd, Dd, Dd, Dd, Dd, Dd, Dd, Dd, Dd, Dd, Dd, Dd, Dd, Dd, Dd, Dd, Dd, Dd, Dd, Dd, Dd, Dd, Dd, Hd, Hd, Dd, Dd, Dd, Dd, Dd
Hd, Hd, Dd, Hd, Dd^Edp, Dd, Hd, Dd, Dd, Dd, Dd, Dd, Dd, Dd, Dd, Dd, Dd, Dd, Dd, Dd, Dd, Dd, Dd, Dd, Dd, Dd, Dd, Dd, Dd, Dd, Dd, Dd, Hd, Hd, Hd, Hd, Dd, Dd, Dd, Dd, Dd
Dd, Dd, Dd^Edp, Dd, Dd, Dd, Hd, Hd, Dd, Dd, Hd, Dd, Rd, Rd, Dd, Dd, Dd^Edp, Dd, Dd, Dd, Dd, Dd, Dd, Dd, Dd, Dd, Dd, Dd, Dd, Dd, Hd, Hd, Hd, Hd, Dd, Dd, Dd, Dd, Dd, Dd, Dd
Dd, Dd, Dd, Hd, Hd, Dd, Dd, Hd, Dd, Dd, Dd^Edp, Dd, Dd, Dd, Dd, Dd, Dd, Dd, Dd, Dd, Dd, Dd, Dd, Dd, Dd, Dd, Dd, Dd, Dd, Hd, Hd, Hd, Hd, Hd, Dd, Dd, Dd, Dd, Dd^Edp, Dd, Dd
Dd, Dd, Dd, Hd, Dd, Dd, Dd^Edp, Dd, Gd^Edp, Dd, Rd, Rd, Dd, Dd, Dd^Edp, Dd, Dd, Dd, Dd, Dd, Dd, Dd, Dd, Dd, Dd, Dd, Dd, Dd, Hd, Hd, Hd, Hd, Hd, Dd, Dd, Dd, Dd, Dd, Dd, Dd, Dd
Dd, Dd, Dd, Dd, Dd^Edp, Wwt, Wwt, Wwt, Wwt, Gs, Gs^Ftd, Dd, Hd, Dd, Dd, Dd, Dd, Dd, Dd, Dd^Edp, Dd, Dd, Dd, Dd, Dd, Dd, Dd, Dd, Hd, Hd, Hd, Hd, Hd, Dd, Dd, Dd^Edp, Dd, Dd, Dd, Dd, Dd
Dd, Dd, Hd, Dd, Dd, Wwt, Wwt, Wwt, Wwt, Wwf, Gs^Ftd, Dd, Hd, Dd, Dd, Dd, Dd^Es, Dd, Dd, Dd, Dd, Dd^Es, Dd, Dd, Dd, Dd, Dd, Dd, Hd, Hd, Hd, Hd, Hd, Dd, Dd, Dd, Hd, Hd, Dd, Dd, Dd
Hd, Hd, Hd, Dd, Dd^Edp, Dd, Wwt, Wwt, Gd^Edp, Gs, Rd, Dd, Dd, Dd, Hd, Dd, Dd, Dd, Dd, Dd, Dd, Dd, Dd, Dd, Dd, Dd, Dd, Hd, Hd, Hd, Hd, Hd, Hd, Dd, Dd, Dd, Hd, Dd, Dd, Dd, Dd
Hd, Hd, Dd, Dd, Hd, Dd, Dd, Wwf, Dd, Dd, Dd, Rd, Rd, Dd, Dd, Dd, Dd, Dd, Dd, Dd^Edp, Dd, Dd, Dd, Dd, Dd, Dd, Dd, Hd, Hd, Hd, Hd, Hd, Hd, Dd, Dd, Dd, Dd, Hd, Dd, Dd, Dd
Dd, Dd, Dd^Edp, Dd, Dd, Dd, Dd^Edp, Dd, Hd, Hd, Hd, Dd, Dd, Dd, Dd, Dd, Hd, Dd, Rd, Dd, Dd, Dd, Dd, Dd, Dd, Dd, Dd, Dd, Hd, Hd, Hd, Hd, Hd, Dd, Dd, Dd, Dd, Dd, Dd, Dd, Dd
Dd, Dd, Hd, Dd, Hd, Dd, Dd, Hd, Hd, Hd, Hd, Hd, Dd, Dd^Edp, Dd, Dd, Dd, Dd, Hd, Rd, Dd, Dd, Dd, Dd, Dd, Dd, Dd, Dd, Hd, Hd, Hd, Hd, Hd, Dd, Dd, Hd, Dd, Dd, Dd, Dd, Dd
Dd, Dd, Hd, Hd, Hd, Dd, Dd, Dd, Dd, Dd, Dd, Dd, Hd, Hd, Dd, Dd, Dd, Dd, Dd, Rd, Dd, Dd, Dd, Dd, Dd, Dd, Dd, Dd, Dd, Hd, Hd, Hd, Hd, Dd, Dd, Dd, Dd^Edp, Dd, Hd, Dd, Dd
Dd, Dd, Dd, Hd, Hd, Hd, Hd, Dd, Hd, Dd, Hd, Hd, Hd, Hd, Hd, Dd, Dd, Hd, Dd, Dd, Dd, Dd, Dd, Dd, Dd, Dd, Dd, Dd, Dd, Hd, Hd, Hd, Hd, Hd, Dd, Dd, Dd, Dd, Hd, Dd, Dd
Dd, Dd, Dd, Hd, Hd, Hd, Hd, Hd, Hd, Dd, Hd, Hd, Hd, Hd, Hd, Hd, Dd, Dd, Dd, Dd, Hd, Dd, Dd, Dd, Dd, Dd, Dd, Dd, Dd, Hd, Hd, Hd, Hd, Hd, Hd, Dd, Dd, Hd, Dd, Dd, Dd
Dd, Dd, Dd, Hd, Hd, Hd, Hd, Hd, Hd, Hd, Hd, Hd, Hd, Hd, Hd, Hd, Hd, Dd, Dd, Hd, Dd, Dd, Dd, Dd, Dd, Dd, Dd, Dd, Dd^Edp, Dd, Dd, Hd, Hd, Hd, Hd, Dd, Dd, Dd, Dd, Dd, Dd
Hd, Hd, Hd, Hd, Hd, Hd, Hd, Hd, Hd, Hd, Hd, Hd, Hd, Hd, Dd, Hd, Hd, Hd, Dd, Dd, Dd, Dd, Dd, Dd, Dd, Dd, Dd, Dd, Dd, Dd, Dd, Dd, Dd, Hd, Hd, Hd, Dd, Dd, Dd, Dd, Dd
Hd, Hd, Hd, Hd, Hd, Hd, Hd, Hd, Hd, Hd, Dd, Hd, Dd, Dd, Dd, Hd, Hd, Dd, Dd, Hd, Dd, Dd, Dd, Dd, Dd, Dd, Rd, Dd, Dd, Dd, Dd, Dd, Dd, Dd, Dd, Hd, Hd, Dd, Hd, Hd, Hd
Hd, Hd, Dd, Hd, Dd, Hd, Dd, Dd, Dd, Hd, Dd, Dd, Dd, Hd, Dd, Hd, Dd, Dd, Hd, Dd, Dd, Dd, Dd, Dd, Dd, Dd, Dd, Rd, Dd, Dd, Dd, Dd, Dd, Dd, Dd, Dd, Dd, Dd, Dd, Dd, Dd
Dd, Dd, Dd, Dd, Hd, Dd, Hd, Hd, Dd, Dd, Hd, Hd, Dd, Dd, Dd, Dd, Hd, Dd, Hd, Hd, Dd, Dd, Dd, Dd^Edp, Dd, Dd, Dd, Dd, Dd, Dd, Rd, Dd, Dd, Dd, Dd, Dd, Dd, Dd, Dd, Dd, Dd
Hd, Hd, Hd, Dd, Dd, Dd, Dd, Dd, Hd, Dd, Dd, Dd, Hd, Dd, Dd, Dd, Dd, Dd, Dd, Dd, Dd, Dd, Dd, Dd, Dd, Dd, Dd, Dd, Dd, Dd, Dd, Rd, Dd, Dd^Edp, Dd, Dd, Dd^Edp, Dd, Dd, Dd, Dd
Hd, Hd, Dd, Dd, Hd, Dd, Dd, Dd, Dd, Dd, Dd, Dd, Dd, Dd, Hd, Dd, Dd, Dd, Hd, Dd, Dd, Dd, Dd, Dd, Dd, Dd, Dd, Dd, Dd, Dd^Edp, Dd, Rd, Gd, Dd, Dd, Dd, Dd, Dd, Dd, Dd, Dd
Dd, Dd, Dd, Hd, Dd, Dd, Hd, Dd, Dd, Hd, Dd, Hd, Dd, Dd, Dd, Dd, Dd, Hd, Dd, Dd, Dd, Dd, Dd, Dd, Dd, Dd, Dd, Dd, Dd, Dd^Edp, Dd, Gd^Edp, Wwf, Gs, Gd^Ftd, Dd, Dd, Dd, Dd, Dd, Dd
Dd, Dd, Dd, Dd, Hd, Dd, Dd, Hd, Dd, Dd, Hd, Dd, Dd, Dd, Dd, Dd, Dd, Dd, Dd, Dd, Dd^Edp, Dd, Dd, Dd, Dd, Dd, Dd, Dd, Dd^Edp, Dd, Dd, Gs, Wwt, Wwt, Gs, Dd, Dd, Dd^Edp, Dd, Dd, Dd
Dd, Dd, Dd, Dd, Dd, Dd, Dd, Dd, Dd, Dd, Dd, Dd, Dd, Dd, Dd, Dd, Dd, Dd, Dd, Dd, Dd, Dd, Dd, Dd, Dd, Dd, Dd, Dd, Dd, Dd, Rd, Gs^Edp, Wwt, Wwt, Wwt, Dd^Edp, Dd, Dd, Dd, Dd, Dd
Dd, Dd, Dd, Dd, Dd, Dd, Dd, Dd, Dd, Dd, Dd, Dd, Dd, Dd, Dd, Dd, Dd, Dd, Dd, Dd, Dd, Dd, Dd, Dd, Dd, Dd, Dd, Dd, Rd, Dd, Dd, Wwt, Wwt, Wwt, Dd^Edp, Dd, Dd, Dd^Edp, Dd, Dd, Dd
Dd, Dd, Dd, Dd, Dd, Dd, Dd, Dd, Dd, Dd, Dd, Dd, Dd, Dd, Dd, Dd, Dd, Dd, Dd, Dd, Dd, Dd, Dd, Dd, Dd, Dd, Dd, Rd, Dd, Dd, Dd, Dd, Dd, Dd, Dd, Dd, Dd^Edp, Dd, Dd, Dd, Dd
Dd, Dd, Dd, Dd, Dd, Dd, Dd, Dd, Dd, Dd, Dd, Dd, Dd, Dd, Dd, Dd, Dd, Dd, Dd, Dd, Dd, Dd, Dd, Dd, Dd, Dd, Dd, Dd, Dd, Dd, Dd, Dd^Edp, Dd, Dd, Dd, Dd, Dd, Dd, Dd, Dd, Dd
Dd, Dd, Dd, Dd, Dd, Dd, Dd, Dd, Dd, Dd, Dd, Dd, Dd, Dd, Dd, Dd, Dd, Dd, Dd, Dd, Dd, Dd, Dd, Dd, Dd, Dd, Dd, Dd, Dd, Dd, Dd, Dd, Dd, Dd, Dd, Dd, Dd, Dd, Dd, Dd, Dd
Dd, Dd, Dd, Dd, Dd, Dd, Dd, Dd, Dd, Dd, Dd, Dd, Dd, Dd, Dd, Dd, Dd, Dd, Dd, Dd, Dd, Dd, Dd, Dd, Dd, Dd, Dd, Dd, Dd, Dd, Dd, Dd, Dd, Dd, Dd, Dd, Dd, Dd, Dd, Dd, Dd
Dd, Dd, Hd, Dd, Dd, Dd, Dd, Dd, Dd, Dd, Dd, Dd, Dd, Dd, Dd, Dd, Dd, Dd, Dd, Dd, Dd, Dd, Dd, Dd, Dd, Dd, Dd, Dd, Dd, Dd, Dd, Dd, Dd, Dd, Dd, Dd, Dd, Dd, Dd, Dd, Dd
Dd, Dd, Dd, Dd, Hd, Dd, Dd, Hd, Dd, Dd, Dd, Dd, Dd, Dd, Rd, Rd, Dd, Dd, Dd, Dd, Dd, Dd, Dd, Dd, Dd, Dd, Dd, Dd, Dd, Dd, Dd, Dd, Dd, Dd, Dd, Dd, Dd, Dd, Dd, Hd, Hd
Dd, Dd, Hd, Dd, Dd, Dd, Dd, Dd, Rd, Rd, Dd, Rd, Dd, Rd, Dd, Dd, Dd, Dd, Dd, Dd, Dd, Dd, Dd, Dd, Dd, Dd, Dd, Dd, Dd, Dd, Dd, Dd, Dd, Dd, Dd, Dd, Dd, Hd, Dd, Hd, Hd
Dd, Dd, Dd, Dd, Gd, Dd, Dd, Dd, Dd, Dd, Ce, Dd, Dd, Dd, Hd, Dd, Dd, Dd, Dd, Dd, Dd, Dd, Dd, Dd, Dd, Dd, Dd, Dd, Dd, Dd, Dd, Dd, Dd, Dd, Dd, Hd, Hd, Dd, Hd, Dd, Dd
Dd, Dd, Gs^Ftd, Wwt, Wwt, Gs, Dd, Dd, Dd, Ce, 1 Ke, Ce, Dd, Dd, Dd, Dd, Dd, Dd, Dd, Dd, Dd, Dd, Dd, Dd, Dd, Dd, Dd, Dd, Dd, Dd, Dd, Dd, Dd, Dd, Dd, Dd, Dd, Dd, Hd, Hd, Hd
Dd, Dd, Wwt, Wwt, Wwt, Gs, Dd, Dd, Dd, Ce, Ce, Ce, Dd, Dd, Dd, Dd, Dd, Dd, Dd, Dd, Dd, Dd, Dd, Dd, Dd, Dd, Dd, Dd, Dd, Dd, Dd, Dd, Hd, Hd, Dd, Hd, Dd, Hd, Hd, Hd, Hd
Dd, Dd, Dd, Wwt, Dd, Dd, Dd, Dd, Dd, Dd, Dd, Dd, Dd, Dd, Dd, Hd, Dd, Dd, Dd, Dd, Dd, Dd, Dd, Dd, Dd, Dd, Dd, Dd, Dd, Dd, Dd, Dd, Dd, Dd, Dd, Dd, Hd, Hd, Hd, Hd, Hd
Dd, Dd, Dd, Dd, Dd, Dd, Dd, Dd, Dd, Dd, Dd, Dd, Dd, Dd, Dd, Dd, Dd, Dd, Dd, Dd, Dd, Dd, Dd, Dd, Dd, Dd, Dd, Dd, Dd, Dd, Dd, Hd, Hd, Dd, Hd, Hd, Hd, Hd, Hd, Hd, Hd
Dd, Dd, Dd, Dd, Dd, Dd, Dd, Dd, Dd, Dd, Dd, Dd, Dd, Dd, Dd, Dd, Dd, Dd, Dd, Dd, Dd, Dd, Dd, Dd, Dd, Dd, Dd, Dd, Dd, Dd, Dd, Hd, Hd, Dd, Hd, Hd, Hd, Hd, Hd, Hd, Hd
