Dd, Dd, Dd, Dd, Dd, Dd, Dd, Dd, Dd, Dd, Dd, Dd, Dd, Dd, Dd, Dd, Dd, Dd, Dd, Dd, Ds, Dd, Dd, Dd, Dd, Dd, Dd, Dd, Hd, Hd, Hhd, Mdd, Mdd, Mdd, Mdd, Mdd, Mdd, Mdd, Mdd, Mdd, Mdd
Dd, Dd, Dd, Dd, Dd, Dd, Dd, Dd, Hd, Dd, Dd, Dd, Dd, Dd, Dd, Hd, Dd, Dd, Dd, Dd, Ds, Dd, Ds, Dd, Dd, Ds, Ds, Dd, Dd, Hd, Dd, Mdd, Hhd, Hhd, Mdd, Mdd, Mdd, Mdd, Mdd, Mdd, Mdd
Dd, Dd, Dd, Dd, Hd, Dd, Dd, Hd, Dd, Hd, Dd, Dd, Hd, Dd, Dd, Dd, Dd, Hd, Hd, Hd, Rd, Ds, Hhd, Hhd, Ds, Ds, Ds, Dd, Hd, Dd, Dd, Hd, Dd, Dd, Dd, Hd, Hd, Hhd, Hhd, Mdd, Mdd
Dd, Dd, Dd, Dd, Dd^Edp, Hd, Hd, Dd, Dd, Dd, Dd, Dd, Dd, Dd, Dd, Hd, Hd, Hd, Hhd, Ds, Rd, Rd, Rd, Gd, Gd, Gd, Dd, Ds, Hd, Hd, Dd, Hd, Hd, Hd, Dd, Hd, Mdd, Mdd, Mdd, Mdd, Hhd
Dd, Dd, Dd, Dd, Dd, Hd, Hd, Dd, Dd, Hd, Hd, Dd, Dd, Dd, Dd, Ds, Ds, Ds, Hhd, Gd, Ce, Ce, Ce, Gs, Gs, Rd, Hd, Dd, Mdd, Hd, Dd, Dd, Dd, Mdd, Mdd, Hhd, Hhd, Mdd, Mdd, Mdd, Mdd
Dd, Dd, Hd, Hd, Dd, Dd, Dd, Dd, Dd, Hd, Dd, Dd, Dd, Hd, Dd, Dd, Hd, Gd, Gd, Gs, Ce, Wwg, Wwg, Gs, Gd, Gd, Gd, Hd, Mdd, Mdd, Dd, Hd, Hd, Hd, Hhd, Hhd, Hhd, Mdd, Mdd, Mdd, Mdd
Dd, Dd, Dd, Hd, Dd, Dd, Dd, Dd, Dd, Dd, Dd, Dd, Dd, Dd, Dd, Dd, Hd, Ds, Gd, Rd, Ce, Ce, 2 Ke, Ce, Gs, Gd, Rd, Hd, Hd, Dd, Dd, Dd^Edp, Hd, Mdd, Mdd, Mdd, Hhd, Hhd, Hhd, Mdd, Mdd
Dd, Dd, Dd, Hd, Dd, Dd, Hd, Dd, Dd, Dd^Edp, Dd, Dd, Dd, Dd, Dd, Hd, Hd, Ds^Vdt, Hhd, Rd, Gd, Ce, Ce, Ce, Hhd, Gd, Hd, Ds^Vdt, Hd, Dd, Hd, Hd, Hd, Hhd, Mdd, Mdd, Mdd, Mdd, Mdd, Hhd, Hhd
Dd, Dd, Dd, Dd, Dd, Hd, Hd, Dd, Dd, Dd, Dd, Hd, Hd, Dd, Dd, Hd, Dd, Hd, Hhd, Gd, Hhd, Hhd, Hhd, Hhd, Hhd, Hd, Ds, Ds, Ds, Hd, Mdd, Mdd, Dd, Dd, Mdd, Mdd, Mdd, Mdd, Mdd, Hhd, Hhd
Dd, Dd, Dd, Dd, Dd, Hd, Dd, Hd, Dd, Dd, Dd, Dd, Dd, Dd, Hd, Dd, Dd, Hd, Dd, Hd, Hd, Mdd, Mdd^Xm, Mdd, Mdd, Hd, Hd, Ds, Hd, Hd, Mdd, Mdd, Dd, Hd, Hd, Hhd, Hhd, Mdd, Mdd, Mdd, Mdd
Dd, Dd, Dd, Dd, Dd, Dd, Dd, Dd, Dd, Dd, Dd^Edp, Dd, Dd, Dd, Dd, Dd, Dd, Hd, Dd, Dd^Vdt, Hd, Mdd, Mdd, Mdd, Dd^Vdt, Hd, Hd, Dd, Dd, Mdd, Hd, Hd, Dd, Dd, Dd, Hd, Hhd, Mdd, Hhd, Mdd, Dd
Dd, Dd, Hd, Dd, Dd, Dd, Dd, Dd, Hd, Dd, Dd, Dd, Hd, Dd, Dd, Dd, Dd, Dd, Hd, Hd, Mdd, Mdd, Dd, Mdd, Hd, Hd, Hd, Hd, Dd, Dd, Dd, Dd, Dd, Dd, Hd, Hd, Dd, Hd, Dd, Dd, Mdd
Dd, Hd, Hd, Hd, Dd, Dd, Ds, Hd, Ds, Dd, Rd, Dd, Hd, Dd, Dd, Dd, Dd, Dd, Dd, Dd, Hd, Hd, Dd, Dd, Hd, Dd, Dd, Dd, Dd, Dd, Dd, Dd, Dd, Dd, Dd, Hd, Dd, Dd, Dd, Dd, Mdd
Hd, Hd, Dd, Dd, Hd, Dd, Hd, Ds, Ds, Ds, Rd, Rd, Gd^Edp, Gd, Dd, Hd, Hd, Dd, Dd, Dd, Dd, Dd, Dd, Dd, Hd, Hd, Dd, Dd, Dd, Hd, Dd, Dd, Dd, Dd, Dd, Dd, Dd, Hd, Hd, Dd, Dd
Dd, Hd, Dd, Dd, Hd, Hd, Hd, Dd, Ds^Edp, Rd, Wwt, Gs, Gs, Gd, Dd, Dd, Dd, Dd, Dd, Dd, Dd, Dd, Dd, Dd, Dd, Hd, Dd, Dd, Dd, Dd, Dd, Dd, Hd, Hd, Dd, Dd, Dd, Dd, Dd, Dd, Dd
Dd, Dd, Hd, Dd, Hd, Hd, Dd, Ds, Ds, Ds, Wwt, Wwt, Wwt, Rd, Ds, Dd, Dd^Edp, Dd, Hd, Hd, Dd, Dd, Hd, Dd, Dd, Dd, Dd, Dd, Hd, Dd, Dd, Dd, Dd, Hd, Dd, Dd, Dd, Dd, Dd, Dd, Dd
Dd, Dd, Hd, Hd, Dd, Hd, Dd, Rd, Rd, Gd^Edp, Gs^Ftd, Wwt, Wwt, Ds^Es, Ds, Dd, Dd, Dd, Dd, Dd, Dd, Dd, Hd, Hd, Dd, Dd, Dd, Dd, Hd, Dd, Dd, Dd, Dd, Dd, Dd, Dd, Hd, Dd, Dd, Dd, Dd
Dd, Dd, Dd, Dd, Dd, Dd, Hd, Rd, Hd, Gd, Gd, Wwt, Gd, Gd^Edp, Ds, Ds, Dd, Dd, Rd, Dd, Dd, Dd, Dd, Hd, Dd, Dd, Dd, Dd, Dd, Dd, Dd, Dd, Dd, Dd, Dd, Hd, Hd, Hd, Dd, Dd, Dd
Dd, Hd, Hd, Dd, Hd, Hd, Ds, Ds, Hd, Rd, Rd, Rd, Hd, Ds, Ds, Hd, Dd, Dd, Rd, Dd, Dd, Dd, Dd, Dd, Dd, Dd, Dd, Dd, Dd, Dd, Dd, Dd, Dd, Dd, Dd, Dd, Dd, Dd, Dd, Dd, Dd
Hd, Hd, Hd, Dd, Dd, Hd, Hd, Hd, Hd, Rd, Hd, Rd, Mdd, Mdd, Dd, Dd, Dd, Dd, Dd, Rd, Dd, Dd, Dd, Dd, Dd, Dd^Es, Dd, Dd, Dd, Dd, Dd, Dd, Dd, Dd, Dd, Dd, Dd, Dd, Dd, Dd, Dd
Dd, Hd, Hd, Hd, Hhd, Hd, Hd, Rd, Dd, Dd, Mdd, Hhd, Hhd, Hd, Dd, Dd, Dd, Dd, Dd, Dd, Dd, Dd, Rd, Dd, Dd, Dd, Dd, Dd, Dd, Dd, Dd, Dd, Dd, Dd, Dd, Dd, Dd, Dd, Dd, Dd, Dd
Dd, Mdd, Mdd, Mdd, Mdd, Mdd, Hhd, Rd, Mdd, Hd, Mdd, Mdd, Mdd, Hd, Hd, Dd, Dd, Dd, Dd, Dd, Dd, Dd, Dd, Rd, Rd, Dd, Dd, Dd, Dd, Dd, Dd^Edp, Dd, Dd, Dd, Dd, Dd, Dd, Dd, Dd, Dd, Dd
Mdd, Hhd, Mdd, Mdd, Mdd, Mdd, Mdd, Hhd, Hhd, Mdd, Hhd, Mdd, Hd, Hd, Dd, Dd, Dd, Dd, Dd, Dd^Es, Dd, Dd, Dd, Dd, Dd, Dd, Dd, Dd, Dd, Dd, Dd, Dd, Dd, Dd, Dd, Dd, Dd, Dd, Dd, Dd, Dd
Mdd, Mdd, Mdd, Mdd, Hhd, Hhd, Rd, Hhd, Rb, Re, Hd, Mdd, Dd, Hd, Dd, Dd, Dd, Dd, Dd, Dd, Dd, Dd, Dd, Dd, Dd, Dd, Dd, Dd, Dd, Dd, Dd, Dd, Dd, Dd^Es, Dd, Dd, Rd, Dd, Rd, Dd, Dd
Hhd, Mdd, Mdd, Mdd, Mdd, Hhd, Rb, Rd, Rd, Re, Rd, Rd, Hd, Hd, Dd, Dd, Dd, Dd, Dd, Dd, Dd, Dd, Dd, Dd, Dd, Dd, Dd, Dd, Dd, Rd, Rd, Dd, Dd^Es, Dd, Chr, Rd, Rb, Rd, Rd, Rd, Dd
Mdd, Hhd, Mdd, Hhd, Mdd, Rb, Rb, Rd, Hhd, Re, Dd, Rd, Dd, Dd, Dd, Dd, Dd, Dd, Hd, Dd, Hd, Dd, Hd, Dd, Hd, Dd, Dd, Dd, Dd, Dd, Dd^Es, Rd, Dd^Dr, Chr, 3 Khr, Chr^Es, Chr^Es, Rb, Rd, Dd, Dd
Hhd, Mdd, Mdd, Mdd, Mdd, Mdd, Rd, Hhd, Hd, Dd, Hd, Dd, Hd, Dd, Dd, Dd, Dd, Rd, Hd, Hd, Hd, Hd, Hd, Hd, Dd, Dd, Dd, Dd, Dd^Edp, Dd, Dd^Es, Dd^Dr, Chr, Dd^Dr, Chr^Es, Chr, Wwg, Chr, Dd, Dd, Dd
Hhd, Mdd, Mdd, Mdd, Mdd, Mdd, Mdd, Mdd, Dd, Dd, Dd, Rd, Mdd, Hd, Dd, Dd, Rd, Hd, Mdd, Hd, Hhd, Hd, Dd, Dd, Hd, Dd, Dd^Es, Dd, Dd, Dd, Dd^Es, Chr^Es, Rd^Es, Rd, Rb, Wwg, Wwg, Chr^Es, Rd, Dd^Es, Dd
Hhd, Hhd, Hhd, Mdd, Hd, Mdd, Re, Mdd, Hd, Hd, Dd, Rd, Dd, Dd, Dd, Rd, Hd, Hhd, Mdd, Mdd, Hhd, Dd, Dd, Hd, Hd, Dd, Dd, Dd, Dd, Dd, Rd, Chr, Re, Rd^Es, Rd^Es, Rb^Es, Rb^Dr, Chr, Rd, Dd^Es, Dd
Mdd, Mdd, Hhd, Hhd, Hhd, Rb, Hhd, Re, Mdd, Hhd, Dd, Hhd, Dd, Dd, Dd, Dd, Hd, Mdd, Hhd, Mdd, Mdd, Dd, Dd, Dd, Dd, Dd, Dd, Dd, Rd, Dd^Es, Rd, Rd, Re, Chr^Es, Chr, Dd^Dr, Rb, Rb^Es, Dd, Dd, Dd
Mdd, Mdd, Mdd, Hhd, Mdd, Hd, Rd, Hhd, Mdd, Mdd, Hhd, Dd, Dd, Dd, Dd, Hd, Dd, Hhd, Hhd, Mdd, Mdd, Mdd, Hd, Dd, Dd, Dd, Hd, Hd, Dd, Dd, Dd, Dd, Dd^Es, Dd, Dd, Dd^Es, Rd, Rd, Dd, Dd, Dd
Mdd, Mdd, Mdd, Hd, Hd, Mdd, Hd, Rd, Hd, Hhd, Rd, Dd, Dd, Dd, Rd, Mdd, Hd, Mdd, Dd, Hd, Mdd, Hd, Mdd, Hd, Hd, Dd, Dd, Dd, Dd, Dd, Dd, Dd, Dd, Dd, Dd, Dd, Dd, Dd, Dd, Dd, Dd
Mdd, Mdd, Mdd, Hd, Hd, Dd, Hd, Dd, Dd, Dd, Dd, Dd, Dd, Dd^Es, Dd, Rd, Dd, Hd, Dd, Dd, Dd, Hd, Hd, Hd, Dd, Dd, Dd, Dd, Dd, Dd, Dd, Dd, Dd, Dd, Dd, Dd, Dd, Dd, Dd, Dd, Dd
Mdd, Mdd, Hhd, Hhd, Mdd, Dd, Dd, Dd, Dd, Hd, Dd^Es, Dd, Hd, Dd, Dd, Dd, Dd, Dd, Dd, Dd, Rd, Rd, Rd, Dd, Hd, Hd, Dd, Dd, Ds, Dd, Dd, Dd, Dd, Dd, Dd, Dd, Hd, Dd, Dd, Dd, Dd
Hd, Hd, Mdd, Hhd, Hhd, Dd, Hd, Dd, Dd, Dd, Dd, Dd, Dd, Dd, Dd, Dd, Dd, Dd, Dd, Dd, Dd, Dd, Dd, Dd, Hd, Mdd, Hd, Ds, Ds, Dd^Edp, Dd, Dd, Dd, Dd, Dd, Hd, Hd, Mdd, Hd, Hd, Hd
Hd, Mdd, Mdd, Dd, Mdd, Hd, Hd, Dd, Dd, Hd, Hd, Dd, Dd, Dd, Hd, Dd, Dd, Dd, Dd, Dd, Dd, Dd, Dd, Hd, Mdd, Mdd, Hd, Hd, Ds, Ds, Hd, Dd, Dd, Dd, Hd, Hd, Mdd, Hhd, Mdd, Hhd, Hhd
Hhd, Hhd, Hhd, Hhd, Mdd, Mdd, Dd, Dd, Dd, Hd, Dd, Dd, Dd, Dd, Dd, Dd, Dd, Dd, Dd, Dd, Dd^Edp, Dd, Hd, Hd, Hd, Hhd, Mdd, Ds, Rd, Hd, Mdd, Hd, Hd, Dd, Mdd, Mdd, Mdd, Mdd, Mdd, Mdd, Mdd
Mdd, Hhd, Dd, Mdd, Mdd, Mdd, Dd, Hhd, Hhd, Dd, Dd, Hd, Dd, Dd, Dd, Dd, Dd, Dd, Dd, Dd, Dd, Dd, Hd, Hd, Hd, Hhd, Rb, Mdd, Rd, Mdd, Mdd, Hhd, Hd, Dd, Dd, Hd, Hhd, Hhd, Mdd, Mdd, Hhd
Mdd, Mdd, Mdd, Dd, Hhd, Hhd, Mdd, Mdd, Hd, Dd, Dd^Edp, Dd, Dd, Dd, Dd, Dd, Dd, Dd, Dd, Dd, Dd, Hd, Hd, Mdd, Mdd, Mdd, Mdd, Rd, Mdd, Mdd, Mdd, Mdd, Hhd, Hd, Hd, Hd, Hd, Mdd, Hd, Hhd, Mdd
Mdd, Mdd, Mdd, Hd, Dd^Edp, Hhd, Mdd, Mdd, Mdd, Dd, Dd, Dd, Dd, Dd, Dd, Dd, Dd, Dd, Dd, Dd, Dd, Dd, Hd, Mdd, Mdd, Mdd, Rd, Rb, Rb, Mdd, Mdd, Mdd, Mdd, Hd, Mdd, Hd, Dd, Dd, Dd, Hd, Hd
Hhd, Hhd, Ds^Edp, Ds, Dd, Mdd, Hd, Hd, Ds, Ds, Hd, Dd, Rd, Rd, Dd, Dd, Dd^Edp, Dd, Dd, Dd, Dd, Dd, Dd, Hd, Dd, Ds, Hd, Mdd, Mdd, Mdd, Mdd, Hhd, Mdd, Hd, Dd, Dd, Mdd, Dd, Hd, Dd, Hd
Hd, Hhd, Dd, Hd, Hd, Gd, Gd, Hd, Ds, Ds, Ds^Edp, Dd, Dd, Dd, Dd, Dd, Dd, Dd, Dd, Dd, Ds, Ds, Hd, Ds, Dd, Hd, Mdd, Mdd, Mdd, Mdd, Hhd, Hhd, Hhd, Hhd, Mdd, Hd, Mdd, Hd, Mdd, Hd, Dd
Dd, Hd, Dd, Hd, Gs, Gd, Gd^Edp, Ds, Gd^Edp, Gd, Rd, Rd, Dd, Dd, Dd^Edp, Dd, Dd, Dd, Dd, Dd, Dd, Hd, Hd, Ds, Hd, Hd, Hd, Hd, Hhd, Mdd, Mdd, Mdd, Mdd, Hhd, Mdd, Mdd, Mdd, Mdd, Mdd, Hhd, Hd
Dd, Hd, Gd, Gd, Gs^Edp, Wwt, Wwt, Wwt, Wwt, Gs, Gs^Ftd, Dd, Hd, Dd, Dd, Dd, Dd, Dd, Dd, Dd^Edp, Dd, Ds, Dd, Dd, Hd, Hd, Hd, Hd, Mdd, Mdd, Mdd, Mdd, Mdd, Mdd, Mdd, Mdd, Mdd, Hhd, Hd, Hhd, Hd
Ds, Dd, Hd, Gd, Gd, Wwt, Wwt, Wwt, Wwt, Wwf, Gs^Ftd, Gd, Hd, Dd, Dd, Dd, Dd^Es, Dd, Dd, Dd, Dd, Ds, Dd, Hd, Hd, Dd, Dd, Dd, Hd, Mdd, Mdd, Mdd, Hhd, Mdd, Hhd, Mdd, Hhd, Hd, Dd, Hd, Dd
Ds, Hd, Hd, Ds, Ds^Edp, Ds, Wwt, Wwt, Gd^Edp, Gs, Rd, Gd, Dd, Dd, Hd, Dd, Dd, Dd, Dd, Dd, Dd, Dd, Dd, Dd, Dd, Dd, Dd, Hd, Hd, Mdd, Mdd, Mdd, Mdd, Hhd, Mdd, Dd, Mdd, Hd, Dd, Dd, Dd
Hd, Hd, Dd, Ds, Hd, Ds, Gs, Wwf, Gd, Ds, Ds, Rd, Rd, Dd, Dd, Dd, Dd, Dd, Dd, Dd^Edp, Dd, Dd, Dd, Dd, Dd, Hd, Dd, Hd, Hd, Hd, Hd, Hhd, Hhd, Mdd, Mdd, Mdd, Hd, Hd, Hd, Hd, Dd
Dd, Dd, Dd^Edp, Dd, Dd, Ds, Gd^Edp, Gs, Ds, Hd, Hd, Ds, Dd, Dd, Dd, Dd, Hd, Dd, Rd, Dd, Dd, Dd, Dd, Dd, Dd, Hd, Dd, Dd, Hd, Hd, Mdd, Hd, Hhd, Hhd, Hhd, Hhd, Hhd, Mdd, Mdd, Dd, Dd
Dd, Dd, Hd, Dd, Hd, Gd, Gd, Hd, Hd, Hd, Hd, Hd, Dd, Dd^Edp, Dd, Dd, Dd, Dd, Hd, Rd, Dd, Dd, Dd, Dd, Dd, Dd, Hd, Dd, Hd, Hd, Hd, Hhd, Mdd, Hhd, Hhd, Mdd, Mdd, Hd, Dd, Dd, Hd
Ds, Dd, Hd, Hd, Hd, Ds, Ds, Ds, Ds, Ds, Dd, Dd, Hd, Hd, Dd, Dd, Dd, Dd, Dd, Rd, Dd, Dd, Dd, Dd, Dd, Hd, Hd, Dd, Dd, Hd, Mdd, Hd, Hhd, Mdd, Mdd, Mdd, Mdd, Mdd, Hd, Dd, Dd
Ds, Ds, Dd, Hd, Hd, Hd, Hd, Hd, Rd, Ds, Hd, Dd, Dd, Hd, Hd, Dd, Dd, Hd, Dd, Dd, Dd, Dd, Dd, Hd, Hd, Hd, Dd, Dd, Dd, Hd, Hd, Mdd, Hhd, Hhd, Mdd, Mdd, Mdd, Mdd, Hhd, Dd, Hd
Dd, Ds, Dd, Dd, Rd, Hd, Hd, Hd, Hd, Rd, Hd, Hd, Hd, Hd, Hd, Hd, Dd, Dd, Dd, Dd, Hd, Dd, Dd, Dd, Dd, Dd, Dd, Dd, Dd, Hd, Hd, Mdd, Hhd, Mdd, Mdd, Mdd, Mdd, Hhd, Mdd, Hd, Hd
Dd, Dd, Dd, Hd, Rd, Hd, Hd, Hd, Hd, Rd, Hd, Hd, Hd, Hd, Hd, Hd, Hd, Dd, Dd, Hd, Dd, Dd, Dd, Dd, Dd, Dd, Dd, Dd, Dd^Edp, Dd, Dd, Hd, Hd, Hhd, Mdd, Mdd, Mdd, Mdd, Mdd, Hhd, Hhd
Hd, Hd, Hd, Hd, Hd, Hd, Hd, Hd, Hd, Hd, Hd, Hd, Hd, Dd, Dd, Hd, Hd, Hd, Dd, Dd, Dd, Dd, Dd, Dd, Dd, Dd, Dd, Dd, Dd, Dd, Dd, Dd, Hd, Hhd, Mdd, Hhd, Mdd, Mdd, Mdd, Mdd, Hhd
Hd, Hd, Hd, Hd, Hd, Hd, Hd, Hd, Hd, Hd, Rd, Hd, Ds, Ds, Dd, Hd, Hd, Dd, Dd, Hd, Dd, Dd, Dd, Dd, Dd, Dd, Rd, Dd, Dd, Dd, Dd, Dd, Hd, Hd, Hd, Mdd, Hhd, Mdd, Mdd, Mdd, Mdd
Hd, Hd, Rd, Hd, Dd, Hd, Rd, Rd, Ds, Hd, Dd, Dd, Ds, Hd, Dd, Hd, Dd, Dd, Hd, Dd, Dd, Dd, Dd, Dd, Dd, Dd, Dd, Rd, Dd, Dd, Dd, Dd, Dd, Hd, Mdd, Dd, Mdd, Mdd, Mdd, Mdd, Hhd
Dd, Rd, Dd, Dd, Hd, Ds, Hd, Rd, Ds, Dd, Hd, Hd, Dd, Dd, Dd, Dd, Hd, Dd, Hd, Hd, Dd, Dd, Dd, Dd^Edp, Dd, Dd, Dd, Dd, Dd, Dd, Rd, Dd, Ds, Hd, Rd, Dd, Hd, Mdd, Hd, Mdd, Mdd
Hd, Hd, Hd, Dd, Dd, Dd, Ds, Ds, Hd, Dd, Dd, Dd, Hd, Dd, Dd, Dd, Dd, Dd, Dd, Dd, Dd, Dd, Dd, Dd, Dd, Dd, Dd, Ds, Dd, Dd, Ds, Rd, Rd, Ds^Edp, Rd, Hd, Hd, Dd, Dd, Mdd, Mdd
Hd, Hd, Ds, Dd, Hd, Dd, Dd, Ds, Dd, Dd, Dd, Dd, Dd, Dd, Hd, Dd, Dd, Dd, Hd, Dd, Dd, Dd, Dd, Dd, Dd, Ds, Ds, Dd, Dd, Ds^Edp, Ds, Rd, Gd, Rd, Gd, Rd, Hd, Dd, Hd, Hd, Hd
Dd, Ds, Dd, Hd, Dd, Dd, Hd, Dd, Dd, Hd, Dd, Hd, Dd, Dd, Dd, Dd, Dd, Hd, Dd, Dd, Dd^Dr, Dd, Dd, Dd, Dd, Ds, Dd, Dd, Ds, Ds^Edp, Rd, Gd^Edp, Wwf, Gs, Gd^Ftd, Gd, Rd, Ds, Dd, Hd, Dd
Dd, Dd, Dd, Dd, Hd, Ds, Dd^Dc, Hd, Dd, Dd, Hd, Dd, Dd, Dd, Dd, Dd, Dd, Dd, Dd, Dd, Dd^Edp, Dd, Dd, Dd, Dd, Dd, Dd, Dd, Ds^Edp, Rd, Rd, Gs, Wwt, Wwt, Gs, Gd, Rd, Dd^Edp, Dd, Dd, Dd
Dd, Dd, Dd, Dd, Dd, Dd^Dr, Ds, Ds, Dd, Dd, Dd, Dd, Ds, Dd, Ds, Dd, Dd, Dd, Dd, Dd, Dd, Dd, Dd, Dd, Dd, Dd, Dd, Dd, Rd, Gd, Gd, Gs^Edp, Wwt, Wwt, Wwt, Ds^Edp, Dd, Dd, Dd, Dd, Dd
Dd, Dd, Dd, Dd, Dd, Dd, Ds, Ds, Dd, Dd, Dd, Dd, Ds^Dr, Ds, Ds, Dd, Dd, Dd, Dd, Dd, Dd, Dd, Dd, Dd, Dd, Dd, Dd, Rd, Rd, Gd, Gs, Wwt, Wwt, Wwt, Ds^Edp, Ds, Ds, Dd^Edp, Dd, Ds, Ds
Dd, Dd, Hd, Dd, Hd, Dd, Dd, Dd, Dd, Dd, Dd, Ds, Ds, Dd^Dc, Ds, Ds, Dd, Dd, Dd, Dd, Dd, Dd, Dd, Dd, Dd, Dd, Dd, Rd, Ds, Rd, Gs, Gs, Gd, Gs, Rd, Ds, Dd^Edp, Dd, Ds, Ds, Ds
Dd, Dd, Hd, Hd, Hd, Hd, Dd, Dd, Dd, Dd, Dd, Dd, Ds, Ds, Dd, Dd, Dd, Dd, Dd, Dd, Dd, Dd, Dd, Dd, Rd, Rd, Dd, Dd, Ds, Ds, Ds, Ds^Edp, Gd, Gd, Rd, Ds, Dd, Dd, Dd, Dd, Dd
Dd, Dd, Dd, Hd, Dd, Hd, Dd, Dd, Dd, Dd, Dd, Dd, Dd, Ds, Dd, Dd, Dd, Dd, Dd, Dd, Dd, Dd, Dd, Dd, Dd, Dd, Dd, Dd, Dd, Ds, Dd, Rd, Rd, Rd, Dd, Dd, Dd, Dd, Dd, Hd, Hd
Dd, Dd, Hd, Dd, Dd, Dd, Dd, Hd, Hd, Dd, Dd, Dd, Dd, Dd, Dd, Dd, Dd, Dd, Dd, Dd, Dd, Dd, Dd, Dd, Dd, Dd, Dd, Dd, Dd, Dd, Dd, Dd, Rd, Rd, Dd, Dd, Dd, Dd, Hd, Hd, Hd
Dd, Dd, Hd, Hd, Hd, Hd, Dd, Dd, Hd, Dd, Dd, Dd, Dd, Dd, Dd, Dd, Dd, Dd, Dd, Dd, Dd, Dd, Dd, Dd, Dd, Dd, Dd, Dd, Dd, Dd, Dd, Dd, Dd, Dd, Dd, Dd, Hd, Dd, Dd, Hd, Hd
Dd, Hd, Ds, Hd, Hd, Dd, Dd, Hd, Dd, Dd, Dd, Dd, Dd, Dd, Rd, Rd, Dd, Dd, Dd, Dd, Dd, Dd, Ds, Hd, Hd, Dd, Dd, Dd, Dd, Dd, Dd, Dd, Dd, Dd, Dd^Dr, Hd, Hd, Dd, Hd, Mdd, Hd
Dd, Dd, Hd, Ds, Ds, Ds, Dd, Dd, Rd, Rd, Ds, Rd, Dd, Rd, Dd, Dd, Dd, Dd, Dd, Dd, Hd, Ds, Hd, Hd, Ds, Ds, Hd, Hd, Dd, Dd, Dd, Dd, Hd, Dd, Dd, Dd, Dd, Hd, Dd, Mdd, Hd
Dd, Ds, Gd, Ds, Gd, Rd, Gd, Dd, Ds, Ds, Ce, Dd, Dd, Dd, Hd, Dd, Dd, Dd, Dd, Hd, Hd, Ds, Dd, Dd, Dd, Hd, Dd, Mdd, Dd, Hd, Hd, Dd, Hd, Hd, Dd, Hd, Hd, Dd, Mdd, Hd, Hd
Gd, Gd, Gs^Ftd, Wwt, Wwt, Gs^Fts, Gd, Rd, Rd, Ce, 1 Ke, Ce, Dd, Dd, Hd, Hd, Dd, Dd, Dd, Dd, Dd, Dd, Dd, Dd, Dd, Dd, Dd, Dd, Hd, Hd, Dd, Dd, Hd, Hd, Dd, Hd, Hd, Hd^Fts, Mdd, Mdd, Hd
Rd, Gd, Wwt, Wwt, Wwt, Gs, Rd, Rd, Rd, Ce, Ce, Ce, Dd, Dd, Dd, Dd, Dd, Dd, Dd, Dd, Hd, Dd, Dd, Hd, Hd, Hd, Hd, Dd, Dd, Dd, Dd, Hd, Hd, Hd, Hd, Hd, Mdd, Hhd, Hhd, Hhd, Hhd
Rd, Rd, Wwt, Wwt, Gd, Gd, Ds, Dd, Dd, Ds, Ds, Dd, Dd, Dd, Hd, Hd, Dd, Dd, Hd, Mdd, Hd, Dd, Hd, Hd, Mdd, Mdd, Dd, Hd, Dd, Dd, Dd, Dd, Dd, Hd, Dd, Hd, Hd, Hhd, Hhd, Mdd, Mdd
Ds, Rd, Ds, Ds, Dd, Ds, Ds, Dd, Dd, Ds, Ds, Dd, Dd, Dd, Hd, Hd, Dd, Dd, Dd, Dd, Dd, Dd, Dd, Dd, Hd, Hd, Dd, Dd, Hd, Dd, Mdd, Hd, Hd, Hd, Hd, Hhd, Hhd, Mdd, Mdd, Mdd, Mdd
Dd, Dd, Dd, Dd, Dd, Ds, Dd, Dd, Dd, Hd, Hd, Hd, Dd, Dd, Dd, Dd, Dd, Dd, Dd, Dd, Dd, Dd, Dd, Dd, Dd, Dd, Dd, Hd, Hd, Dd, Dd, Hd, Hd, Dd, Hd, Mdd, Hd, Mdd, Hhd, Mdd, Mdd
