Hd, Hd, Hd, Hd, Hd, Hd, Dd, Dd, Dd, Dd, Dd, Dd, Dd, Dd, Dd, Dd, Dd, Dd, Dd, Dd, Dd, Dd, Dd, Dd, Dd, Dd, Hd, Hd, Hd, Hd, Dd, Dd, Dd, Dd, Dd, Dd, Dd, Dd, Dd, Dd, Dd, Dd, Rd, Dd, Dd, Dd, Dd, Dd, Dd, Dd, Dd, Dd, Dd, Dd, Dd, Dd, Dd, Dd, Dd, Dd, Dd, Dd, Dd, Dd, Dd, Dd, Dd, Dd, Dd, Dd, Dd, Dd, Dd, Hd, Hd, Md, Md, Xu
Hd, Hd, Hd, Hd, Hd, Hd, Dd, Dd, Dd, Dd, Dd, Dd, Dd, Dd, Dd, Dd, Dd, Dd, Dd, Dd^Edp, Dd, Dd, Dd, Dd, Dd, Dd, Hd, Hd, Hd, Hd, Dd, Dd, Dd, Dd, Dd, Dd^Edp, Dd, Dd, Dd, Dd, Dd, Dd, Rd, Dd, Dd, Dd, Dd, Dd, Dd, Dd, Dd, Dd, Dd, Dd, Dd, Dd, Dd, Dd, Dd, Dd, Dd, Dd, Dd, Dd, Dd, Dd, Dd, Dd, Dd, Dd, Dd, Dd, Dd, Hd, Hd, Md, Md, Xu
Hd, Hd, Hd, Hd, Hd, Hd, Hd, Hd, Hd^Edp, Hd, Hd, Hd, Hd, Dd, Hd, Hd, Hd, Hd, Hd, Dd, Hd, Dd, Hd, Hd, Hd, Hd, Hd^Edp, Hd, Hd, Hd, Hd, Hd, Hd, Hd, Hd, Dd, Dd, Dd, Dd, Dd, Dd, Rd, Dd, Dd, Dd, Dd, Dd, Dd, Dd, Dd, Dd, Dd, Hd, Hd, Hd, Dd, Dd, Dd, Dd, Dd, Dd, Dd^Edp, Dd, Dd, Dd, Dd, Dd, Dd, Dd, Dd, Hd, Hd, Hd, Hd, Md, Md, Xu, Xu
Hd, Hd, Md, Hd, Md, Hd, Hd, Hd, Hd, Hd, Hd, Hd, Hd, Hd, Md, Hd, Md, Hd, Hd, Hd, Hd, Hd, Hd, Hd, Hd, Hd, Hd, Hd, Hd, Hd, Md, Md, Md, Hd, Hd, Hd, Dd, Dd, Dd, Dd, Dd, Rd, Dd, Dd, Dd, Dd, Dd^Edp, Dd, Dd, Dd, Dd, Hd, Md, Md, Md, Hd, Hd, Dd, Dd, Dd, Dd, Dd, Dd, Dd, Dd, Dd, Dd, Dd, Dd, Hd, Hd, Hd, Md, Md, Md, Md, Xu, Xu
Md, Md, Md, Md, Md, Md, Md, Md, Md, Md, Md, Md, Md, Md, Md, Md, Md, Md, Md, Hd, Hd, Hd, Hd, Hd, Hd, Hd, Hd, Hd, Hd, Md, Md, Md, Md, Hd, Hd, Hd, Hd, Dd, Dd, Dd, Dd, Rd, Dd, Dd, Dd, Dd, Dd, Dd, Dd, Dd, Hd, Hd, Md, Md, Md, Hd, Hd, Dd, Dd, Dd, Wwt, Wwt, Dd, Dd^Edp, Dd, Dd, Dd, Dd, Hd, Hd, Md, Md, Md, Md, Xu, Xu, Xu, Xu
Md, Md, Md, Md, Md, Md, Md, Md, Md, Md, Md, Md, Xu, Md, Xu, Md, Md, Md, Md, Md, Md, Md, Md, Md, Md, Md, Md, Md, Md, Md, Md, Md, Md, Hd, Hd, Hd, Hd, Dd, Dd, Hd, Hd, Rd, Dd, Dd, Dd, Dd, Hd, Dd, Hd, Hd, Md, Md, Md^Xm, Md, Md, Hd, Dd, Dd, Dd, Dd^Edp, Wwt, Wwt, Wwt, Dd^Edp, Dd, Dd, Hd, Hd, Hd, Hd, Md, Md, Xu, Xu, Xu, Xu, Xu, Xu
Md, Md, Md, Md, Md, Md, Md, Md, Md, Md, Xu, Xu, Xu, Xu, Xu, Xu, Xu, Md, Md, Md, Md, Md, Md, Md, Md, Md, Md, Md, Md, Md, Md, Md, Hd, Hd, Hd, Hd, Hd, Dd, Hd, Hd, Hd, Hd, Hd, Dd, Hd, Dd, Hd, Hd, Hd, Md, Md, Md, Md^Xm, Md^Xm, Md, Hd, Hd, Dd, Dd^Edp, Dd, Dd, Dd^Edp, Dd, Dd, Dd, Dd, Hd, Hd, Md, Md, Xu, Xu, Xu, Xu, Xu, Xu, Xu, Xu
Md, Md, Md, Md, Xu, Xu, Xu, Xu, Xu, Xu, Xu, Xu, Xu, Xu, Xu, Xu, Xu, Xu, Xu, Xu, Xu, Xu, Xu, Xu, Xu, Md, Md, Md, Md, Md, Md, Md, Hd, Hd, Hd, Hd, Hd, Hd, Hd, Hd, Hd, Rd, Hd, Hd, Hd, Hd, Hd, Hd, Md, Md, Md, Md^Xm, Md^Xm, Md^Xm, Md^Xm, Md, Hd, Hd, Dd, Dd, Dd, Dd, Dd, Dd, Dd, Hd, Hd, Md, Md, Md, Xu, Xu, Xu, Xu, Xu, Xu, Xu, Xu
Md, Md, Xu, Xu, Xu, Xu, Xu, Xu, Xu, Xu, Xu, Xu, Xu, Xu, Xu, Xu, Xu, Xu, Xu, Xu, Xu, Xu, Xu, Xu, Xu, Xu, Xu, Md, Md, Md, Md, Hd, Hd, Hd, Hd, Hd, Hd, Hd, Hd, Hd, Hd, Rd, Hd, Hd, Hd, Hd, Hd, Md, Md, Md, Md^Xm, Md^Xm, Md^Xm, Md^Xm, Md^Xm, Md, Md, Hd, Hd, Dd, Dd, Dd, Hd, Hd, Hd, Hd, Md, Md, Xu, Xu, Xu, Xu, Xu, Xu, Xu, Xu, Xu, Xu
Xu, Xu, Xu, Xu, Xu, Xu, Xu, Xu, Xu, Xu, Xu, Xu, Xu, Xu, Xu, Xu, Xu, Xu, Xu, Xu, Xu, Xu, Xu, Xu, Xu, Xu, Xu, Xu, Md, Md, Md, Hd, Dd, Dd, Dd, Hd, Dd, Dd, Rd, Rd, Hd, Hd, Hd, Hd, Hd, Hd, Md, Md, Md, Md^Xm, Md^Xm, Md^Xm, Md^Xm, Md^Xm, Md^Xm, Md, Md, Hd, Hd, Hd, Hd, Hd, Hd, Hd, Md, Md, Xu, Xu, Xu, Xu, Xu, Xu, Xu, Xu, Xu, Xu, Xu, Xu
Xu, Xu, Xu, Xu, Xu, Xu, Xu, Xu, Xu, Xu, Xu, Xu, Xu, Xu, Xu, Xu, Xu, Xu, Xu, Xu, Xu, Xu, Xu, Xu, Xu, Xu, Xu, Xu, Md, Md, Hd, Hd, Dd, Dd, Dd, Dd, Dd, Dd, Rd, Dd, Dd, Hd, Hd, Hd, Hd, Hd, Md, Md, Md^Xm, Md^Xm, Md^Xm, Md^Xm, Md^Xm, Md^Xm, Md^Xm, Md^Xm, Md^Xm, Md, Md, Hd, Md, Hd, Md, Md, Xu, Xu, Xu, Xu, Xu, Xu, Xu, Xu, Xu, Xu, Xu, Xu, Xu, Xu
Xu, Xu, Xu, Xu, Xu, Xu, Xu, Xu, Xu, Xu, Xu, Xu, Xu, Xu, Xu, Xu, Xu, Xu, Xu, Xu, Xu, Xu, Xu, Xu, Xu, Xu, Md, Md, Md, Hd, Hd, Hd, Hd, Dd, Dd, Hd, Hd, Dd, Rd, Dd, Hd, Hd, Hd, Hd, Hd, Hd, Md, Md, Md^Xm, Md^Xm, Md^Xm, Md^Xm, Md^Xm, Md^Xm, Md^Xm, Md^Xm, Md^Xm, Md^Xm, Md^Xm, Md, Md^Xm, Md, Xu, Xu, Xu, Xu, Xu, Xu, Xu, Xu, Xu, Xu, Xu, Xu, Xu, Xu, Xu, Xu
Xu, Xu, Xu, Xu, Xu, Xu, Xu, Xu, Xu, Xu, Xu, Xu, Xu, Xu, Mm^Xm, Xu, Xu, Xu, Xu, Xu, Xu, Xu, Xu, Xu, Xu, Xu, Md, Md, Md, Hd, Hd, Hd, Hd, Dd, Dd, Hd, Hd, Hd, Rd, Dd, Hd, Hd, Hd, Hd, Hd, Hd, Md, Md, Md^Xm, Md^Xm, Md^Xm, Md^Xm, Md^Xm, Md^Xm, Md^Xm, Md^Xm, Md^Xm, Md^Xm, Md^Xm, Md^Xm, Md^Xm, Xu, Xu, Xu, Xu, Xu, Xu, Xu, Xu, Xu, Xu, Xu, Xu, Xu, Xu, Xu, Xu, Xu
Xu, Xu, Uu, Xu, Uu, Uu, Uu, Xu, Xu, Xu, Xu, Xu, Xu, Xu, Mm^Xm, Xu, Xu, Xu, Xu, Xu, Uu, Xu, Uu, Xu, Xu, Xu, Md, Md, Md, Hd, Hd, Hd, Hd, Dd, Hd, Hd, Hd, Hd, Hd, Dd, Hd, Hd, Dd, Hd, Hd, Hd, Md, Md, Md^Xm, Md^Xm, Md^Xm, Md^Xm, Md^Xm, Md^Xm, Md^Xm, Md^Xm, Md^Xm, Md^Xm, Md^Xm, Md^Xm, Xu, Xu, Xu, Xu, Xu, Xu, Xu, Xu, Xu, Xu, Xu, Xu, Xu, Xu, Xu, Xu, Xu, Xu
Wo, Wwg, Xu, Re, Xu, Xu, Uh, Uu, Xu, Xu, Xu, Xu, Xu, Xu, Xu, Mm^Xm, Mm^Xm, Uu, Uu, Uu, Xu, Uu, Xu, Uu, Xu, Xu, Xu, Md, Md, Md, Hd, Hd, Hd, Hd, Hd, Hd, Dd, Dd, Rd, Dd, Dd, Dd, Dd, Dd, Hd, Md, Md, Md, Md, Md^Xm, Md^Xm, Md^Xm, Md^Xm, Md^Xm, Md^Xm, Md^Xm, Md^Xm, Md^Xm, Md^Xm, Md^Xm, Xu, Xu, Xu, Xu, Xu, Xu, Xu, Xu, Xu, Xu, Xu, Xu, Xu, Xu, Xu, Xu, Xu, Xu
Xu, Wwg, Uh, Uu, Xu, Xu, Xu, Uu, Xu, Xu, Xu, Xu, Uu, Uu, Uu, Uu, Mm^Xm, Xu, Xu, Xu, Xu, Xu, Xu, Uu, Uu, Xu, Xu, Md, Md, Md, Hd, Hd, Hd, Dd, Dd, Dd, Hd, Hd, Rd, Hd, Hd, Dd, Dd, Hd, Hd, Md, Md, Md, Md, Md^Xm, Md^Xm, Md^Xm, Md^Xm, Md^Xm, Md^Xm, Md^Xm, Md^Xm, Md^Xm, Md^Xm, Xu, Xu, Xu, Xu, Xu, Xu, Xu, Xu, Xu, Xu, Xu, Xu, Xu, Xu, Xu, Xu, Xu, Xu, Xu
Xu, Xu, Xu, Xu, Xu, Xu, Uu^Uf, Uu, Xu, Xu, Xu, Xu, Uu, Xu, Xu, Xu, Xu, Xu, Uu^Vud, Xu, Uu, Xu, Xu, Xu, Xu, Uu, Xu, Xu, Md, Md, Md, Hd, Hd, Hd, Dd, Dd, Hd, Hd, Dd, Rd, Rd, Hd, Hd, Hd, Hd, Md, Md, Md, Md, Md^Xm, Md^Xm, Md^Xm, Md^Xm, Md^Xm, Md^Xm, Md^Xm, Md^Xm, Md^Xm, Md^Xm, Xu, Xu, Xu, Xu, Xu, Xu, Xu, Xu, Xu, Xu, Xu, Xu, Xu, Xu, Xu, Xu, Xu, Xu, Xu
Xu, Xu, Xu, Xu, Re, Uu, Xu, Xu, Xu, Xu, Xu, Xu, Uu, Xu, Uu, Uu, Uu, Uu, Uu, Uu, Re, Xu, Xu, Xu, Xu, Uu, Uu, Xu, Md, Md, Dd, Hd, Dd, Dd, Dd, Dd, Hd, Hd, Hd, Dd, Dd, Rd, Dd, Hd^Edp, Hd, Hd, Hd, Hd, Md, Md, Md, Md^Xm, Md, Md, Md, Md^Xm, Md^Xm, Md^Xm, Xu, Xu, Xu, Xu, Xu, Xu, Xu, Xu, Xu, Xu, Xu, Xu, Xu, Xu, Xu, Xu, Xu, Xu, Xu, Xu
Xu, Xu, Xu, Xu, Re, Xu, Xu, Xu, Xu, Xu, Xu, Xu, Uu, Uu, Xu, Re, Re, Uu, Chr, Uu, Uu, Re, Re, Xu, Xu, Xu, Xu, Dd, Dd, Dd, Md, Dd, Hd, Hd, Hd, Hd, Hd, Hd, Hd, Dd, Dd, Rd, Rd, Dd, Dd, Hd, Hd, Hd, Md, Md, Md, Md, Md, Md, Md, Md, Md^Xm, Md^Xm, Xu, Xu, Xu, Xu, Xu, Xu, Xu, Xu, Xu, Xu, Xu, Xu, Xu, Xu, Xu, Xu, Xu, Xu, Xu, Xu
Xu, Xu, Uh, Xu, Uu, Xu, Xu, Xu, Xu, Xu, Uu, Uu, Xu, Xu, Xu, Xu, Xu, Xu, Khr, Chr, Uu, Uu, Uu, Uu^Vud, Xu, Xu, Md, Md, Md, Md, Md, Hd, Hd, Hd, Dd^Vdt, Hd, Hd, Hd, Hd, Hd, Rd^Edp, Rd, Dd^Vdt, Rd, Rd, Dd^Edp, Hd, Hd, Hd, Hd, Hd, Md, Md, Md, Md, Md, Md, Xu, Xu, Xu, Xu, Xu, Xu, Xu, Xu, Xu, Xu, Xu, Xu, Xu, Xu, Xu, Xu, Xu, Xu, Xu, Xu, Xu
Xu, Xu, Uu^Uf, Uu^Uf, Uu, Xu, Xu, Xu, Xu, Uu, Uu, Xu, Xu, Xu, Xu, Xu, Xu, Xu, Xu, Chr, Re, Uu, Uu, Uu, Re, Xu, Md, Md, Md, Md, Hd, Hd, Hd, Hd, Hd, Hd, Hd, Hd, Dd, Dd, Rd, Gs^Edp, Wwt, Gs, Gs^Edp, Rd, Rd, Dd^Vdt, Rd, Hd, Hd, Hd, Hd, Md, Md, Md, Md, Xu, Xu, Xu, Xu, Xu, Xu, Xu, Xu, Xu, Xu, Xu, Xu, Xu, Xu, Xu, Xu, Xu, Xu, Xu, Xu, Xu
Xu, Xu, Uu^Uf, Xu, Uu, Xu, Xu, Xu, Uh, Uu, Uu, Uh, Uu, Xu, Xu, Xu, Xu, Uu, Uu, Uu, Uu^Vud, Re, Uu, Uu, Md, Md, Md, Md, Md, Md, Hd, Hd, Hd, Hd^Edp, Hd, Hd, Dd, Dd, Dd^Edp, Rd, Gs, Gs, Wwt, Wwt, Gs, Rd, Hd, Rd, Hd, Rd, Rd, Hd, Hd, Md, Md, Md, Xu, Xu, Xu, Xu, Xu, Xu, Xu, Xu, Xu, Xu, Xu, Xu, Xu, Xu, Xu, Xu, Xu, Xu, Xu, Xu, Xu, Xu
Xu, Xu, Uu, Xu, Xu, Re, Xos, Xos, Xos, Uu, Uu, Uu, Re, Xu, Xu, Xu, Xu, Xu, Xu, Xu, Uu, Re, Md, Md, Hd, Hd, Hd, Hd, Dd^Vdt, Hd, Hd, Hd, Dd, Hd, Dd, Dd, Dd^Edp, Dd, Dd, Rd, Rd, Dd^Vdt, Gs, Wwt, Gs, Rd^Edp, Hd, Hd, Hd, Dd^Vdt, Rd, Hd, Hd, Md, Md, Md, Xu, Xu, Xu, Xu, Xu, Xu, Xu, Xu, Xu, Xu, Xu, Xu, Xu, Xu, Xu, Xu, Xu, Xu, Xu, Xu, Xu, Xu
Xu, Xu, Uu, Xu, Xu, Re, Xu, Xu, Xu, Xos, Uu, Xu, Xu, Xu, Xu, Xu, Xu, Xu, Xu, Xu, Md, Md, Md, Md, Hd, Hd, Hd, Hd, Hd, Rd, Rd, Rd, Rd, Dd^Edp, Rd, Rd, Rd^Edp, Dd, Dd, Dd, Dd^Edp, Rd, Rd, Dd^Vdt, Rd, Rd, Hd, Hd, Rd, Rd, Hd, Hd, Hd, Md, Md, Md, Xu, Xu, Xu, Xu, Xu, Xu, Xu, Xu, Xu, Xu, Xu, Xu, Xu, Xu, Xu, Xu, Xu, Xu, Xu, Xu, Xu, Xu
Xu, Xu, Re, Xu, Xu, Uu, Re, Xu, Xu, Xos, Uu, Xos, Uu, Xu, Xu, Xu, Xu, Xu, Xu, Xu, Md, Md, Md, Hd, Hd, Hd, Hd, Hd, Hd, Hd, Dd^Vdt, Hd, Hd, Rd, Gs, Gs^Edp, Gs, Rd, Rd, Dd, Rd, Rd, Dd, Rd, Dd, Hd, Hd, Hd, Rd, Dd^Vdt, Hd, Hd, Hd, Md, Md, Md, Xu, Xu, Xu, Xu, Xu, Xu, Xu, Xu, Xu, Xu, Xu, Xu, Xu, Xu, Xu, Xu, Xu, Xu, Xu, Xu, Xu, Xu
Xu, Xu, Xu, Uu, Uu, Xu, Uu, Xu, Xu, Xos, Xos, Uu, Uu, Uu, Xu, Xu, Xu, Xu, Xu, Xu, Md, Md, Md, Dd^Vdt, Hd, Hd, Hd, Hd, Hd, Hd, Hd, Hd, Hd, Rd^Edp, Dd^Vdt, Wwt, Wwt, Dd^Vdt, Rd, Rd^Edp, Rd, Rd, Dd, Dd, Hd, Hd, Hd, Hd, Rd, Hd, Hd, Hd, Md, Md, Md, Md, Xu, Xu, Xu, Xu, Xu, Xu, Xu, Xu, Xu, Xu, Xu, Xu, Xu, Xu, Xu, Xu, Xu, Xu, Xu, Xu, Xu, Xu
Xu, Xu, Xu, Xu, Uh, Uh, Xu, Xu, Xu, Uu, Uu, Uu, Uu, Uu, Xu, Xu, Xu, Xu, Xu, Xu, Xu, Md, Md, Md, Md, Hd, Md, Hd, Md, Hd, Hd, Hd, Hd, Hd, Hd, Wwt, Dd^Vdt, Gs^Edp, Rd, Dd, Dd, Rd, Rd, Hd, Chr, Hd, Rd, Rd, Hd, Hd, Md, Md, Md, Md, Xu, Xu, Xu, Xu, Xu, Xu, Xu, Xu, Xu, Xu, Xu, Xu, Xu, Xu, Xu, Xu, Xu, Xu, Xu, Xu, Xu, Xu, Xu, Xu
Xu, Xu, Xu, Xu, Uu, Xu, Xu, Xu, Xu, Uu, Uu, Uu, Uu, Uu, Xu, Xu, Xu, Xu, Uu, Xu, Xu, Xu, Xu, Md, Md, Md, Md, Md, Md, Md, Hd, Hd, Hd, Hd, Hd^Edp, Hd, Hd, Rd, Hd, Dd, Dd, Dd, Hd, Chr, 2 Khr, Chr, Hd, Hd, Hd, Md, Md, Md, Md, Md, Xu, Xu, Xu, Xu, Xu, Xu, Xu, Xu, Xu, Xu, Xu, Xu, Xu, Xu, Xu, Xu, Xu, Xu, Xu, Xu, Xu, Xu, Xu, Xu
Xu, Xu, Xu, Xu, Xu, Uu^Uf, Xu, Xu, Xu, Uu, Uu, Uu, Uu, Uu, Xu, Xu, Uu, Uu, Uu, Uu, Uu, Xu, Xu, Xu, Xu, Md, Md, Md, Md, Md, Md, Hd, Md, Hd, Md, Hd, Hd, Hd, Hd, Hd, Hd, Hd, Hd, Chr, Chr, Chr, Hd, Hd, Md, Md, Md, Md, Xu, Xu, Xu, Xu, Xu, Xu, Xu, Xu, Xu, Xu, Xu, Xu, Xu, Xu, Xu, Xu, Xu, Xu, Xu, Xu, Xu, Xu, Xu, Xu, Xu, Xu
Xu, Xu, Xu, Xu, Uu, Uu, Xu, Xu, Xu, Uu, Uu, Uu, Xu, Xu, Xu, Xu, Uu, Uu, Uu, Uu, Uu, Xu, Xu, Xu, Xu, Xu, Xu, Md, Md, Md, Md, Md, Md, Md, Md, Md, Md, Md, Md, Hd, Hd, Hd, Hd, Hd, Hd, Hd, Md, Md, Md, Md, Md, Xu, Xu, Xu, Xu, Xu, Xu, Xu, Xu, Xu, Xu, Xu, Xu, Xu, Xu, Xu, Xu, Xu, Xu, Xu, Xu, Xu, Xu, Xu, Xu, Xu, Xu, Xu
Xu, Xu, Uu, Uu, Xu, Xu, Xu, Xu, Xu, Uu, Xu, Xu, Xu, Xu, Xu, Xu, Uu, Uu, Uu, Uu, Uu, Xu, Xu, Xu, Xu, Xu, Xu, Xu, Md, Md, Md, Md, Md, Md, Md, Md, Md, Md, Md, Md, Md, Hd, Hd, Hd, Md, Md, Md, Md, Md, Md, Xu, Xu, Xu, Xu, Xu, Xu, Xu, Xu, Xu, Xu, Xu, Xu, Xu, Xu, Xu, Xu, Xu, Xu, Xu, Xu, Xu, Xu, Xu, Xu, Xu, Xu, Uu, Uu
Xu, Xu, Re, Xu, Xu, Xu, Xos, Xu, Xu, Xu, Xu, Xu, Xu, Xu, Xu, Xu, Xu, Uu, Uu, Uu, Xu, Xu, Xu, Xu, Xu, Xu, Xu, Xu, Xu, Md, Md, Md, Xu, Xu, Xu, Md, Md, Md, Md, Md, Md, Md, Md, Md, Md, Md, Md, Md, Xu, Xu, Xu, Xu, Xu, Xu, Xu, Xu, Xu, Xu, Xu, Xu, Xu, Xu, Xu, Xu, Xu, Xu, Xu, Xu, Xu, Xu, Xu, Xu, Xu, Xu, Uu, Wwg, Wo, Wo
Xu, Xu, Re, Xu, Xos, Xos, Urb, Uu, Uu, Xu, Xu, Xu, Xu, Xu, Xu, Xu, Xu, Uu, Uu, Uu, Xu, Xu, Xu, Xu, Xu, Xu, Xu, Xu, Xu, Xu, Xu, Xu, Xu, Xu, Xu, Xu, Xu, Md, Xu, Md, Xu, Md, Md, Md, Md, Md, Md, Xu, Xu, Xu, Xu, Xu, Xu, Xu, Xu, Xu, Xu, Xu, Xu, Xu, Xu, Xu, Xu, Xu, Xu, Xu, Xu, Xu, Xu, Xu, Uh, Uu, Uh, Uu, Wo, Wo, Wo, Wo
Xu, Xu, Xu, Uu, Uu, Urb, Urb, Urb, Uu, Xos, Xu, Xu, Xu, Xu, Xu, Xu, Xu, Uu, Uu, Uu, Xu, Xu, Xu, Xu, Xu, Xu, Xu, Xu, Xu, Xu, Xu, Xu, Xu, Xu, Xu, Xu, Xu, Xu, Xu, Xu, Xu, Xu, Xu, Md, Md, Md, Uu, Xu, Xu, Xu, Xu, Xu, Xu, Xu, Xu, Xu, Xu, Xu, Xu, Xu, Xu, Xu, Xu, Xu, Xu, Xu, Xu, Xu, Xu, Uh, Wo, Wo, Wo, Wo, Wo, Wo, Xu, Xu
Xu, Xu, Xu, Xos, Uu, Urb, Urb, Urb, Uu, Xos, Xu, Xu, Xu, Xu, Xu, Xu, Xu, Uu, Uu, Uu, Xu, Xu, Uu, Uu, Uu, Xu, Xu, Xu, Xu, Xu, Xu, Xu, Xu, Xu, Xu, Xu, Xu, Xu, Xu, Xu, Xu, Xu, Xu, Xu, Uu, Uu, Uu, Uu, Xu, Xu, Xu, Xu, Xu, Xu, Xu, Xu, Xu, Xu, Xu, Xu, Xu, Xu, Xu, Xu, Xu, Xu, Xu, Xu, Uu, Uh, Wo, Wo, Wo, Wo, Xu, Xu, Xu, Xu
Xu, Xu, Xu, Xu, Xu, Uu, Uu, Uu, Uu, Uu, Uu, Xu, Xu, Xu, Xu, Xu, Xu, Xu, Xu, Xu, Xu, Xu, Xu, Xu, Uu, Xu, Xu, Xu, Uu, Xu, Xu, Xu, Xu, Xu, Xu, Xu, Xu, Xu, Xu, Xu, Xu, Xu, Xu, Xu, Xu, Uu, Uu, Uu, Xu, Xu, Xu, Xu, Xu, Xu, Xu, Xu, Xu, Xu, Xu, Xu, Xu, Xu, Xu, Xu, Xu, Xu, Uu, Uu, Wo, Wo, Wo, Wo, Xu, Xu, Xu, Xu, Xu, Xu
Xu, Xu, Xu, Xu, Xu, Xu, Xu, Uu, Uu, Uu, Uu, Xu, Xos, Xu, Re, Uu, Xos, Uu, Xu, Xu, Xu, Xu, Xu, Xu, Uu, Xu, Uu, Uu, Cud, Uu, Uu, Xu, Xu, Xu, Xu, Xu, Xu, Xu, Xu, Xu, Xu, Xu, Xu, Xu, Xu, Uu, Uu, Xu, Xu, Xu, Xu, Xu, Xu, Xu, Xu, Xu, Xu, Xu, Xu, Xu, Xu, Xu, Xu, Xu, Xu, Uh, Wo, Wo, Wo, Wo, Wo, Wo, Xu, Xu, Xu, Xu, Xu, Xu
Xu, Xu, Xu, Xu, Xu, Xu, Xu, Uu, Uu, Uu, Xu, Uu, Uu, Uu, Uu, Uu, Uu, Uu, Xu, Xu, Xu, Xu, Xu, Xu, Xu, Uu, Uu, Cud, Kud, Cud, Uu, Xu, Xu, Xu, Xu, Xu, Xu, Xu, Xu, Xu, Xu, Xu, Xu, Xu, Wo, Wo, Xu, Xu, Xu, Xu, Xu, Xu, Xu, Xu, Xu, Xu, Xu, Xu, Xu, Xu, Xu, Xu, Xu, Xu, Uu, Uu, Wo, Wo, Wo, Wo, Xu, Xu, Xu, Xu, Xu, Xu, Xu, Xu
Xu, Xu, Xu, Xu, Xu, Xu, Xu, Xu, Uu, Xu, Xom, Xu, Xu, Uu, Uu, Uu, Uu, Uu, Uu, Re, Xu, Xu, Xu, Xu, Xu, Xu, Uu, Cud, Cud, Cud, Uu, Xu, Xu, Xu, Xu, Xu, Xu, Xu, Xu, Xu, Xu, Xu, Xu, Xu, Wo, Xu, Xu, Xu, Xu, Xu, Xu, Xu, Xu, Xu, Xu, Xu, Xu, Xu, Xu, Xu, Xu, Xu, Xu, Xu, Wwg, Wo, Wo, Wo, Wo, Xu, Xu, Xu, Xu, Xu, Xu, Xu, Xu, Xu
Xu, Xu, Xu, Xu, Xu, Xu, Xu, Xu, Uu, Xu, Iwr, Xom, Xom, Uu, Xu, Uu, Uu, Uu, Uu, Uu, Uu, Xu, Xu, Xu, Xu, Xu, Xu, Uu, Uu, Uu, Xu, Xu, Xu, Xu, Xu, Xu, Xu, Xu, Xu, Xu, Uu, Wwg, Wo, Wo, Wo, Xu, Xu, Xu, Xu, Xu, Xu, Xu, Re, Xu, Xu, Xu, Xu, Xu, Xu, Xu, Xu, Xu, Wwg, Uu, Wo, Wo, Wo, Wo, Xu, Xu, Xu, Xu, Xu, Xu, Xu, Xu, Xu, Xu
Wo, Wwg, Uu, Xu, Xu, Xu, Xu, Xom, Iwr, Iwr, Iwr, Iwr, Iwr, Xom, Xu, Re, Re, Xu, Xu, Xu, Uu, Xu, Xu, Xu, Xu, Xu, Xu, Xu, Xu, Xu, Xu, Xu, Xu, Xu, Xu, Xu, Xu, Xu, Uu, Uh, Uh, Wwg, Xu, Xu, Xu, Xu, Xu, Xu, Xu, Xu, Xu, Uu, Uu, Re, Uu, Xu, Xu, Xu, Xu, Xu, Uu, Uu, Wo, Wo, Xu, Xu, Xu, Xu, Xu, Xu, Xu, Xu, Xu, Xu, Xu, Xu, Xu, Xu
Xu, Xu, Re, Xu, Xu, Xu, Xu, Xom, Iwr, Iwr, Iwr, Iwr, Iwr, Xom, Xom, Xu, Xu, Xu, Xu, Xos, Uu, Xu, Xu, Xu, Xu, Xu, Xu, Xu, Xu, Xu, Xu, Xu, Xu, Xu, Xu, Xu, Xu, Xu, Re, Uu, Xu, Xu, Xu, Xu, Xu, Xu, Xu, Xu, Xu, Uu, Uu, Uu, Ce, Uu, Uu, Xu, Xu, Xu, Uu, Uh, Ww, Ww, Wo, Xu, Xu, Xu, Xu, Xu, Xu, Xu, Xu, Xu, Xu, Xu, Xu, Xu, Xu, Xu
Xu, Xu, Re, Xu, Xu, Xu, Xu, Xom, Iwr, Iwr, Iwr, Iwr, Iwr, Iwr, Xom, Xu, Xos, Re, Uu, Uu, Uu, Xu, Xu, Xu, Xu, Xu, Xu, Xu, Xu, Xu, Xu, Xu, Xu, Xu, Xu, Xu, Uu, Uu, Xu, Xu, Xu, Xu, Xu, Xu, Xu, Xu, Xu, Xu, Xu, Uh, Uu, 1 Ke, Ce, Uu, Uu, Uh, Uh, Xu, Uu, Wo, Wo, Wo, Wo, Xu, Xu, Xu, Xu, Xu, Xu, Xu, Xu, Xu, Xu, Xu, Xu, Xu, Xu, Xu
Xu, Xu, Re, Xu, Xu, Xu, Xu, Xu, Xom, Iwr, Iwr, Iwr, Iwr, Iwr, Xos, Xu, Uu, Uu, Uu, Uu, Uu, Uu, Xu, Xu, Xu, Xu, Xu, Xu, Xu, Xu, Xu, Xu, Xu, Xu, Uh, Uh, Uu, Uu, Xu, Xu, Xu, Xu, Xu, Xu, Xu, Xu, Xu, Xu, Xu, Xu, Uu, Ce, Uu, Uu, Uu, Uu, Wwg, Uu, Wwg, Wo, Wo, Wo, Xu, Xu, Xu, Xu, Xu, Xu, Xu, Xu, Xu, Xu, Xu, Xu, Xu, Xu, Xu, Xu
Xu, Xu, Uu, Xu, Xu, Xu, Xu, Xu, Xu, Iwr, Iwr, Iwr, Uu, Xos, Uu, Uu, Uu, Uu, Uu, Uu, Uu, Re, Xos, Xu, Xu, Xu, Xu, Xu, Xu, Xu, Uu, Xu, Uu, Uu, Uu, Uu, Xu, Xu, Xu, Xu, Xu, Xu, Xu, Xu, Xu, Xu, Xu, Xu, Xu, Xu, Re, Uu, Uu, Uh, Uu, Wwg, Wwg, Wo, Wo, Wo, Wo, Xu, Xu, Xu, Xu, Xu, Xu, Xu, Xu, Xu, Xu, Xu, Xu, Xu, Xu, Xu, Xu, Xu
Xu, Xu, Uu, Re, Xu, Xu, Xu, Xu, Xu, Xom, Xu, Xu, Xu, Uu, Xu, Xu, Uu, Uu, Uu, Uu, Uu, Xos, Chr, Re, Re, Xu, Xu, Xu, Xu, Re, Uu, Uh, Uu, Uu, Re, Xu, Xu, Xu, Xu, Xu, Xu, Xu, Re, Xu, Xu, Xu, Xu, Xu, Xu, Re, Uu, Uu, Uu, Uu, Uu, Uu, Wo, Wo, Wo, Wo, Wo, Xu, Xu, Xu, Xu, Xu, Xu, Xu, Xu, Xu, Xu, Xu, Xu, Xu, Xu, Xu, Xu, Xu
Xu, Xu, Xu, Uu, Xu, Xu, Xu, Xu, Xu, Xu, Uu^Em, Xu, Uu, Xu, Uu, Uu, Xu, Xu, Xu, Xos, Uu, Uu, Uu, Uu, Chr, Xu, Xu, Xu, Xu, Xu, Uu, Uu, Uu, Uu, Uu, Xu, Xu, Xu, Xu, Xu, Xu, Xu, Uu, Re, Uu, Uu^Em, Xu, Xu, Xu, Uu, Uu, Uu, Re, Uu, Uu, Wwg, Wo, Wo, Wo, Xu, Xu, Xu, Xu, Xu, Xu, Xu, Xu, Xu, Xu, Xu, Xu, Xu, Xu, Xu, Xu, Xu, Xu, Xu
Xu, Xu, Xu, Re, Uu, Xu, Uu, Uu, Re^Edt, Uu, Uu, Uu, Uu, Uu, Uu, Xu, Xu, Xu, Xu, Chr, Uu, Uu, Uu^Xo, Urb^Xo, Xos, Xos, Xu, Xu, Xu, Uh, Xu, Uu, Re, Uu^Uf, Uu, Xu, Xu, Xu, Uu, Uu, Uu, Uu, Uu, Uu, Uh, Uu, Uu, Xu, Uu, Uu, Uu, Xu, Xu, Uu, Wwg, Wwg, Wo, Wo, Wo, Xu, Xu, Xu, Xu, Xu, Xu, Xu, Xu, Xu, Xu, Xu, Xu, Xu, Xu, Xu, Xu, Xu, Xu, Xu
Xu, Xu, Xu, Xu, Uu, Xu, Uu, Uu, Re, Uu^Edb, Uu, Uu^Es, Uu, Uu, Xu, Xu, Xu, Xu, Xu, Xu, Xu, Chr, Xos, Uu, Uu, Uu, Uu, Xu, Re, Uh, Xu, Re, Xu, Re, Uu, Xu, Uu, Xu, Xu, Uu, Uu, Uu^Em, Re, Xu, Xu, Uu, Re, Re, Re, Uu, Xu, Xu, Xu, Uu, Wo, Wo, Wo, Wo, Xu, Xu, Xu, Xu, Xu, Xu, Xu, Xu, Xu, Xu, Xu, Xu, Xu, Xu, Xu, Xu, Xu, Xu, Xu, Xu
Xu, Xu, Xu, Xu, Xu, Uu, Uu, Re^Edb, Re^Edb, Uu, Re^Edt, Uu, Xu, Xu, Xu, Xu, Xu, Xu, Xu, Xu, Xu, Xos, Xu, Uu, Uh, Uu, Xu, Uu, Xu, Xu, Xu, Xu, Xu, Xu, Xu, Uu, Xu, Uu, Uu, Uu, Uu, Uu, Re, Xu, Xu, Xu, Xu, Xu, Xu, Xu, Xu, Xu, Uu, Uu, Wwg, Wo, Wo, Xu, Xu, Xu, Xu, Xu, Xu, Xu, Xu, Xu, Xu, Xu, Xu, Xu, Xu, Xu, Xu, Xu, Xu, Xu, Xu, Xu
Xu, Xu, Xu, Xu, Xu, Xu, Xu, Re, Re, Re, Xu, Xu, Xu, Uu, Uu, Re, Re, Xu, Xu, Xu, Xu, Xu, Xu, Xu, Xu, Xu, Xu, Xu, Xu, Xu, Xu, Xu, Xu, Xu, Xu, Xu, Xu, Xu, Uu^Em, Uu, Uu, Uu^Uf, Uu^Uf, Xu, Xu, Xu, Xu, Xu, Xu, Xu, Xu, Xu, Uu, Wwg, Wo, Wo, Wo, Xu, Xu, Xu, Xu, Xu, Xu, Xu, Xu, Xu, Xu, Xu, Xu, Xu, Xu, Xu, Xu, Xu, Xu, Xu, Xu, Xu
Xu, Xu, Xu, Xu, Xu, Xu, Xu, Xu, Xu, Xu, Xu, Xu, Xu, Xu, Xu, Xu, Xu, Re, Re, Uu, Uu, Xu, Uh, Uu, Xu, Xu, Xu, Xu, Xu, Xu, Xu, Xu, Xu, Xu, Xu, Xu, Xu, Xu, Re, Uu, Uu^Uf, Uu^Uf, Uu^Uf, Uu^Uf, Uu^Uf, Xu, Xu, Xu, Wwg, Xu, Xu, Xu, Uu, Wwg, Wo, Wo, Wo, Wo, Xu, Xu, Xu, Xu, Xu, Xu, Xu, Xu, Xu, Xu, Xu, Xu, Xu, Xu, Xu, Xu, Xu, Xu, Xu, Xu
Xu, Xu, Xu, Xu, Xu, Xu, Xu, Xu, Xu, Xu, Xu, Xu, Xu, Xu, Xu, Xu, Xu, Xu, Xu, Xu, Xu, Uh, Xu, Xu, Xu, Xu, Xu, Xu, Xu, Xu, Xu, Xu, Xu, Xu, Xu, Xu, Xu, Uh, Uh, Re, Uu^Uf, Uu^Uf, Xu, Uu^Uf, Uu^Uf, Xu, Re, Uu^Uf, Wwg, Wo, Wo, Wo, Ww, Wo, Wo, Wo, Xu, Xu, Xu, Xu, Xu, Xu, Xu, Xu, Xu, Xu, Xu, Xu, Xu, Xu, Xu, Xu, Xu, Xu, Xu, Xu, Xu, Xu
Xu, Xu, Xu, Xu, Xu, Xu, Xu, Xu, Xu, Xu, Xu, Xu, Xu, Xu, Xu, Xu, Xu, Xu, Xu, Xu, Xu, Xu, Xu, Xu, Xu, Xu, Xu, Xu, Xu, Xu, Xu, Xu, Xu, Xu, Xu, Xu, Xu, Xu, Uh, Xu, Xu, Xu, Xu, Xu, Xu, Uu^Uf, Xu, Xu, Xu, Wo, Xu, Wo, Xu, Uu, Wo, Xu, Xu, Xu, Xu, Xu, Xu, Xu, Xu, Xu, Xu, Xu, Xu, Xu, Xu, Xu, Xu, Xu, Xu, Xu, Xu, Xu, Xu, Xu
Xu, Xu, Xu, Xu, Xu, Xu, Xu, Xu, Xu, Xu, Xu, Xu, Xu, Xu, Xu, Xu, Xu, Xu, Xu, Xu, Xu, Xu, Xu, Xu, Xu, Xu, Xu, Xu, Xu, Xu, Xu, Xu, Xu, Xu, Xu, Xu, Xu, Xu, Xu, Xu, Xu, Xu, Xu, Xu, Xu, Xu, Xu, Xu, Xu, Xu, Xu, Xu, Xu, Uu, Wo, Xu, Xu, Xu, Xu, Xu, Xu, Xu, Xu, Xu, Xu, Xu, Xu, Xu, Xu, Xu, Xu, Xu, Xu, Xu, Xu, Xu, Xu, Xu
