Xu, Xu, Xu, Xu, Xu, Xu, Xu, Xu, Xu, Xu, Xu, Xu, Xu, Xu, Xu, Xu, Xu, Xu, Xu, Xu, Xu, Xu
Xu, Xu, Xu, Xu, Xu, Xu, Xu, Xu, Xu, Xu, Xu, Xu, Xu, Xu, Xu, Xu, Xu, Xu, Xu, Xu, Xu, Xu
Xu, Xu, Xu, Xu, Xu, Xu, Xu, Xu, Xu, Xu, Xu, Xu, Xu, Xu, Xu, Xu, Xu, Xu, Xu, Xu, Xu, Xu
Xu, Xu, Xu, Xu, Xu, Xu, Xu, Xu, Xu, Xu, Urb, Xu, Xu, Xu, Xu, Xu, Xu, Xu, Xu, Xu, Xu, Xu
Xu, Xu, Xu, Xu, Xu, Xu, Xu, Xu, Uu, Uu^Es, Urb, Uu^Em, Rb^Em, Xu, Xu, Xu, Xu, Xu, Xu, Xu, Xu, Xu
Xu, Xu, Xu, Xu, Xu, Xu, Uh^Tf, Uu^Em, Rb^Es, Xu, Urb, Xu, Uh^Tf, Uh, Uu^Emf, Xu, Xu, Xu, Xu, Xu, Xu, Xu
Xu, Xu, Xu, Xu, Uu^Em, Uu^Emf, Uue^Em, Rb, Uue, Rb^Es, Urb, Uu^Em, Uh^Em, Uue, Rb^Es, Uue, Uu^Es, Xu, Xu, Xu, Xu, Xu
Xu, Xu, Xu, Urb, Urb, Xu, Uh, Uue^Es, Xu, Uh, Urb, Ur, Xu, Rb, Uue, Xu, Urb, Urb, Xu, Xu, Xu, Xu
Xu, Xu, Xu, Uu^Em, Xu, Urb, Urb, Ur, Ur, Uue, Urb, Uu^Es, Uu, Uue, Urb, Urb, Xu, Uu, Xu, Xu, Xu, Xu
Xu, Xu, Xu, Uu^Emf, Uh^Tf, Rb^Es, Ur, Urb, Urb, Uu, Urb, Uu, Urb, Urb, Uu^Es, Uu^Es, Rb^Es, Rb^Es, Xu, Xu, Xu, Xu
Xu, Xu, Xu, Rb^Em, Uue, Uh, Xu, Uu^Es, Uu, Urb, 2 Xu, Urb, Uu, Uu, Xu, Uh^Em, Uue^Es, Uh^Em, Xu, Xu, Xu, Xu
Xu, Xu, Xu, Rb^Es, Uu, Uue^Em, Uu, Uu, Urb, Urb, Urb, Urb, Urb, Ur, Ur, Ur, Uue^Em, Uh^Emf, Xu, Xu, Xu, Xu
Xu, Xu, Xu, Uue, Xu, Uh, Urb, Urb, Uue, Uu, Urb, Uu, Uu, Urb, Urb, Uue, Xu, Uue, Xu, Xu, Xu, Xu
Xu, Xu, Xu, Uu, Urb, Urb, Uu, Uue^Em, Xu, Uu, 1 Urb, Uu, Xu, Uh, Uu, Urb, Urb, Uu, Xu, Xu, Xu, Xu
Xu, Xu, Xu, Urb, Uu, Xu, Uue^Em, Uh^Emf, Uh, Uue, Urb, Uue, Uue, Uue^Em, Rb^Es, Xu, Uu, Urb, Xu, Xu, Xu, Xu
Xu, Xu, Xu, Xu, Xu, Uue, Uue^Em, Ur^Es, Ur^Es, Uue, Urb, Uu, Uu, Uue^Em, Uh^Emf, Rb^Em, Xu, Xu, Xu, Xu, Xu, Xu
Xu, Xu, Xu, Xu, Xu, Xu, Xu, Uh, Rb, Xu, Urb, Xu, Uh, Uu^Em, Xu, Xu, Xu, Xu, Xu, Xu, Xu, Xu
Xu, Xu, Xu, Xu, Xu, Xu, Xu, Xu, Xu, Uu, Urb, Uu, Xu, Xu, Xu, Xu, Xu, Xu, Xu, Xu, Xu, Xu
Xu, Xu, Xu, Xu, Xu, Xu, Xu, Xu, Xu, Xu, Rb^Es, Xu, Xu, Xu, Xu, Xu, Xu, Xu, Xu, Xu, Xu, Xu
Xu, Xu, Xu, Xu, Xu, Xu, Xu, Xu, Xu, Xu, Rb, Xu, Xu, Xu, Xu, Xu, Xu, Xu, Xu, Xu, Xu, Xu
Xu, Xu, Xu, Xu, Xu, Xu, Xu, Xu, Rb^Es, Rb, Rb, Rb, Rb^Es, Xu, Xu, Xu, Xu, Xu, Xu, Xu, Xu, Xu
Xu, Xu, Xu, Xu, Xu, Xu, Xu, Xu, Rb, Rb, Rb, Rb, Rb, Xu, Xu, Xu, Xu, Xu, Xu, Xu, Xu, Xu
