border_size=1
usage=map

Re          ,Re          , Re          , Hh          , Hh          , Hh          , Hh          , Hh          , Hh          , Hh          , Hh          , Hh          , Hh          , Hh          , Dd          , Dd          , Dd          , Dd          , Dd          , Dd          , Dd          , Dd          , Dd          , Dd          , Dd          , Dd          , Dd          , Dd          
Re          ,Re          , Re          , Hh          , Hh          , Hh          , Hh          , Hh          , Hh          , Hh          , Hh          , Hh          , Hh          , Hh          , Dd          , Dd          , Dd          , Dd          , Dd          , Dd          , Dd          , Dd          , Dd          , Dd          , Dd          , Dd          , Dd          , Dd          
Hh          ,Hh          , Hh          , Re          , Hh          , Hh          , Hh          , Hh          , Ds          , Ds          , Hh          , Hh          , Hh          , Dd          , Dd          , Dd          , Dd          , Dd          , Dd          , Dd          , Dd          , Dd          , Dd          , Dd          , Dd          , Dd          , Dd          , Dd          
Hh          ,Hh          , Hh          , Re          , Hh          , Hh          , Hh          , Hh          , Hh          , Hh          , Hh          , Hh          , Dd          , Dd          , Dd          , Dd          , Hd          , Hd          , Hd          , Dd          , Dd          , Dd          , Dd          , Dd          , Hd          , Dd          , Dd          , Dd          
Hh          ,Hh          , Hh          , Re          , Re          , Hh          , Hh          , Hh          , Hh          , Hh          , Hh          , Hh          , Dd          , Dd          , Dd          , Dd          , Hd          , Hd          , Dd          , Dd          , Dd          , Dd          , Dd          , Hd          , Hd          , Dd          , Dd          , Dd          
Hh          ,Hh          , Hh          , Hh          , Hh          , Re          , Ds          , Hh          , Hh          , Hh          , Dd          , Dd          , Dd          , Dd          , Dd          , Dd          , Dd          , Hd          , Dd          , Dd          , Dd          , Dd          , Dd^Cd       , Hd          , Dd          , Dd          , Dd          , Dd          
Hh          ,Hh          , Hh          , Ds          , Re          , Re          , Hh          , Hh          , Hh          , Hh          , Dd          , Dd          , Hd          , Dd          , Hd          , Dd          , Dd          , Dd          , Dd          , Dd          , Dd          , Dd          , Dd^Cd       , 3 Dd^Kd     , Dd^Cd       , Dd          , Dd          , Dd          
Hh          ,Hh          , Hh          , Ds          , Re          , Hh          , Hh          , Hh          , Hh          , Hh          , Dd          , Hd          , Hd          , Hd          , Hd          , Dd          , Dd          , Dd          , Dd          , Dd          , Dd          , Dd          , Dd^Cd       , Dd^Cd       , Dd          , Dd          , Dd          , Dd          
Hh          ,Hh          , Hh          , Hh          , Hh          , Re          , Re          , Re          , Dd          , Dd          , Dd          , Dd          , Hd          , Hd          , Hd          , Hd          , Dd          , Dd          , Dd          , Dd          , Dd          , Dd          , Dd          , Hd          , Hd          , Dd          , Dd          , Dd          
Hh          ,Hh          , Hh          , Hh          , Hh          , Hh          , Re          , Re          , Dd          , Dd          , Dd          , Hd          , Hd          , Hd          , Hd          , Hd          , Dd          , Dd          , Dd          , Dd          , Dd          , Dd          , Dd          , Hd          , Dd          , Dd          , Dd          , Dd          
Hh          ,Hh          , Ds          , Hh          , Hh          , Hh          , Dd          , Dd          , Dd          , Dd          , Dd          , Dd          , Dd          , Dd          , Dd^Fi       , Hd          , Dd^Vdt      , Dd          , Dd          , Dd          , Dd          , Dd          , Dd          , Dd          , Dd          , Dd          , Dd          , Dd          
Hh          ,Hh          , Hh          , Hh          , Hh          , Hh          , Dd          , Dd          , Dd          , Dd          , Dd          , Dd          , Hd          , Hd          , Hd          , Hd          , Dd          , Dd          , Dd          , Dd          , Dd          , Dd          , Dd          , Dd          , Hd          , Dd          , Dd          , Dd          
Hh          ,Hh          , Hh          , Hh          , Dd          , Dd          , Hd          , Dd          , Dd          , Dd          , Dd          , Dd^Vdt      , Hd          , Hd          , Dd          , Dd          , Dd          , Dd          , Dd          , Dd^Vdt      , Dd          , Dd          , Dd          , Dd          , Hd          , Dd          , Dd          , Dd          
Hh          ,Hh          , Hh          , Dd          , Dd          , Hd          , Hd          , Hd          , Dd          , Dd          , Dd          , Hd          , Dd          , Dd          , Dd          , Dd^Vdt      , Dd          , Dd          , Dd          , Dd          , Hd          , Hd          , Dd          , Dd          , Hd          , Hd          , Hd          , Hd          
Hh          ,Hh          , Dd          , Dd          , Dd          , Dd          , Dd          , Hd          , Dd          , Dd          , Dd          , Dd          , Dd          , Dd          , Dd          , Dd          , Dd          , Dd          , Dd          , Dd          , Hd          , Dd^Vdt      , Dd          , Dd          , Hd          , Hd          , Hd          , Hd          
Hh          ,Hh          , Dd          , Hd          , Dd          , Dd          , Ce          , Dd          , Dd          , Dd          , Ww          , Dd          , Dd          , Dd          , Dd          , Dd          , Dd^Fi       , Dd          , Dd          , Dd          , Dd          , Dd          , Dd          , Dd          , Dd          , Hd          , Hd          , Hd          
Dd          ,Dd          , Dd          , Dd          , Dd          , Ce          , 1 Ke        , Ce          , Dd          , Ww          , Ww          , Ww          , Dd          , Dd^Vdt      , Dd          , Dd          , Dd          , Dd          , Dd^Vdt      , Dd          , Dd          , Dd          , Dd          , Dd          , Dd          , Hd          , Hd          , Hd          
Dd          ,Dd          , Hd          , Dd          , Dd          , Ce          , Ce          , Ce          , Dd          , Dd          , Ww          , Ww          , Dd          , Dd          , Dd          , Dd          , Dd          , Dd          , Dd          , Dd          , Dd          , Dd          , Dd          , Dd          , Dd          , Dd          , Dd          , Dd          
Dd          ,Dd          , Dd          , Dd          , Dd          , Dd          , Dd          , Dd          , Dd          , Dd          , Dd          , Ww          , Dd          , Dd          , Dd^Vdt      , Dd          , Dd          , Dd          , Dd          , Dd^Vdt      , Dd          , Dd          , Hd          , Dd          , Dd          , Dd          , Dd          , Dd          
Dd          ,Dd          , Dd          , Dd          , Dd          , Dd          , Dd          , Dd          , Dd          , Dd          , Dd^Vdt      , Dd          , Dd          , Dd          , Dd          , Dd          , Dd          , Dd          , Dd          , Dd          , Hd          , Hd          , Hd          , Dd          , Dd          , Dd          , Dd          , Dd          
Dd          ,Dd          , Hd          , Dd          , Dd          , Dd          , Dd          , Dd          , Dd          , Dd          , Dd          , Dd          , Dd          , Dd^Fi       , Dd          , Dd          , Dd          , Dd^Vdt      , Dd          , Dd          , Dd          , Hd          , Dd          , Dd          , Dd          , Dd          , Dd          , Dd          
Dd          ,Dd          , Dd          , Dd          , Dd          , Dd          , Dd          , Dd          , Dd          , Dd          , Hd          , Dd          , Hd          , Hd          , Hd          , Dd          , Dd          , Dd          , Dd          , Dd          , Dd          , Dd          , Dd          , Dd          , Dd          , Dd          , Dd          , Dd          
Dd          ,Dd          , Dd          , Dd          , Dd          , Dd          , Dd          , Dd          , Dd          , Dd          , Hd          , Hd          , Hd          , Dd^Vdt      , Hd          , Dd          , Dd          , Dd          , Dd          , Dd          , Dd^Cd       , Dd          , Dd          , Dd          , Dd          , Dd          , Dd          , Dd          
Dd          ,Dd          , Dd          , Dd          , Dd          , Dd          , Dd          , Dd          , Dd          , Dd          , Dd          , Hd          , Hd          , Hd          , Dd          , Dd          , Hd          , Hd          , Dd          , Dd          , Dd^Cd       , Dd^Cd       , Dd^Cd       , Dd          , Dd          , Dd          , Dd          , Dd          
Hd          ,Hd          , Hd          , Dd          , Dd          , Dd          , Dd          , Dd          , Dd          , Dd          , Dd          , Hd          , Dd          , Hd          , Dd          , Dd          , Dd          , Hd          , Dd          , Dd          , Dd^Cd       , 2 Dd^Kd     , Dd          , Dd          , Hd          , Hd          , Dd          , Dd          
Hd          ,Hd          , Hd          , Hd          , Hd          , Dd          , Dd          , Dd          , Dd          , Dd          , Dd          , Dd          , Dd          , Dd          , Dd          , Dd          , Dd          , Dd          , Dd          , Dd          , Dd          , Dd          , Dd          , Dd          , Dd          , Hd          , Dd          , Dd          
Hd          ,Hd          , Hd          , Hd          , Hd          , Dd          , Dd          , Dd          , Dd          , Dd          , Dd          , Dd          , Dd          , Dd          , Dd          , Dd          , Dd          , Dd          , Dd          , Dd          , Dd          , Dd          , Dd          , Dd          , Dd          , Dd          , Dd          , Dd          
Hd          ,Hd          , Hd          , Hd          , Hd          , Dd          , Dd          , Dd          , Dd          , Dd          , Dd          , Dd          , Dd          , Dd          , Dd          , Dd          , Dd          , Dd          , Dd          , Dd          , Dd          , Dd          , Dd          , Dd          , Dd          , Dd          , Dd          , Dd          
