WWWWWWWWWWWWWWWWWWWW
WWWWWWWWWWWWWWWWWWWW
WWWWWWWWWWWWWWWWWWWW
WWWWWWWWWWWWWWWWWWWW
WWWWWWWoooooWWWWWWWW
WWWWWWWoo2ooWWWWWWWW
WWWWWWWoooooWWWWWWWW
WWWWWWoooooooWWWWWWW
WWWWWoooo1ooooWWWWWW
WWWWoooooRoooooWWWWW
WWWWoooooRoooooWWWWW
WWWWWooooRooooWWWWWW
WWWWWWoooRoooWWWWWWW
WWWWWWWWoRoWWWWWWWWW
WWWWWWWWWuWWWWWWWWWW
WWWWWWWWWuWWWWWWWWWW
WWWWWWWWWuWWWWWWWWWW
WWWWWWWWWuWWWWWWWWWW
WWWWWWWWWuWWWWWWWWWW
WWWWWWWWWuWWWWWWWWWW
