border_size=1
usage=map

Gs^Fds      , Gs^Fds      , Gs^Fds      , Gs^Fds      , Re^Gvs      , Gs^Fds      , Gs^Fds      , Ce          , Gg          , Rr          , Gg          , Ce          , Gs^Fds      , Gs^Fds      , Gs^Fds      , Gs^Fds      , Gs^Fds      , Gs^Fds      , Gs^Fds      , Gs^Fds      , Gs^Fds      , Gs^Fds      
Gs^Fds      , Gs^Fds      , Gs^Fds      , Gs^Fds      , Re^Gvs      , Gs^Fds      , Gs^Fds      , Ce          , Gg^Vh       , Rr          , Gg^Vh       , Ce          , Gs^Fds      , Gs^Fds      , Gs^Fds      , Gs^Fds      , Gs^Fds      , Gs^Fds      , Gs^Fds      , Gs^Fds      , Gs^Fds      , Gs^Fds      
Gs^Fds      , Gs^Fds      , Re^Gvs      , Re^Gvs      , Re^Gvs      , Gs          , Re^Gvs      , Ce          , Ce          , Rr          , Ce          , Ce          , Gs^Fds      , Gs^Fds      , Gs^Fds      , Gs^Fds      , Gs^Fds      , Gs^Fds      , Gs^Fds      , Gs^Fds      , Gg          , Gg          
Gg          , Gs          , Re^Gvs      , Gs^Fds      , Re^Gvs      , Gs^Fds      , Re^Gvs      , Gs^Fds      , Gs          , Rr          , Gs          , Gs          , Gs          , Gs^Fds      , Gg          , Gs^Fds      , Gs^Fds      , Gs^Fds      , Gs^Fds      , Gg          , Gs^Fds      , Gs^Fds      
Gg          , Gs          , Re^Gvs      , Re^Gvs      , Re^Gvs      , Re^Gvs      , Gs^Fds      , Gs^Fds      , Re          , Re          , Gg          , Gg          , Gg          , Gg          , Gg          , Gg          , Gs^Fds      , Gs^Fds      , Gg          , Gs^Fds      , Gs^Fms      , Gs^Fds      
Gg          , Gs          , Gs^Fds      , Gs^Fds      , Re^Gvs      , Gs^Fds      , Gs          , Gs          , Re          , Gg          , Gs^Fds      , Gs^Fds      , Gg          , Gs^Fds      , Gs^Fds      , Gs^Fds      , Gs^Fms      , Gs^Fds      , Gs^Fms      , Gs^Fds      , Gs^Fms      , Gs^Fms      
Gs^Fds      , Gs^Fds      , Re^Gvs      , Re^Gvs      , Gs^Fds      , Gs^Fds      , Re          , Re          , Gg          , Gg          , Gg          , Gs^Fds      , Gs^Fds      , Gs^Fds      , Gs^Fds      , Gs^Fds      , Gs^Fms      , Gs^Fms      , Gs^Fds      , Gs^Fms      , Gs^Fms      , Gs^Fms      
Gs^Fms      , Gs^Fms      , Gs^Fms      , Gs^Fms      , Gs^Fms      , Re          , Gs^Fms      , Gs^Fms      , Gg          , Gg          , Gs^Fds      , Gs^Fds      , Gs^Fds      , Gs^Fds      , Gs^Fds      , Gg^Vh       , Gg          , Gs^Fms      , Gs^Fms      , Gs^Fms      , Gs^Fms      , Gs^Fms      
Gg          , Gg          , Gs^Fds      , Gs^Fds      , Gs^Fds      , Gs          , Gs          , Gs^Fms      , Gg          , Gs^Fds      , Gs^Fds      , Gs^Fds      , Gs^Fds      , Gs^Fds      , Gg          , Gs^Fds      , Gg          , Gg          , Gs^Fms      , Gs^Fms      , Gs^Fms      , Gs^Fms      
Gg          , Gg          , Gg          , Gs^Fms      , Gs^Fds      , Gs^Fms      , Gs^Fms      , Gs          , Re          , Gs^Fds      , Gs^Fds      , Gs^Fds      , Gs^Fds      , Gg          , Gg          , Gg          , Gs^Fms      , Gg          , Gg          , Gs^Fds      , Gg          , Gg          
Gg          , Gg          , Gg          , Gg          , Gg          , Gg          , Gs^Fms      , Gs^Fds      , Gs^Fds      , Re          , Gg          , Gs^Fds      , Gg^Vh       , Gs^Fds      , Gg          , Gs^Fds      , Gs^Fms      , Gs^Fp       , Gs^Fms      , Gg          , Gs^Fds      , Gs^Fds      
Gg          , Gg          , Gg          , Gg          , Gg          , Gg          , Gs^Fds      , Gs^Fds      , Gs^Fds      , Re          , Gg          , Gs^Fds      , Gs^Fds      , Gs^Fds      , Gg          , Gs^Fms      , Gs^Fms      , Gs^Fp       , Gs^Fp       , Gg^Vh       , Gs^Fms      , Gs^Fms      
Gg          , Gg          , Gs^Fms      , Gg          , Gs^Fds      , Gg          , Gg          , Gs^Fds      , Re          , Re          , Gg          , Gg          , Gg          , Gg          , Gg          , Gg          , Gs^Fp       , Gs^Fp       , Gs^Fp       , Gs^Fms      , Gg          , Gg          
Gs^Fp       , Gs^Fms      , Gs^Fp       , Gs^Fms      , Gs^Fms      , Gs^Fms      , Gg          , Gs          , Gs^Fds      , Gs^Fds      , Gs^Fms      , Gg          , Gg          , Gg          , Gg          , Gg          , Gg          , Gs^Fp       , Gs^Fp       , Gs^Fp       , Gg          , Gg          
Gs^Fp       , Gs^Fp       , Gs^Fp       , Gs^Fp       , Gs^Fms      , Gs^Fp       , Gg          , Re          , Re          , Gs^Fms      , Gs^Fms      , Gs^Fp       , Gg          , Gg          , Gg          , Gg          , Gs^Fp       , Gs^Fp       , Gs^Fp       , Gs^Fp       , Gg          , Gg          
Gg          , Gg          , Gg          , Gs^Fp       , Gg          , Gg^Vh       , Gs^Fp       , Gs^Fp       , Gs^Fp       , Re          , Gs^Fp       , Gs^Fp       , Gg          , Gg          , Gs^Fp       , Gs^Fp       , Gs^Fp       , Gs^Fp       , Gg          , Gg          , Gs          , Gs          
Gg          , Gg          , Gg          , Gg          , Gs^Fds      , Gs^Fds      , Gs^Fms      , Gs^Fp       , Gs^Fp       , Re          , Gg          , Gg          , Gg^Vh       , Gs^Fp       , Gs^Fp       , Gs^Fp       , Gs^Fp       , Gg          , Gg          , Gs          , Hh          , Hh          
Gg          , Gg          , Gg          , Gg          , Gs^Fms      , Gs^Fds      , Gs^Fms      , Gs^Fp       , Gg          , Re          , Gs^Fp       , Gs^Fp       , Gs^Fp       , Gs^Fp       , Gs^Fp       , Gs^Fp       , Gg          , Gg          , Gs          , Gs          , Gs          , Gs          
Gg          , Gg          , Gg          , Gg          , Gg          , Gs^Fp       , Gs^Fp       , Gs^Fp       , Gg          , Gs          , Gs^Fp       , Gs^Fp       , Gs^Fp       , Gs^Fp       , Gs^Fp       , Gs^Fp       , Gs          , Gs          , Gs          , Hh          , Hh          , Hh          
Gg          , Gg          , Gg          , Gg          , Gg          , Gs^Fp       , Gs^Fp       , Gs^Fp       , Gg          , Re          , Gg          , Gs^Fp       , Gg          , Gs^Fp       , Gg          , Gg          , Gs          , Hh          , Hh          , Hh          , Gs          , Gs          
Gg          , Gg          , Gg          , Gg          , Gs^Fp       , Gs^Fp       , Gs^Fp       , Gs^Fp       , Re          , Re          , Gs^Fp       , Gg          , Wo          , Gg          , Ds          , Ds          , Ds          , Gs          , Gs^Fp       , Gs          , Hh          , Hh          
Gs^Fp       , Gs^Fp       , Gs^Fp       , Gs^Fp       , Gs^Fp       , Gs^Fp       , Gs^Fp       , Gs^Fp       , Re          , Gs^Fp       , Gs^Vh       , Gg^Fp       , Gg^Fp       , Gg^Fp       , Gs^Fp       , Gs^Fp       , Gs^Fp       , Gs^Fp       , Hh          , Hh          , Hh          , Hh          
Gs^Fp       , Gs^Fp       , Gs^Fp       , Gs^Fp       , Gg^Fp       , Gs^Fp       , Gg^Fp       , Gs^Fp       , Gs          , Gs^Fp       , Gs^Fp       , Gs^Fp       , Gg^Fp       , Gs^Fp       , Gg^Fp       , Gg^Fp       , Gg^Fp       , Hh          , Hh          , Gs^Fp       , Hh          , Hh          
Gs^Fp       , Gs^Fp       , Gg^Fp       , Gg^Vh       , Ww          , Gg^Fp       , Ww          , Re          , Gg^Fp       , Gg^Fp       , Gg^Fp       , Gg^Fp       , Ww          , Gg^Fp       , Ww          , Ww          , Ww          , Gg^Fp       , Hh          , Gg^Fp       , Gg^Fp       , Gs^Fp       
Gg^Fp       , Gg^Fp       , Ww          , Ww          , Ww          , Ww          , Gg^Fp       , Ww^Bw|      , Ww          , Ww          , Ww          , Ww          , Gg^Fp       , Ww          , Ww          , Ww          , Ww          , Ww          , Ww          , Ww          , Ww          , Ww          
Ww          , Ww          , Ww          , Ww          , Gg^Fp       , Gg^Fp       , Gs^Fp       , Re          , Re          , Gg^Fp       , Gs^Fp       , Gg^Fp       , Gs^Fp       , Gg^Fp       , Gg^Fp       , Ww          , Gg^Fp       , Ww          , Ww          , Ww          , Ww          , Ww          
Gg^Fp       , Gg^Fp       , Gg^Fp       , Gg^Fp       , Gs^Fp       , Gs^Fp       , Gs^Fp       , Gs^Fp       , Re          , Gs^Fp       , Gs^Fp       , Gs^Fp       , Gs^Fp       , Gs^Fp       , Gs^Fp       , Gg^Fp       , Hh          , Hh          , Gg          , Gg^Fds      , Hh          , Hh          
Gs^Fp       , Gs^Fp       , Gs^Fp       , Gs^Fp       , Gs^Fp       , Gs^Fp       , Gs^Vh       , Gs^Fp       , Gs^Fp       , Re          , Gs          , Gs^Fp       , Gs^Fp       , Gs^Fp       , Gs^Fp       , Gs^Fp       , Hh          , Hh          , Hh^Fds      , Hh          , Hhd^Fdw     , Hhd^Fds     
Gs^Fp       , Gs^Fp       , Gs^Fp       , Gs^Fp       , Gs^Fp       , Gs^Fp       , Gs^Fp       , Wo          , Gs^Fp       , Re          , Re          , Gs^Fp       , Gs^Fp       , Gs^Fp       , Gs^Fp       , Hh          , Hh          , Hh          , Hhd         , 2 Hhd       , Hhd^Fds     , Hhd^Fds     
Gs^Fp       , Gs^Fp       , Gs^Vh       , Gs^Fp       , 1 Re        , Gs^Fp       , Re          , Gs^Fp       , Re          , Re          , Gs^Fp       , Gs^Fp       , Gs^Fp       , Gs^Fms      , Hh          , Hh          , Hh^Fds      , Hh^Fds      , Gs^Fds      , Hhd^Fdw     , Hhd         , Hhd         
Gs^Fp       , Gs^Fp       , Gs          , Re          , Gs^Fp       , Re          , Gs^Fp       , Re          , Gs^Fp       , Gs^Fp       , Gs^Fp       , Gs^Fms      , Gs^Fms      , Gs^Fms      , Hh          , Hh          , Gs^Fds      , Hh          , Hh^Fds      , Hhd         , Hhd^Fms     , Hhd^Fdw     
Gs^Fp       , Gs^Fp       , Gs          , Gs          , Gs^Fp       , Re          , Gs^Fp       , Re          , Gs^Fp       , Gs^Fms      , Gs^Fms      , Gs^Fds      , Gs^Fds      , Gs^Fds      , Hh          , Hh          , Gs^Fds      , Hh          , Hh^Fds      , Hh          , Hh^Fms      , Hh^Fms      
