Gs^Fp       , Gg          , Gs^Fp       , Gs^Fp       , Hh          , Gg          , Hh          , Hh          , Gs^Fp       , Hh          , Hh          , Hh          , Gg          , Hh          , Gg          , Gg          , Ss          , Gg          , Ss          , Re^Gvs      , Gg          , Re^Gvs      , Re^Gvs      , Re^Gvs      , Gg          , Re^Gvs      , Gg          , Ce          , Gs^Fp       , Ce          , Gs^Fp       , Gg          , Gs^Fp       , Gg          , Gs^Fp       , Gg          , Hh          , Gs^Fp       , Hh          , Hh          
Hh          , Ss          , Ww          , Ww          , Ss          , Ss          , Gs^Fp       , Gs^Fp       , Gs^Fp       , Gs^Fp       , Gs^Fp       , Gg          , Hh          , Gg          , Gg          , Gs^Fp       , Gg          , Gg          , Re^Gvs      , Ce          , Re^Gvs      , Ce          , Re^Gvs      , Re^Gvs      , Re^Gvs      , Rr          , Gg          , Gg          , Ce          , Rr          , Ce          , Ce          , Ce          , Ce          , Ce          , Ce          , Gg          , Gg          , Gs^Fp       , Hh          
Ss          , Ss          , Ss          , Ww          , Ww          , Ww          , Gg          , Ww          , Ss          , Gg          , Gs^Fp       , Gs^Fp       , Hh          , Gg          , Gg          , Ww          , Gs^Fp       , Ce          , Ce          , Re^Gvs      , Ce          , Gg^Vh       , Rr          , Gg          , Gg^Vh       , Rr          , Gg          , Gs^Fp       , Gg          , Gs^Fp       , Rr          , Rr          , Gg^Vh       , Rr          , Gs^Fp       , Rr          , Ce          , Ce          , Gg          , Gg          
Ww          , Ww          , Ww          , Ww          , Ww          , Ww          , Ww          , Ww          , Ww          , Ww          , Ww          , Ww          , Gs^Fp       , Ww          , Ww          , Gg          , Gg          , Ce          , Re^Gvs      , Re^Gvs      , Re^Gvs      , Gg          , Rr          , Gg          , Gg          , Rr          , Rr          , Rr          , Gg^Vh       , Rr          , Rr          , Gg          , Rr          , Gg          , Rr          , Gg^Vh       , Gs^Fp       , Re^Gvs      , Re^Gvs      , Gg          
Ww          , Ss          , Ww          , Ww          , Ss          , Ss          , Ww          , Ww          , Ww          , Ww^Bw\      , Ww          , Ss          , Ww          , Gg          , Gg          , Gs^Fp       , Gs^Fp       , Ce          , Re^Gvs      , Gg          , Gg          , Rr          , Rr          , Gg          , Gg          , Rr          , Gg          , Gg          , Rr          , Gg          , Gg          , Rr          , Rr          , Gg          , Gg          , Rr          , Re^Gvs      , Re^Gvs      , Re^Gvs      , Gs^Fp       
Ww          , Ww          , Ss          , Gg          , Ss          , Ss          , Ss          , Ww          , Ww          , Ss          , Gg          , Ww^Bw\      , Ss          , Gg          , Gg^Vh       , Gg          , Gg          , Rr          , Ce          , Rr          , Gg          , Rr          , Gg          , Gg          , Gg^Vh       , Rr          , Gg          , Gg          , Gg          , Gg          , Rr          , Gg          , Gg          , Chr         , Gg          , Rr          , Gg          , Gs^Fp       , Ce          , Ce          
Ss          , Gg          , Gg          , Gg          , Gg          , Gg          , Gg          , Ww          , Ss          , Gs^Fp       , Gs^Fp       , Gs^Fp       , Gg          , Gg          , Ww          , Re          , Re          , Rr          , Rr          , Rr          , Rr          , Rr          , Rr          , Rr          , Rr          , Gg^Fet      , Rr          , Rr          , Gg          , Rr          , Rr          , Gg          , Ch          , 1 Kh        , Rr          , Gg          , Gg^Vh       , Gg          , Gg          , Gs^Fp       
Gg          , Gg          , Gg          , Gs^Fp       , Gg          , Gg^Vh       , Ce          , Ss          , Ww          , Ss          , Gs^Fp       , Gg          , Gg          , Re          , Re          , Gg          , Re          , Gs^Fp       , Ce          , Gg          , Gg          , Rr          , Gg          , Gg          , Rr          , Rr          , Rr          , Gg          , Rr          , Gg          , Rr          , Rr          , Rr          , Chr         , Chr         , Gg          , Gg          , Gg          , Ce          , Gs^Fp       
Gg          , Gg          , Gs^Fp       , Gg          , Gg          , Gg          , Ke          , Re          , Ww          , Ww^Bw/      , Re          , Re          , Re          , Gg          , Gg          , Gg          , Gg          , Gs^Fp       , Ce          , Gg          , Gg          , Rr          , Gg          , Gs^Fp       , Gg          , Rr          , Gg          , Gg          , Gg          , Gg          , Gg          , Rr          , Gg          , Gg          , Gg          , Gg          , Gg          , Gg          , Ce          , Gg          
Gg          , Gs^Fp       , Gg          , Gs^Fp       , Gg          , Re          , Re          , Ce          , Re          , Ww          , Ww          , Gg          , Gg          , Gs^Fp       , Gs^Fp       , Gs^Fp       , Gs^Fp       , Gs^Fp       , Gg          , Gs^Fp       , Gg          , Re^Gvs      , Rr          , Rr          , Gg          , Rr          , Gg^Vh       , Gg          , Gs^Fp       , Gg          , Rr          , Gg          , Rr          , Gg^Vh       , Gg          , Gs^Fp       , Gg          , Ce          , Ce          , Gg          
Gs^Fp       , Gg          , Gg          , Gs^Fp       , Re          , Gs^Fp       , Ce          , Gg          , Gs^Fp       , Gg^Vh       , Ww          , Ww          , Gs^Fp       , Gs^Fp       , Gg          , Gg          , Gg          , Ce          , Gg          , Gg          , Re^Gvs      , Re^Gvs      , Gg^Vh       , Rr          , Gg          , Gg          , Rr          , Rr          , Rr          , Rr          , Rr          , Gg^Vh       , Gg          , Re^Gvs      , Gg          , Re^Gvs      , Gg          , Gg          , Gg          , Gg          
Gs^Fp       , Gg          , Gs^Fp       , 2 Re        , Re          , Gg          , Gs^Fp       , Gs^Fp       , Gs^Fp       , Gg          , Gs^Fp       , Gg          , Ww          , Gg          , Gg^Vh       , Gs^Fp       , Gg          , Ce          , Gg          , Gg          , Re^Gvs      , Re^Gvs      , Gg          , Ce          , Gg^Vh       , Gg          , Rr          , Gg^Vh       , Gs^Fp       , Gg          , Rr          , Re^Gvs      , Re^Gvs      , Re^Gvs      , Re^Gvs      , Ce          , Gg          , Re^Gvs      , Re^Gvs      , Gs^Fp       
Gg          , Gg          , Gg          , Re          , Gg          , Gg          , Gs^Fp       , Gs^Fp       , Gg          , Gg          , Gs^Fp       , Gg          , Ww          , Ww          , Gs^Fp       , Gg          , Gg          , Gs^Fp       , Ce          , Ce          , Re^Gvs      , Gg          , Gg          , Ce          , Gg          , Gg          , Rr          , Gg          , Gg          , Gg          , Rr          , Re^Gvs      , Re^Gvs      , Re^Gvs      , Gg^Vh       , Ce          , Re^Gvs      , Re^Gvs      , Gs^Fp       , Hh          
Gs^Fp       , Gs^Fp       , Gg          , Re          , Gg          , Gs^Fp       , Gs^Fp       , Gs^Fp       , Gg          , Gs^Fp       , Gg          , Gs^Fp       , Gg          , Gs^Fp       , Ww          , Ww          , Gg          , Gs^Fp       , Gs^Fp       , Gs^Fp       , Gg          , Ss          , Gg          , Gg          , Ce          , Ce          , Gg          , Ce          , Gg          , Ce          , Rr          , Gg          , Re^Gvs      , Ce          , Ce          , Gg          , Re^Gvs      , Gs^Fp       , Gs^Fp       , Ww          
Gg          , Gg          , Gg          , Re          , Gg          , Gg          , Gg          , Gg          , Gg          , Gg          , Gg          , Gg          , Gs^Fp       , Gg          , Gg          , Gs^Fp       , Gs^Fp       , Ww          , Ww          , Ww          , Ww          , Ww          , Ss          , Gs^Fp       , Gg          , Gs^Fp       , Ce          , Gs^Fp       , Ce          , Gs^Fp       , Gg          , Gs^Fp       , Gg          , Gg          , Gg          , Gs^Fp       , Gs^Fp       , Hh          , Hh          , Ww          
