border_size=1
usage=map

Gg, Gg, Gg, Gg, Gg, Gg, Gg, Gg, Gg, Gg, Gg, Gg, Gll^Fp, Gll^Fp, Gll^Fp, Gll^Fp, Gll^Fp, Gll^Fp, Gg, Ww, Ww, Ww, Ww, Ww, Gll^Fp, Gll^Fp, Gg, Gg, Gg, Gg, Gg, Gg, Hh, Hh, Mm, Mm, Mm, Mm, Re, Re
Gg, Gg, Gg, Gg, Gg, Gg, Gg, Gg, Gg, Gg, Gg, Gg, Gll^Fp, Gll^Fp, Gll^Fp, Gll^Fp, Gll^Fp, Gll^Fp, Gg, Ww, Ww, Ww, Ww, Ww, Gg^Ve, Gll^Fp, Gg, Gg, Gg, Gg, Gs, Gg, Hh, Hh, Mm, Mm, Re, Re, Ce, Mm
Gg, Gg, Gg, Gg, Gg, Gg, Gg, Gg, Ce, Ce, Ce, Gg, Gll^Fp, Gll^Fp, Gll^Fp, Gll^Fp, Gll^Fp, Gll^Fp, Gll^Fp, Gg, Ww, Ww, Ww, Gll^Fp, Gll^Fp, Gll^Fp, Gg, Gg, Gs, Gs, Gs, Gs, Gs, Hh, Re, Re, Ce, Ce, 1 Ke, Hh
Gg, Gg, Gg, Gg, Gg, Gg, Gg, Gg, Gg, Gg, Gg, Ce, Gg, Gll^Fp, Gll^Fp, Gll^Fp, Gll^Fp, Gll^Fp, Gg, Gg, Gg, Ww, Ww, Gll^Fp, Gg, Gs, Gg, Gs, Gs, Gs, Gll^Fp, Gs, Gs, Gs, Re, Hh, Hh, Ce, Hh, Hh
Rr, Rr, Rr, Rr, Rr, Gg, Ce, Ce, Ce, Gg, Gg^Ve, Ce, Gg, Gll^Fp, Gll^Fp, Gll^Fp, Gg, Gll^Fp, Gll^Fp, Gg, Gg, Wwf, Wwf, Gg, Gg, Gg, Gs, Gll^Fp, Gg, Gll^Fp, Gs, Gs, Gs, Gs, Re, Hh, Gs, Hh, Mm, Mm
Gg, Gg, Gg, Ce, Gg, Rr, Ce, 6 Ke, Ce, Gg, Ce, Ce, Gg, Gg, Gg, Gg, Gg, Gg, Gg, Gg, Re^Gvs, Wwf, Wwf, Gg, Gg, Gll^Fp, Gll^Fp, Gll^Fp, Gll^Fp, Gll^Fp, Gs, Gs, Gs, Re, Gs, Gs, Gs, Hh, Hh^Vo, Mm
Gg, Gg, Gg, Ce, Gg, Rr, Rr, Ce, Gg, Gg, Gll^Fp, Gg, Gll^Fp, Gg, Gg, Gg, Re^Gvs, Re^Gvs, Re^Gvs, Re^Gvs, Re^Gvs, Ww, Ww, Gg, Gg, Gll^Fp, Gll^Fp, Gg, Gll^Fp, Gs, Gll^Fp, Gs, Gs, Re, Gs, Gs, Hh, Mm, Mm, Mm
Gg, Gg, Gg, Ce, Ce, Gg^Vo, Rr, Gg, Gg, Gg, Gg, Gll^Fp, Gll^Fp, Gll^Fp, Gll^Fp, Gll^Fp, Gg, Re^Gvs, Re^Gvs, Re^Gvs, Gg, Ww, Ww, Gg, Gg, Gg, Gg, Gll^Fp, Gll^Fp, Gg^Ve, Gs, Gs, Re, Re, Gg, Gs, Gs, Hh, Hh, Hh
Gg, Gg, Gg, Gg, Gg, Ce, Rr, Re^Gvs, Re^Gvs, Re^Gvs, Gg, Gg, Gg, Gg, Gg, Gg, Re^Gvs, Gg, Gg, Gg, Re^Gvs, Ww, Rb^Gvs, Rb^Gvs, Rb^Gvs, Gg, Gg, Gg, Gg, Gll^Fp, Ce, Ce, Ce, Gg, Gg, Gg, Gg, Hh, Hh, Hh
Gll^Fp, Gll^Fp, Gll^Fp, Gg, Gg, Gg, Re^Gvs, Rr, Re^Gvs, Re^Gvs, Rr, Re^Gvs, Re^Gvs, Re^Gvs, Gg, Gg, Re^Gvs, Re^Gvs, Re^Gvs, Re^Gvs, Re^Gvs, Ww, Ww, Rb^Gvs, Rb^Gvs, Rb^Gvs, Rb^Gvs, Re^Gvs, Rb, Rb, Ce, 5 Kea, Ce, Gg, Gg, Gg, Gg, Hh, Hh, Hh
Gll^Fp, Gll^Fp, Gg, Gg, Re^Gvs, Gg, Gg, Rr, Rr, Rr, Gll^Fp, Rr, Re^Vo, Re^Gvs, Rr, Gg, Rr, Re^Gvs, Re^Gvs, Re^Gvs, Ww, Ww, Ss, Ww, Rb^Gvs, Rb^Gvs, Rb, Rb, Rb^Gvs, Hh, Hh, Ce, Gg, Gg, Re^Gvs, Gg, Hh^Vo, Gg, Hh, Hh
Gll^Fp, Gll^Fp, Gll^Fp, Gg, Re^Gvs, Re^Gvs, Re^Gvs, Gg, Gll^Fp, Gll^Fp, Gll^Fp, Rr, Rr, Rr, Gg, Rr, Gg, Rr, Rr, Ww, Ss, Ss, Co, Ww, Wwf, Rb, Rb^Gvs, Rb^Gvs, Rb^Gvs, Hh, Gg, Hh, Gg, Gg, Re^Gvs, Hh, Hh, Hh, Hh, Hh
Gll^Fp, Gll^Fp, Gg, Re^Gvs, Re, Re^Gvs, Re^Gvs, Gg, Re, Gll^Fp, Gg, Re^Gvs, Re^Gvs, Re^Gvs, Gg, Gg, Re^Gvs, Re^Gvs, Re^Gvs, Ww^Bw\, Rb, Co, Co, Co, Wwf, Rb^Gvs, Rb^Gvs, Rb^Gvs, Gg, Gg, Gg, Gg, Rb^Gvs, Rb^Gvs, Rb^Gvs, Hh, Hh, Hh, Hh, Hh
Re, Re, Re, Re, Re, Re, Re, Re, Re^Gvs, Re, Re, Gg, Gg, Gg, Re^Gvs, Re^Gvs, Re^Gvs, Re^Gvs, Ww, Ww, Hh^Vo, Co, Hh, Co, Ww, Rb^Gvs, Rb^Gvs, Rb^Gvs, Rb^Gvs, Rb^Gvs, Rb^Gvs, Rb^Gvs, Rb^Gvs, Rb^Gvs, Re, Hh, Gs, Hh, Hh, Hh
Re, Re, Re, Re, Re^Gvs, Re^Gvs, Gll^Fp, Re^Gvs, Gll^Fp, Gll^Fp, Re, Re, Re, Re^Gvs, Re^Gvs, Re^Gvs, Ww, Ww, Co, Co, Co, Co, Hh, 3 Ko, Co, Ww, Ww, Rb^Gvs, Ww, Rb^Gvs, Rb^Gvs, Rb^Gvs, Re, Re, Re^Gvs, Re^Gvs, Re^Gvs, Gs, Hh, Hh
Gll^Fp, Gll^Fp, Gll^Fp, Re^Gvs, Gg, Gg, Gll^Fp, Gll^Fp, Re, Re, Re, Gg, Re^Gvs, Re, Re, Wwf, Wwf, Rb, Co, Co, Co, Hh^Vo, Hh^Vo, Hh, Co, Co, Hh^Vo, Ww, Rb^Gvs, Ww, Ww, Rb^Gvs, Wwf, Re^Gvs, Re^Gvs, Re^Gvs, Gs, Gs, Hh, Hh
Gll^Fp, Gll^Fp, Gll^Fp, Gll^Fp, Gg, Gg, Re, Re, Gg, Gg, Gg, Gll^Fp, Gll^Fp, Re^Gvs, Re, Wwf, Ww, Hh, Hh, Ko, Co, Hh, Co, Co, Co, Co, Hh, Rb^Gvs, Rb^Gvs, Rb^Gvs, Rb, Wwf, Re, Ww, Ww, Gg, Hh, Hh, Wo, Wo
Gll^Fp, Gll^Fp, Gg, Gg, Re, Re, Gg, Gg, Gll^Fp, Gg, Gll^Fp, Gll^Fp, Gll^Fp, Re^Gvs, Re, Ww, Ww, Ss, Hh, Rb^Gvs, Hh, Co, Hh, Co, Rb, Hh, Hh, Rb^Gvs, Rb, Rb, Rb^Gvs, Gg^Vo, Rb^Gvs, Rb^Gvs, Rb^Gvs, Ww, Wo, Wo, Rb, Rb
Gll^Fp, Gll^Fp, Gg, Re, Gg, Gg, Gll^Fp, Gll^Fp, Gll^Fp, Gll^Fp, Gll^Fp, Gll^Fp, Gg, Re^Gvs, Re, Ss, Ww, Ss, Ss, Rb^Gvs, Rb^Gvs, Rb^Gvs, Rb^Gvs, Rb^Gvs, Rb^Gvs, Rb, Rb, Rb, Rb^Gvs, Rb^Gvs, Rb^Gvs, Rb^Gvs, Rb, Rb^Gvs, Rb^Gvs, Rb^Gvs, Rb, Rb, Gg, Gg
Gg, Gg, Gg, Re, Gg, Gll^Fp, Gll^Fp, Gll^Fp, Gg, Gll^Fp, Gll^Fp, Gll^Fp, Re, Re, Ww, Ww, Gll^Fp, Ww, Ss, Rb^Gvs, Gll^Fp, Rb^Gvs, Rb^Gvs, Rb^Gvs, Rb^Gvs, Rb^Gvs, Rb^Gvs, Rb, Rb, Rb^Gvs, Rb, Rb, Rb^Gvs, Rb, Rb, Rb, Gg, Gg, Hh, Hh
Gll^Fp, Gll^Fp, Gg, Re, Re, Gg, Gg, Gg^Vo, Gg, Gg, Gg, Gg, Re, Gg, Ww, Gll^Fp, Gll^Fp, Ww, Ss, Gg, Gll^Fp, Rb^Gvs, Gll^Fp, Rb^Gvs, Gg, Rb^Gvs, Rb^Gvs, Rb^Gvs, Rb, Rb, Rb^Gvs, Rb^Gvs, Rb^Gvs, Rb, Rb^Gvs, Rb^Gvs, Gg, Gg, Hh, Hh
Gll^Fp, Gll^Fp, Gg, Gll^Fp, Re, Gg, Gll^Fp, Gg, Gll^Fp, Gll^Fp, Gll^Fp, Gg, Re, Gg, Ww, Gll^Fp, Gll^Fp, Ww, Ww, Gg, Gg, Gll^Fp, Gll^Fp, Gg, Gg, Gg, Rb^Gvs, Rb^Gvs, Rb, Rb^Gvs, Rb^Gvs, Rb^Gvs, Re^Gvs, Rb^Gvs, Gg, Rb^Gvs, Hh, Hh, Hh, Hh
Gll^Fp, Gll^Fp, Gll^Fp, Gll^Fp, Re, Gll^Fp, Gll^Fp, Gll^Fp, Gg, Gll^Fp, Gll^Fp, Gg^Vo, Re, Gg, Ww, Gll^Fp, Gll^Fp, Gll^Fp, Ww, Gg, Gg, Gll^Fp, Gg, Gg, Gg, Gg, Rb^Gvs, Rb^Gvs, Rb, Rb^Gvs, Re^Gvs, Re^Gvs, Re^Gvs, Re^Gvs, Re^Gvs, Gg, Hh, Hh, Hh, Hh
Gll^Fp, Gll^Fp, Gll^Fp, Gll^Fp, Re, Gll^Fp, Gll^Fp, Gg, Gll^Fp, Gg, Re, Re, Gg, Ww^Bw\, Gg, Gg, Gll^Fp, Gll^Fp, Ww, Gg, Gg, Gg, Gg, Gg, Gg^Vo, Rb^Gvs, Re^Gvs, Rb^Gvs, Re, Re, Re, Re, Re, Re^Gvs, Re^Gvs, Re^Gvs, Hh, Hh, Hh, Hh
Gll^Fp, Gll^Fp, Gll^Fp, Re, Gll^Fp, Gll^Fp, Gll^Fp, Gll^Fp, Gg, Re, Gg, Gg, Ww, Ww, Gg, Gg, Gg, Gll^Fp, Gg, Gg, Gg, Gg, Gll^Fp, Gll^Fp, Re^Gvs, Re^Gvs, Re, Re, Re^Gvs, Re^Gvs, Re^Gvs, Re^Gvs, Re^Gvs, Re, Hh, Hh, Hh, Hh, Mm, Mm
Ch, Ch, Ch, Re, Gll^Fp, Gll^Fp, Gll^Fp, Gll^Fp, Gll^Fp, Re, Gg, Ww, Ww, Gg, Gg, Gg, Gg, Gg, Gg, Gg, Gll^Fp, Gll^Fp, Gg, Gll^Fp, Re^Gvs, Re^Gvs, Re, Re^Gvs, Re^Gvs, Re^Gvs, Re^Gvs, Re^Gvs, Re^Gvs, Hh, Hh, Hh, Mm, Hh, Mm, Mm
Ch, Ch, 2 Kh, Ch, Re, Gll^Fp, Gll^Fp, Gll^Fp, Gll^Fp, Re, Gg, Ww, Gg, Gg, Gg, Gg, Gg, Gg^Ve, Gg, Gg, Gll^Fp, Gll^Fp, Gg, Gs, Ce, Re, Re, Re^Gvs, Ce, Gs, Gs, Gs, Gs, Hh, Hh, Mm, Mm, Mm, Mm, Mm
Ch, Ch, Gll^Fp, Gll^Fp, Gll^Fp, Re, Re, Re, Re, Re, Gg, Ww, Gg, Gll^Fp, Gll^Fp, Gg, Gg, Gg, Gg, Gg, Gg, Gg, Ce, Ce, Gs, Ce, Re, Ce, Hh, Ce, Ce, Gs, Hh, Hh, Hh, Hh, Hh, Mm, Mm, Mm
Ch, Ch, Gll^Fp, Gll^Fp, Gll^Fp, Gll^Fp, Gll^Fp, Gg, Gg, Gg, Gg, Ww, Ww, Gll^Fp, Gll^Fp, Gll^Fp, Gll^Fp, Gg, Gg, Gg, Gg, Gg, Ce, Gs, Re, Re, Ce, Gs, Hh, Hh, Ce, Hh, Hh, Hh, Hh, Hh, Hh, Hh, Mm, Mm
Gll^Fp, Gll^Fp, Gll^Fp, Gll^Fp, Gll^Fp, Gll^Fp, Gg^Ve, Gll^Fp, Gg, Gg, Ww, Ww, Gg, Gg, Gg, Gll^Fp, Gg, Gg, Gg, Gg, Gg, Gs, Ce, Gs^Vo, Re, Ce, 4 Ke, Ce, Gs, Hh^Vc, Ce, Hh, Hh, Hh, Mm, Mm^Vc, Mm, Mm, Mm, Mm
Gg, Gg^Ve, Gg, Gll^Fp, Gll^Fp, Gll^Fp, Gg, Gg, Gg, Gll^Fp, Ww, Ww, Gg, Gg, Gg, Gll^Fp, Gg, Gg, Gg, Gg, Gg, Gs, Re, Re, Gs, Ce, Ce, Ce, Hh, Hh, Hh, Hh, Mm, Mm, Mm, Mm, Mm, Mm, Mm, Mm
Gg, Gg, Gg, Gll^Fp, Gll^Fp, Gll^Fp, Gg, Gg, Gg, Gll^Fp, Ww, Ww, Gg, Gg, Gg, Gll^Fp, Gg, Gg, Gg, Gg, Gg, Gg, Re, Re, Gs, Ce, Ce, Ce, Hh, Hh, Hh, Hh, Mm, Mm, Mm, Mm, Mm, Mm, Mm, Mm
