Dd, Dd, Dd, Dd, Dd, Dd, Dd, Dd, Rd, Hd, Hd, Hd, Mdd, Mdd, Hd, Hd, Dd, Dd, Dd, Dd, Dd, Dd, Dd, Dd, Dd, Dd, Ds, Dd, Dd, Dd, Dd, Dd, Ds, Hd, Hd, Mdd, Mdd, Mdd, Mdd, Mdd
Dd, Dd, Ce, Dd, Dd, Dd, Rd, Dd, Dd, Hd, Hd, Hd, Mdd, Mdd, Hd, Hd, Dd, Dd, Dd, Dd, Dd, Dd, Hd, Dd, Dd, Dd, Ds, Dd, Dd, Dd, Dd, Dd, Ds, Hd, Hd, Mdd, Mdd, Mdd, Mdd, Mdd
Dd, Dd, 1 Ke, Ce, Hd, Dd, Dd, Dd, Hd, Hd, Dd, Hd, Hd, Hd, Dd, Dd, Dd, Dd, Ds, Dd, Dd, Dd, Hd, Dd, Dd, Ds, Dd, Ds, Ds, Dd, Dd, Ds, Dd, Dd, Hd, Hd, Hd, Mdd, Hd, Hd
Dd, Dd, Ce, Ce, Rd, Rd, Dd, Dd^Do, Dd, Dd, Dd, Dd, Dd, Dd, Dd, Dd, Dd, Dd, Ds, Ds, Dd, Hd, Dd, Dd, Dd, Dd, Hd, Ds, Dd, Ds, Ds, Ds, Dd, Dd, Hd, Hd, Ds, Hd, Hd, Hd
Dd, Ce, Dd, Ce, Rd, Dd, Dd, Hd, Dd, Dd, Dd, Dd, Dd, Dd, Ds, Ds, Ds, Ds, Dd, Ds, Rd, Dd, Dd, Dd, Dd, Hd, Ds, Ds, Dd, Dd, Dd, Dd, Dd, Dd, Hd, Ds, Ds, Hd, Hd, Hd
Dd, Dd, Dd, Rd, Dd, Dd, Hd, Dd, Dd, Dd, Dd, Dd, Dd, Dd, Dd, Ds, Ds, Dd, Dd, Rd, Dd, Dd, Dd, Dd, Dd^Do, Hd, Ds, Ds, Dd, Dd, Dd, Rd, Dd, Dd, Ds, Ds, Ds, Ds, Dd, Dd
Dd, Hd, Hd, Rd, Hd, Hd, Dd, Dd, Dd, Dd, Dd, Dd, Dd, Dd, Hd, Ds, Ds, Dd, Rd, Rd, Ds, Hd, Dd, Dd, Ww, Ww, Ww, Dd, Dd, Dd, Dd, Rd, Rd, Dd, Rd, Rd, Rd, Ds, Dd, Dd
Dd, Hd, Dd, Rd, Dd, Dd, Dd, Dd, Dd, Dd, Dd, Dd, Dd, Hd, Hd, Ds, Dd, Rd, Ds, Dd, Hd, Hd, Dd^Do, Ww, Wo, Wo, Ww, Dd, Hd, Hd, Dd, Ds, Ds, Rd, Ds, Ds, Ds, Rd, Dd, Dd
Dd, Dd, Dd, Rd, Rd, Dd, Dd^Vdt, Dd, Rd, Rd, Rd, Dd, Ds, Dd^Vdt, Hd, Dd, Dd, Dd, Ds, Dd, Hd, Hd, Hd, Ww, Ww, Ww, Dd^Do, Dd, Dd, Dd, Ds, Ds, Ds, Ds, Dd, Dd, Ds, Dd, Dd, Dd
Dd, Dd, Dd, Dd, Dd, Rd, Dd, Dd, Ds, Dd, Dd, Rd, Dd, Hd, Dd, Hd, Ds, Dd, Ds, Dd, Dd, Hd, Hd, Ww, Ww, Ww, Dd, Dd, Ds, Ds, Ds, Ds, Ds, Dd, Dd, Dd, Dd, Dd, Dd, Dd
Hd, Hd, Dd, Dd, Dd, Dd, Dd, Dd, Dd, Dd, Dd, Dd, Ds, Ds, Dd, Dd, Ds, Dd, Ds, Dd, Dd, Dd, Dd, Dd, Dd, Dd, Ds, Ds, Ds, Ds, Ds, Ds, Dd, Dd, Dd, Ds, Ds, Dd, Dd, Dd
Hd, Hd, Hd, Hd, Ds, Dd, Hd, Dd, Dd, Ds, Dd, Ds, Dd, Rd, Ds, Ds, Dd, Ds, Dd, Ds, Ds, Dd, Dd, Dd, Hd, Hd, Ds, Ds, Ds, Ds, Ds, Dd, Rd, Ds, Hd, Hd, Ds, Dd, Ds, Ds
Hd, Hd, Hd, Hd, Ds, Hd, Dd, Dd, Dd, Dd, Dd, Dd, Dd^Vdt, Rd, Dd, Dd, Dd, Dd, Dd, Ds, Ds, Dd, Dd, Dd, Ds, Dd, Dd, Ds, Ds, Ds, Rd, Rd, Dd, Dd, Ds, Ds, Dd, Dd, Dd, Dd
Hd, Hd, Ds, Dd, Dd, Dd, Dd, Dd, Dd, Dd, Dd, Dd, Hd, Rd, Rd, Dd, Dd, Dd, Dd, Ds, Dd, Dd, Dd, Ds, Ds, Dd, Dd, Ds, Ds, Ds, Rd, Ds, Ds, Ds, Ds, Ds, Dd, Dd, Hd, Hd
Hd, Hd, Hd, Ds, Ds, Dd, Dd, Ds, Dd, Dd, Hd, Hd, Dd, Dd, Dd, Dd, Dd, Dd, Ds, Ds, Ds, Dd, Dd, Ds, Ds, Dd, Dd, Dd, Rd, Rd, Dd, Dd, Dd, Dd, Dd, Ds, Dd, Ds, Hd, Hd
Hd, Hd, Dd, Dd, Dd, Dd, Dd, Dd, Dd, Dd, Dd, Hd, Dd, Dd, Dd^Vdt, Rd, Rd, Dd, Dd, Ds, Hd, Dd, Ds, Ds, Ds, Dd, Dd, Ds, Ds, Dd, Dd, Dd, Dd, Dd, Ds, Ds, Dd, Dd, Hd, Hd
Dd, Dd, Dd, Dd, Hd, Ds, Dd, Dd, Dd, Dd, Dd, Dd, Ds, Dd, Hd, Dd, Rd, Dd, Dd^Vdt, Hd, Hd, Dd, Ds, Ds, Ds, Ds, Dd, Ds, Dd, Dd, Hd, Hd, Dd, Ds, Ds, Dd, Dd, Hd, Dd, Dd
Dd, Dd, Dd, Hd, Hd, Dd, Dd, Dd, Dd, Dd, Ds, Ds, Hd, Hd, Dd, Dd, Ds, Ds, Hd, Hd, Dd, Dd, Dd, Ds, Ds, Rd, Ds, Ds, Dd, Dd, Dd, Dd, Ds, Ds, Ds, Dd, Dd, Dd, Ds, Ds
Dd, Dd, Dd, Dd, Dd, Ds, Dd, Rd, Dd, Dd^Vda, Dd, Hd, Dd, Hd, Dd, Dd, Ds, Ds, Dd, Dd, Dd, Dd, Dd, Dd, Ds, Rd, Rd, Dd, Dd, Dd, Dd, Dd, Dd, Ds, Ds, Dd, Dd, Dd, Ds, Ds
Dd, Dd, Dd, Dd, Dd, Ds, Rd, Rd, Dd, Dd, Dd, Dd, Dd, Dd, Ds, Dd, Rd, Rd, Rd, Rd, Rd, Dd, Dd, Dd, Dd, Ds, Dd, Rd, Rd, Dd, Dd, Dd, Ds, Ds, Ds, Dd, Ds, Dd, Gs, Gs
Hd, Hd, Dd, Dd, Dd, Ds, Rd, Dd, Dd, Dd, Ds, Dd, Ds, Ds, Ds, Ds, Rd, Ds, Ds, Dd, Dd, Ds, Ds, Dd, Ds, Dd, Ds, Ds, Rd, Dd, Dd, Ds, Ds, Ds, Ds, Dd, Ds, Gs, Gs^Vht, Gs
Hd, Hd, Hd, Hd, Ds, Dd, Rd, Dd, Hd, Hd, Dd, Ds, Dd, Ds, Ds, Ds, Dd, Ds, Dd, Dd, Dd, Dd, Gs, Gs, Gs, Ds, Ds, Ds, Dd, Dd, Ds, Ds, Gs, Ds, Gs, Ds, Ds, Gs, Gs, Gs
Hd, Hd, Hd, Dd, Dd, Ds, Rd, Dd, Dd, Dd, Dd, Dd, Dd, Dd, Dd, Dd, Dd, Dd, Dd, Dd, Ds, Ds, Ds, Gs^Vht, Gs, Ds, Ds, Dd, Ds, Ds, Gs, Gs, Gs, Gs, Gs, Gs, Ds, Ds, Ds, Ds
Hd, Hd, Dd, Dd, Ds, Ds, Dd, Rd, Rd, Dd, Ds, Dd, Ds, Dd, Ds, Ds, Ds, Ds, Ds, Ds, Ds, Ds, Dd, Dd, Dd, Gs, Ds, Ds, Gs, Gs, Gg, Gg, Ww, Ww, Ww, Gs, Gs, Ds, Ds, Ds
Hd, Hd, Dd, Ds, Hd, Ds, Ds, Dd, Dd, Ds, Dd, Ds, Ds, Ds, Ds, Ds, Ds, Ds, Ds, Ds, Ds, Ds, Dd, Dd, Dd, Ds, Ds, Gs, Gg, Gg, Gg^Vh, Ww, Wo, Wo, Ww, Gs, Ww, Gs, Gs, Gs
Hd, Hd, Dd^Do, Hd, Ds, Ds, Dd, Dd, Ds, Ds, Ds, Ds, Dd, Ds, Dd, Dd, Dd, Ds, Ds, Ds, Gs, Ds, Gs, Ds, Ds, Ds, Gs, Gs, Ww, Ww, Ww, Ww^Bw/, Wo, Wo, Wo, Ww, Ww, Gs, Gs, Gs
Hd, Hd, Hd, Hd, Dd, Dd, Dd, Ds, Ds, Ds, Ds, Ds, Dd, Ds, Hd, Hd, Dd, Ds, Ds, Ds, Gs, Gs, Ds, Gs, Ds, Ds, Gs, Gs, Ww^Bw\, Ww, Wo, Wo, Wo, Wo, Wo, Wo, Ww, Ww, Gs, Gs
Hd, Hd, Hd, Ds, Dd, Dd, Dd, Ds, Ds, Ds, Ds, Dd, Dd, Dd, Hd, Dd, Dd, Ds, Ds, Gs, Dd, Ds, Ds, Ds, Ds, Gs, Gg, Ww, Ww, Wo, Wo, Wo, Wo, Wo, Wo, Wo, Wo, Ww, Gs, Gs
Hd, Hd, Hd, Hd, Hd, Hd, Hd, Dd, Dd, Ds, Ds, Ds, Dd, Dd, Ds, Dd, Dd, Dd, Ds, Dd, Ds, Dd, Ds, Ds, Gs, Gs, Gg, Gg, Ww, Ww, Ww, Wo, Ww, Wo, Ww, Wo, Ww, Ww, Gg, Gg
Mdd, Mdd, Mdd, Hd, Hd, Mdd, Hd, Dd, Dd, Ds, Dd, Ds, Ds, Dd, Dd, Ds, Ds, Ds, Ds, Ds, Gs, Ds, Dd, Ds, Ch, Gg, Ch, Ww, Ww, Ww, Gg, Ww, Gg, Ww, Gg^Vhr, Ww, Ww, Ww, Gg, Gg
Mdd, Mdd, Mdd, Mdd, Mdd, Mdd, Mdd, Hd, Dd, Dd, Dd, Dd, Dd, Dd, Dd, Dd, Dd, Ds, Gs, Gs^Vht, Gs, Ds, Ds, Gs, Ch, 2 Kh, Ch, Gg, Gg, Gg, Gg^Vh, Gg, Gg, Gg, Gg, Gg, Gg, Gg, Gg, Gg
Mdd, Mdd, Mdd, Mdd, Mdd, Mdd, Mdd, Hd, Dd, Dd, Dd, Dd, Dd, Dd, Dd, Dd, Dd, Ds, Gs, Gs, Gs, Ds, Ds, Gs, Gg, Gg, Gg, Gg, Gg, Gg, Gg, Gg, Gg, Gg, Gg, Gg, Gg, Gg, Gg, Gg
