Gg, Gg, Gg, Gg, Gg, Gg, Gg, Gg, Gg, Gg, Gs^Fp, Gs^Fp, Gs^Fp, Gs^Fp, Gs^Fp, Gg, Re, Gg, Gg, Gg, Gg, Hh, Hh, Hh, Hh, Hh, Mm, Mm, Mm, Mm, Hh, Hh, Hh
Gg, Gg, Gg, Gg, Re^Gvs, Gg, Gg, Re^Gvs, Re^Gvs, Gg, Gg, Gs^Fp, Gs^Fp, Gs^Fp, Gg, Gg, Re, Gg, Re^Gvs, Gg, Gg, Hh, Hh, Hh, Hh, Hh, Mm, Mm, Mm, Mm, Hh, Hh, Hh
Gg, Gg, Gg, Re, Re^Gvs, Gg^Vh, Gg, Re^Gvs, Re^Gvs, Re^Gvs, Re^Gvs, Gg, Gg, Gg, Gg, Gg, Ce, Gg, Re^Gvs, Gg, Gs^Fp, Hh^Fp, Hh, Hh, Hh, Mm, Mm, Mm, Hh^Fp, Mm, Hh, Hh, Hh
Gg, Gg, Gg, Re, Re^Gvs, Re, Re^Gvs, Gg, Gg^Wm, Re^Gvs, Re^Gvs, Re^Gvs, Gg, Gg, Gg, Ce, 1 Ke, Ce, Re^Gvs, Gg, Hh, Hh, Hh, Hh, Hh^Fp, Hh, Hh, Hh^Fp, Hh^Fp, Hh, Hh, Hh, Hh
Gg, Gg, Gg, Re^Gvs, Gg, Gg, Re^Gvs, Re^Gvs, Gg, Gg, Gg, Re^Gvs, Re^Gvs, Gg, Gg, Ce, Ce, Ce, Re^Gvs, Gg, Hh, Hh, Hh, Hh^Fp, Hh^Fp, Hh^Fp, Hh, Hh, Hh, Hh, Hh, Hh, Gg
Gg, Gg, Gg, Gg, Gg, Gg, Re^Gvs, Re^Gvs, Gg, Re^Gvs, Re^Gvs, Gg, Gg, Re^Gvs, Gg, Gg, Re, Gg, Gg, Gg, Gg, Hh, Hh, Hh, Hh^Fp, Hh^Fp, Hh, Hh, Rr, Rr, Rr, Rr, Rr
Gg, Gg, Ce, Ce, Ce, Gg, Re^Gvs, Re^Gvs, Gg, Re^Gvs, Gg^Vh, Gg, Re^Gvs, Gg, Gg, Gg, Re, Gg^Vh, Re^Gvs, Re^Gvs, Re^Gvs, Gg, Gg, Gs^Fp, Gg, Gs^Fp, Rr, Rr, Ce, Ce, Ce, Gg, Gg
Gg, Gg, Ce, 2 Ke, Ce, Gg, Re^Gvs, Re, Gs^Fp, Re^Gvs, Re^Gvs, Gg, Re^Gvs, Re^Gvs, Gg, Gg, Re, Gg, Re^Gvs, Re^Gvs, Re^Gvs, Re, Gg, Re^Gvs, Re^Gvs, Gg, Rr, Gg, Ce, 3 Ke, Ce, Gg, Gg
Gg, Gg, Gg^Vh, Ce, Gg, Gg, Re^Gvs, Gs^Fp, Gs^Fp, Gs^Fp, Re^Gvs, Gg, Re^Gvs, Re^Gvs, Gg, Gg, Rr, Gg, Re^Gvs, Gs^Fp, Re^Gvs, Re^Gvs, Gg, Re^Gvs, Gg, Gg, Rr, Gg, Gg^Vh, Ce, Gg, Gg, Gg
Rr, Rr, Rr, Gg, Rr, Gg, Gg, Re^Gvs, Gg, Gs^Fp, Re^Gvs, Gg, Re^Gvs, Gs^Fp, Gs^Fp, Gg, Rr, Gg, Re^Gvs, Re^Gvs, Re^Gvs, Gg^Vh, Gg, Gg, Rr, Rr, Gg, Gg, Gg, Gg, Gg, Gg, Gg
Gg, Gg, Re, Rr, Gs^Fp, Rr, Rr, Gg, Gg, Re^Gvs, Re^Gvs, Gg, Re^Gvs, Gs^Fp, Gg, Gg, Rr, Gg, Re^Gvs, Re^Gvs, Re^Gvs, Gg, Rr, Rr, Gg, Gg, Re^Gvs, Gg, Ds, Gg, Ds, Ds, Ds
Gs^Fp, Gs^Fp, Re, Gs^Fp, Gs^Fp, Gs^Fp, Rr, Gg, Gg, Re^Gvs, Re^Gvs, Gg^Vh, Re^Gvs, Re^Gvs, Gg, Gg, Rr, Gg, Re^Gvs, Gg^Wm, Re^Gvs, Gg, Rr, Gg, Re^Gvs, Re^Gvs, Gs^Fp, Ds, Ww, Ds, Ww, Ww, Ww
Gs^Fp, Gs^Fp, Re, Gs^Fp, Gs^Fp, Gs^Fp, Re, Rr, Rr, Gg, Gg, Gg, Re^Gvs, Re^Gvs, Gg, Gg, Rr, Gg^Vh, Re^Gvs, Gg, Gg, Gg, Rr, Gs^Fp, Gs^Fp, Gs^Fp, Ds, Ds, Ww, Ww, Ww, Ww, Ww
Gs^Fp, Gs^Fp, Gs^Fp, Re, Re, Re, Gs^Fp, Gs^Fp, Gs^Fp, Rr, Rr, Gg, Gg, Gg, Gg, Gg, Rr, Gg, Gg, Gg, Rr, Rr, Gg, Gs^Fp, Ds, Ds, Ww, Ww, Ww, Ww, Ww, Ww, Ww
Gs^Fp, Gs^Fp, Gs^Fp, Gs^Fp, Re, Gs^Fp, Gs^Fp, Gs^Fp, Gs^Fp, Gg, Gg, Rr, Rr, Rr, Rr, Gg, Rr, Gg, Rr, Rr, Gg, Gg, Re^Gvs, Re^Gvs, Ds, Ww, Ww, Ww, Ww, Ww, Ww, Ww, Ww
Gs^Fp, Gs^Fp, Gs^Fp, Gs^Fp, Re, Gs^Fp, Gs^Fp, Gs^Fp, Re^Gvs, Gs^Fp, Re^Gvs, Gg, Gg, Gg, Gg, Rr, Rr, Rr, Gg, Gg, Re^Gvs, Re^Gvs, Gg, Ds, Ds, Ww, Ww, Ww, Ww, Ww, Ww, Ww, Ww
Re, Re, Re, Re, Gs^Fp, Re, Re, Gs^Fp, Gs^Fp, Re^Gvs, Re^Gvs, Re^Gvs, Gg, Gg, Rr, Rr, Ch, Rr, Rr, Gg, Re^Gvs, Re^Gvs, Gg, Ds, Ww, Ww, Ww, Ww, Ww, Ww, Ww, Ww, Ww
Gs^Fp, Gs^Fp, Gs^Fp, Gs^Fp, Gs^Fp, Gs^Fp, Re, Gs^Fp, Gs^Fp, Re^Gvs, Re, Re^Gvs, Gg, Gg, Rr, Ch, 5 Kh, Ch, Rr, Gg^Vh, Gg, Gg, Ds, Ds, Ww, Ww, Ww, Ww, Ww, Ww, Ww, Ww, Ds
Gs^Fp, Gs^Fp, Gs^Fp, Gs^Fp, Gs^Fp, Gs^Fp, Gs^Fp, Re, Re, Re, Gg, Gg, Gg, Gg, Rr, Ch, Ch, Ch, Rr, Gg, Gg, Ds, Ds, Ww, Ds, Ww, Ds, Ww, Ds, Ww, Ds, Ds, Gs^Fp
Gs^Fp, Gs^Fp, Gs^Fp, Gs^Fp, Gs^Fp, Gs^Fp, Gs^Fp, Gs^Fp, Gg, Rr, Rr, Gg^Vh, Rr, Rr, Gg, Rr, Rr, Rr, Gg, Rr, Rr, Gg, Gg, Ds, Ds, Ds, Re^Gvs, Ds, Re^Gvs, Ds, Gs^Fp, Gs^Fp, Gs^Fp
Gg, Gg, Gg, Gg, Ch, Ch, Re^Gvs, Re^Gvs, Gg, Gg, Gg, Rr, Gg, Gg, Gg, Gg, Rr, Gg, Gg, Gg, Gg, Rr, Rr, Gg, Gg^Wm, Gg, Gg, Ch, Ch, Gg, Gg, Gg, Gg
Gg, Gg, Ch, Ch, Gg, Re^Gvs, Re^Gvs, Re^Gvs, Re^Gvs, Re^Gvs, Gg, Gg, Ww, Ww, Ww, Ww, Ww^Bw|, Ww, Ww, Ww, Ww, Gg, Gg, Rr, Gg, Gg, Re^Gvs, Re^Gvs, Re^Gvs, Ch, Ch, Gg, Gg
Gg, Gg, Ch, Gg, Re^Gvs, Re^Gvs, Gg, Re^Gvs, Gg, Gg, Ww, Ww, Ch, Kh, Ch, Ch, Rr, Ch, Ch, Kh, Ch, Ww, Ww, Gg, Gg, Re^Gvs, Re^Gvs, Re^Gvs, Re^Gvs, Re^Gvs, Ch, Gg, Gg
Gg, Gg, Ch, Re^Gvs, Gg, Gg, Gg, Gg, Gg, Ww, Ch, Ch, Gg, Rp^Vhc, Rr, Rr, Rr, Rr, Rr, Rp^Vhc, Gg, Ch, Ch, Ww, Gg, Gg, Gg, Gg, Gg, Gg, Ch, Gg, Gg
Gg, Gg, Ch, Gg, Gg, Gg^Vh, Gg, Gg, Gg, Ww, Ch, Rp^Vhc, Rr, Rr, Ch, Rp^Vhc, Ch, Rp^Vhc, Ch, Rr, Rr, Rp^Vhc, Ch, Ww, Gg, Gg, Gg, Gg^Vh, Gg, Gg, Ch, Gg, Gg
Re, Gg, Re, Gg, Re, Gg, Gg, Gg, Gg, Ww, Rr, Gg, Rr, Rr, Rr, Ch, 4 Kh, Ch, Rr, Rr, Rr, Gg, Rr, Ww, Gg, Gg, Gg, Gg, Re, Gg, Re, Gg, Re
Gg, Re, Ch, Re, Gg, Re, Re, Re, Re, Ww^Bw/, Ch, Rr, Rr, Rr, Ch, Ch, Ch, Ch, Ch, Rr, Rr, Rr, Ch, Ww^Bw\, Re, Re, Re, Re, Gg, Re, Ch, Re, Gg
Gg, Gg, Ch, Gg, Gg, Re, Gg, Gg, Gg, Ww, Ch, Gg, Rr, Rr, Rp^Vhc, Rr, Rr, Rr, Rp^Vhc, Rr, Rr, Gg, Ch, Ww, Gg, Gg, Gg, Re, Gg, Gg, Ch, Gg, Gg
Gg, Gg, Ch, Gg, Gg, Re, Gg, Gg^Vh, Gg, Ww, Ch, Rp^Vhc, Rr, Gg, Gg, Gg, Rr, Gg, Gg, Gg, Rr, Rp^Vhc, Ch, Ww, Gg, Gg, Gg^Vh, Re, Gg, Gg, Ch, Gg, Gg
Gg, Gg, Ch, Gg, Gg, Re, Gg, Gg, Gg, Ww, Ww, Ch, Ch, Kh, Ch, Ch, Rr, Ch, Ch, Kh, Ch, Ch, Ww, Ww, Gg, Gg, Gg, Re, Gg, Gg, Ch, Gg, Gg
Gg, Gg, Ch, Gg, Gg, Re, Gg, Gg, Gg, Gg, Gg, Ww, Ww, Ww, Ww, Ch, Ww^Bw|, Ch, Ww, Ww, Ww, Ww, Gg, Gg, Gg, Gg, Gg, Re, Gg, Gg, Ch, Gg, Gg
Gg, Gg, Ch, Gg, Gg, Re, Gg, Gg^Vh, Gg, Gg, Gg, Gg, Gg, Gg, Gg, Ww, Rr, Ww, Gg, Gg, Gg, Gg, Gg, Gg, Gg, Gg, Gg, Re, Gg, Gg, Ch, Gg, Gg
Gg, Gg, Ch, Gg, Gg, Re, Gg, Gg, Gg, Gg, Gg, Gg, Gg, Gg, Gg, Gg, Rr, Gg, Gg, Gg, Gg, Gg, Gg, Gg, Gg, Gg, Gg, Re, Gg, Gg, Ch, Gg, Gg
