Ai, Ai^Esa, Ai^Esa, Ai, Ms, Ms, Ms, Ms^Xm, Ms, Ms, Aa^Fpa, Aa^Fpa, Aa^Fpa, Aa^Fpa, Ha, Ha, Ha, Ha, Ha, Ai, Ai, Aa, Aa, Aa, Aa^Esa, Aa, Aa^Esa, Aa, Aa^Fpa, Aa^Fpa, Aa^Fpa, Aa^Fpa
Ai, Ai^Esa, Ai^Es, Ai, Ms, Ms, Ms^Xm, Ms^Xm, Ms, Ms, Aa^Fpa, Aa^Fpa, Ha^Fpa, Ha^Fpa, Ha, Ha, Ha, Ha, Ha, Ai, Ai, Aa^Esa, Aa^Esa, Aa, Aa, Aa^Esa, Aa, Aa^Esa, Aa^Fpa, Aa^Fpa, Aa^Fpa, Aa^Fpa
Ai, Ai, Ai^Esa, Ai^Esa, Ai, Ms, Ms^Xm, Ms, Ms, Aa^Fpa, Aa^Fpa, Aa^Fpa, Aa^Fpa, Ha^Fpa, Ha, Ha^Es, Coa, Coa, Coa, Coa^Esa, Ai, Aa^Esa, Aa^Esa, Aa, Aa, Aa^Vca, Aa^Fpa, Aa^Fpa, Aa^Fpa, Aa^Fpa, Aa^Fpa, Aa^Fpa
Ai^Esa, Ai^Esa, Ai, Ai, Ms, Ai, Ms^Xm, Ms, Ms, Ms, Ms, Aa, Aa^Es, Aa^Fpa, Ms, Coa, Coa^Esa, 4 Koa, Coa, Ai, Ai, Aa, Aa, Aa^Es, Aa, Aa, Coa, Aa^Fpa, Aa^Fpa, Aa^Fpa, Aa^Fpa, Aa^Fpa
Ai, Ai^Esa, Ms, Ms^Xm, Ms, Ai, Ai^Esa, Ms, Ms, Ms^Xm, Ms, Ms, Ms, Ha, Ha, Ha, Coa^Esa, Coa^Esa, Aa, Aa^Voa, Ai, Aa^Esa, Ha^Esa, Ha, Coa, Coa^Esa, Coa^Esa, Aa^Fpa, Aa^Fpa, Aa^Fpa, Aa^Fpa, Aa^Fpa
Ms, Ms, Ms^Xm, Ms, Ms, Ms^Xm, Ms, Ai^Esa, Ai, Ms, Ms, Ms, Ms, Ha, Ha^Es, Ha^Es, Aa^Fpa, Aa, Aa^Fpa, Ai, Ai, Aa^Esa, Ai, Aa, Aa, Coa^Esa, 5 Koa, Coa, Aa^Fpa, Aa^Fpa, Aa^Fpa, Aa^Fpa
Ms, Ms, Ms^Xm, Ms, Ms^Xm, Ms^Xm, Ms, Ms, Aa^Fpa, Ai, Ai, Ha^Vca, Ha, Ha, Ha^Fpa, Ha, Ha^Fpa, Aa^Fpa, Aa^Fpa, Aa, Aa^Fpa, Ai, Aa, Ai, Ai, Coa, Coa^Esa, Coa^Esa, Aa^Fpa, Aa^Fpa, Aa^Fpa, Aa^Fpa
Ms, Ms^Xm, Ms, Ms^Xm, Ms, Ms, Ms, Aa^Fpa, Aa^Fpa, Aa^Fpa, Ai, Aa^Fpa, Ha, Ha, Aa^Fpa, Aa^Fpa, Aa, Ha, Aa^Esa, Aa^Fpa, Aa^Fpa, Aa^Fpa, Aa^Fpa, Ha^Esa, Ms, Ai, Ai, Ai, Aa^Fpa, Aa^Fpa, Aa^Fpa, Aa^Fpa
Ms, Ms^Vhha, Ms, Ms, Aa^Esa, Aa^Esa, Aa^Fpa, Aa^Fpa, Aa^Fpa, Aa^Fpa, Aa^Fpa, Ai, Ha, Ha, Aa^Fpa, Ha^Vhha, Aa, Aa, Aa^Esa, Aa^Esa, Aa^Fpa, Aa^Fpa, Ha^Fpa, Ha^Fpa, Ha^Fpa, Ha^Esa, Ha, Ai, Ai, Aa^Fpa, Aa^Fpa, Aa^Fpa
Ms, Ms, Ms, Ms, Aa, Aa^Es, Aa^Fpa, Aa^Fpa, Ha^Fpa, Aa^Fpa, Aa^Fpa, Ai, Ai, Ai, Aa^Esa, Aa^Esa, Aa, Aa, Aa^Fpa, Aa^Fpa, Aa^Fpa, Aa^Fpa, Ha^Esa, Ha^Fpa, Ha^Esa, Ha^Esa, Ha^Voa, Ms, Ai^Esa, Aa^Fpa, Aa^Fpa, Aa^Fpa
Ms, Ms, Ms, Ms, Ms, Aa, Aa^Fpa, Ha^Fpa, Ha^Esa, Aa^Fpa, Aa^Fpa, Aa^Fpa, Ai, Aa^Fpa, Aa, Aa^Esa, Aa, Aa, Aa, Ha, Aa^Esa, Ha^Esa, Ha^Esa, Ha, Ha, Ha, Ms, Ms, Ai, Aa^Fpa, Aa^Fpa, Aa^Fpa
Ms, Ms, Coa, Ha, Ha, Ms, Ha^Esa, Ha, Ms, Ms, Aa^Esa, Aa^Fpa, Ai, Aa, Aa, Aa, Aa, Aa, Aa, Aa^Esa, Aa^Esa, Ha, Ms, Ms, Ms, Ms, Ms^Xm, Ms^Xm, Ms, Ai, Ms, Ms
Ha, Coa, 3 Koa, Coa, Ha, Ha^Esa, Ha, Ms, Ai, Ha^Esa, Ai, Ai, Aa^Esa, Aa^Esa, Aa^Esa, Aa, Aa, Aa^Esa, Aa^Esa, Aa, Ha^Esa, Ms, Ms, Ms^Xm, Ms, Ms^Xm, Ms, Ms, Ai^Esa, Ai, Ms, Ms^Xm
Ha, Coa, Coa^Esa, Coa, Ha, Ha, Ha^Voa, Ha, Ai^Esa, Ai^Esa, Ai^Esa, Aa, Aa, Aa^Esa, Aa, Aa, Aa, Aa^Esa, Ha, Ha^Es, Ha^Esa, Ms, Ms, Ms, Ms, Ms^Xm, Ms, Ai^Esa, Ms, Ms^Xm, Ms^Xm, Ms^Xm
Ha, Ha^Esa, Ha^Esa, Ha, Ai, Ha, Ai, Ai, Ai, Ai, Ai, Aa, Aa^Voa, Ha, Ha, Ha, Ha, Ha, Ha^Esa, Ha, Ha, Ms, Ms, Ms, Ms, Ms^Xm, Ms, Ai, Ms, Ms, Ms^Xm, Ms
Ha, Ha, Ai, Ai, Ha^Esa, Ai, Coa^Esa, Aa, Aa^Esa, Aa^Esa, Aa, Aa, Ha, Ha, Ha^Fpa, Ha^Es, Ha, Ha^Esa, Ha^Es, Ha, Ms, Ms, Ms^Xm, Ms, Ms^Xm, Ms^Xm, Ms, Ai, Ms, Ms, Ms^Xm, Ms
Ha, Ha, Ai, Ha^Esa, Aa^Esa, Coa^Esa, 1 Koa, Coa, Aa, Aa, Aa^Fpa, Aa^Fpa, Aa^Fpa, Aa^Fpa, Ha, Ha, Ha^Esa, Ha^Esa, Ha, Ha^Es, Ms, Ms, Ms, Ms, Ms^Xm, Ms, Ai^Esa, Ai^Esa, Ms, Ms^Xm, Ms^Xm, Ms^Xm
Ai, Ai, Aa, Aa, Aa, Coa, Coa, Coa, Aa^Fpa, Aa^Fpa, Ms, Ha, Coa, Coa, Coa, Ha, Aa^Fpa, Ha^Es, Ha^Es, Ms^Vhha, Ms, Ms, Ms, Ms^Xm, Ms, Ms, Ai, Ms, Ms, Ms, Ms^Xm, Ms^Xm
Ai, Ai, Aa^Esa, Aa^Voa, Aa, Aa^Esa, Aa^Fpa, Aa^Fpa, Aa^Fpa, Aa^Fpa, Ms, Ms, Coa, 2 Koa, Coa, Ha, Ms, Aa^Fpa, Ha^Fpa, Ha^Fpa, Ms, Ms^Xm, Ms^Xm, Ms^Xm, Ms, Ai, Ai, Ai, Ai^Esa, Ms, Ms^Xm, Ms^Xm
Ai, Ai, Aa, Aa^Es, Aa, Aa^Fpa, Aa^Fpa, Aa^Fpa, Aa^Fpa, Aa^Fpa, Ms, Ms, Ms^Xm, Coa, Ms, Aa^Fpa, Ms, Ms, Ha^Fpa, Ha^Fpa, Aa^Fpa, Ms, Ms, Ms^Xm, Ms, Ai^Esa, Ai^Esa, Ai, Ms, Ms, Ms^Xm, Ms^Xm
Aa, Aa, Aa^Esa, Aa^Esa, Aa^Fpa, Aa^Fpa, Aa^Fpa, Aa^Fpa, Ms, Ms^Xm, Ms, Ms, Ms, Ms, Ms^Xm, Ms, Ms, Aa^Fpa, Ha, Ha^Esa, Aa^Fpa, Ms, Ms^Xm, Ms^Xm, Ms, Ms, Ai, Ms, Ms^Xm, Ms^Xm, Ms^Xm, Ms^Xm
Aa, Aa^Esa, Aa^Esa, Aa, Aa^Fpa, Aa^Fpa, Aa^Fpa, Aa^Fpa, Ms, Ms, Ms, Ms, Ms, Ms, Ms, Ms, Ms, Aa^Fpa, Aa^Fpa, Ha^Esa, Aa^Fpa, Ms, Ms, Ms, Ms, Ms, Ai, Ms, Ms^Xm, Ms^Xm, Ms^Xm, Ms^Xm
