border_size=1
usage=map

Mm          , Mm          , Mm          , Mm          , Mm          , Mm          , Mm          , Mm          , Mm          , Mm          , Mm          , Mm          , Mm          , Ha          , Ha          , Ha          , Ha          , Mm          , Mm          , Mm          , Ha          , Ha          , Aa          , Aa          , Aa          , Aa          , Aa          , Aa          , Aa          , Aa          , Aa          , Aa          
Mm          , Mm          , Mm          , Mm          , Mm          , Mm          , Mm          , Mm          , Mm          , Mm          , Mm          , Mm          , Mm          , Ha          , Ha          , Ha          , Ha          , Mm          , Mm          , Mm          , Ha          , Ha          , Aa          , Aa          , Aa          , Aa          , Aa          , Aa          , Aa          , Aa          , Aa          , Aa          
Mm          , Mm          , Mm          , Mm          , Mm          , Mm          , Ha          , Mm          , Mm          , Mm          , Ha          , Ha          , Ha          , Ha          , Ha          , Ha          , Ha          , Ha          , Mm          , Ha          , Ha          , Aa          , Aa          , Aa          , Aa          , Aa          , Aa          , Aa          , Aa          , Aa          , Aa          , Aa          
Mm          , Mm          , Mm          , Mm          , Mm          , Mm          , Mm          , Ha          , Ha          , Mm          , Mm          , Ha          , Ha          , Ha          , Re^Vct      , Ch          , Ch          , Ha          , Ha          , Ha          , Ha          , Aa          , Aa          , Aa          , Aa          , Aa          , Aa          , Aa          , Aa^Voa      , Aa          , Aa          , Aa          
Mm^Xm       , Mm^Xm       , Mm^Xm       , Ha          , Mm          , 4 Mm        , Mm          , Ha          , Ha          , Ha          , Ha          , Ha          , Ha          , Re          , Ch          , 8 Kh        , Ch          , Re^Vct      , Ha          , Ha          , Aa^Vha      , Aa          , Aa^Fpa      , Aa^Fpa      , Aa          , Aa          , Aa          , Aa          , Aa          , Aa          , Aa^Fpa      , Aa^Fpa      
Mm          , Mm          , Mm          , Mm          , Mm          , Mm          , Mm          , Ha          , Ha          , Ha          , Ha          , Mm          , Mm          , Ha          , Ha          , Ch          , Ch          , Re          , Aa          , Ha          , Ha          , Aa          , Aa^Fpa      , Aa^Fpa      , Aa          , Aa          , Aa          , Aa          , Aa          , Aa          , Aa          , Aa          
Mm          , Mm          , Ha          , Mm          , Mm          , Mm          , Ha          , Ha          , Ha          , Ha          , Ha          , Ha          , Mm          , Ha          , Ha          , Re          , Re          , Aa          , Re^Vct      , Ha          , Aa          , Aa          , Aa^Fpa      , Aa^Fpa      , Aa          , Aa          , Aa          , Aa          , Aa          , Aa          , Aa^Fpa      , Aa^Fpa      
Mm          , Mm          , Mm          , Mm          , Ha          , Mm          , Ha          , Ha          , Ha          , Ha          , Aa          , Aa          , Ha          , Mm          , Ha          , Re^Vct      , Aa          , Re          , Re          , Aa          , Aa          , Aa          , Aa          , Aa^Fpa      , Aa^Fpa      , Aa          , Aa          , Aa          , Aa          , Aa          , Aa          , Aa          
Mm          , Mm          , Ha          , Ha          , Ha          , Ha          , Ha          , Ha          , Aa          , Ha          , Aa          , Ha          , Ha          , Ha          , Ha          , Ha          , Aa          , Aa          , Re          , Aa          , Aa          , Aa          , Aa          , Aa^Fpa      , Aa          , Aa          , Aa          , Aa          , Aa          , Aa          , Aa^Fpa      , Aa^Fpa      
Mm          , Mm          , Mm          , Ha          , Ha          , Ha          , Ha^Voa       , Ha          , Aa          , Ha^Fpa      , Aa^Fpa      , Aa          , Aa          , Aa          , Aa^Voa      , Ha          , Aa          , Aa          , Aa          , Aa          , Aa^Voa      , Aa          , Aa          , Aa          , Aa^Fpa      , Aa          , Aa          , Aa          , Aa          , Aa          , Aa          , Aa          
Mm          , Mm          , Mm          , Ha          , Ha          , Ha          , Ha          , Aa          , Aa          , Aa^Fpa      , Aa^Fpa      , Aa^Fpa      , Aa          , Aa          , Aa          , Aa          , Aa          , Aa          , Aa          , Aa          , Aa          , Aa          , Aa          , Aa          , Aa          , Aa          , Aa          , Aa          , Aa          , Aa          , Aa          , Aa          
Mm          , Mm          , Mm          , Ha          , Ha          , Ha          , Ha          , Ha          , Ha          , Ha^Fpa      , Ha^Fpa      , Aa^Fpa      , Aa^Fpa      , Aa          , Aa          , Aa          , Aa          , Aa          , Aa          , Aa          , Aa          , Aa          , Aa          , Aa          , Aa          , Aa          , Aa          , Aa          , Aa          , Aa          , Aa          , Aa          
Mm          , Mm          , Mm          , Ha          , Ha          , Ha          , Ha          , Ha          , Ha          , Aa          , Aa          , Aa^Fpa      , Aa^Fpa      , Aa          , Aa          , Aa          , Aa          , Aa^Voa      , Aa          , Aa          , Aa          , Aa          , Aa          , Aa          , Aa          , Aa          , Aa          , Aa          , Aa          , Aa          , Re          , Re          
Mm          , Mm          , Mm          , Ha          , Ha          , Ha          , Ha          , Ha          , Re          , Ha          , Aa          , Aa          , Aa^Fpa      , Aa^Fpa      , Aa          , Aa          , Aa          , Aa          , Aa          , Aa          , Aa          , Aa          , Aa          , Aa          , Aa          , Aa          , Aa          , Aa          , Aa          , Aa^Voa      , Re          , Aa          
Mm          , Mm          , Mm          , Ha          , Ha          , Ha          , Ha          , Re          , Ha          , Ha          , Aa          , Aa          , Aa          , Aa          , Aa          , Re          , Re          , Re          , Re          , Aa          , Aa          , Aa          , Aa          , Re^Vct      , Aa          , Aa          , Aa          , Aa^Fpa      , Aa          , Re          , Aa          , Aa          
Mm          , Mm          , Mm          , Ha          , Ha          , Ha          , Ha          , Re          , Ha          , Ha          , Ha          , Aa          , Aa^Vea      , Aa          , Aa          , Aa          , Aa          , Aa          , Aa          , Aa          , Aa          , Aa^Vea      , Ch          , Re          , Re          , Aa          , Aa^Fpa      , Aa^Fpa      , Aa          , Re          , Aa          , Aa          
Mm          , Mm          , Mm          , Ha          , Ha          , Ha          , Re^Vct      , Re          , Re          , Re          , Ha          , Aa          , Ch          , Aa          , Aa^Vea      , Aa          , Aa          , Aa          , Aa^Vea      , Aa          , Ch          , Ch          , 7 Kh        , Ch          , Aa^Fpa      , Re^Vct      , Aa^Fpa      , Aa          , Re          , Aa          , Aa          , Aa          
Mm          , Mm          , Mm          , Ha          , Ha          , Ha          , Aa          , Aa          , Aa          , Aa          , Re          , Aa          , Ch          , Ch          , Ch          , Aa          , Aa^Vea      , Ai          , Ai          , Ai          , Ai          , Ch          , Ch          , Ch          , Aa          , Aa^Fpa      , Aa^Fpa      , Re^Vct      , Re          , Aa          , Aa^Fpa      , Aa^Fpa      
Mm          , Mm          , Ha          , Ha          , Ha          , Ha          , Aa^Vea      , Aa          , Aa          , Re^Vct      , Re          , Aa^Vea      , Ch          , 6 Kh        , Ch          , Ai          , Ai          , Wo          , Wo          , Wo          , Ai          , Aa          , Aa          , Ch          , Aa          , Aa^Vha      , Re          , Re          , Aa          , Aa^Fpa      , Aa^Fpa      , Aa^Fpa      
Mm          , Mm          , Mm          , Ha          , Ha          , Ha          , Ha          , Aa          , Aa          , Aa          , Re          , Re          , Ch          , Ch          , Aa          , Ai          , Wo          , Wo          , Wo          , Wo          , Wo          , Ai          , Aa          , Aa          , Re          , Re          , Re          , Re          , Aa          , Aa^Fpa      , Aa^Fpa      , Aa^Fpa      
Mm          , Mm          , Ha          , Ha          , Ha          , Ha          , Ha          , Aa          , Aa          , Re          , Aa          , Aa          , Aa          , Re^Vct      , Aa          , Ai          , Wo          , Wo          , Wo          , Ai          , Ai          , Aa          , Aa          , Re          , Re          , Re^Vct      , Aa          , Aa          , Aa^Fpa      , Aa^Fpa      , Aa^Fpa      , Aa^Fpa      
Mm          , Mm          , Mm          , Ha          , Ha          , Aa          , Aa          , Ha          , Aa          , Aa          , Re          , Aa          , Aa          , Aa^Vea      , Aa          , Ai          , Wo          , Wo          , Wo          , Wo          , Ai          , Ai          , Aa          , Aa          , Re^Vct      , Re          , Aa          , Aa          , Aa          , Aa^Fpa      , Aa^Fpa      , Aa^Fpa      
Mm          , Mm          , Ha          , Ha          , Aa          , Aa          , Aa          , Aa          , Aa          , Aa          , Re          , Aa          , Aa          , Aa          , Ai          , Wo          , Wo          , Wo          , Wo          , Wo          , Ai          , Aa          , Aa          , Aa          , Re          , Re          , Aa          , Aa          , Aa^Fpa      , Aa^Fpa      , Aa^Fpa      , Aa^Fpa      
Mm          , Mm          , Ha          , Ha          , Aa          , Aa          , Aa          , Aa          , Aa          , Re          , Re          , Aa          , Aa^Fpa      , Aa^Fpa      , Ai          , Wo          , Wo          , Wo          , Wo          , Wo          , Ai          , Aa          , Re          , Re          , Re          , Aa          , Aa          , Aa          , Aa^Fpa      , Aa^Fpa      , Aa^Fpa      , Aa^Fpa      
Mm          , Mm          , Ha          , Ha          , Aa          , Aa^Vea      , Aa          , Aa          , Re          , Re          , Aa          , Aa          , Aa          , Ai          , Wo          , Wo          , Ai          , Ai          , Ai          , Ai          , Aa          , Aa          , Aa          , Aa          , Re          , Re          , Aa          , Aa          , Aa^Fpa      , Aa^Fpa      , Aa^Fpa      , Aa^Fpa      
Ha          , Ha          , Ha          , Ha          , Aa          , Aa          , Aa          , Aa          , Aa^Fpa      , Aa          , Aa          , Aa          , Aa          , Ai          , Wo          , Wo          , Ai          , Aa          , Aa^Vea      , Aa          , Aa          , Aa          , Aa          , Aa          , Aa          , Re          , Re          , Aa          , Aa          , Aa^Fpa      , Aa^Fpa      , Aa^Fpa      
Ha          , Ha          , Ha          , Aa          , Aa          , Aa          , Aa          , Aa^Fpa      , Aa^Fpa      , Aa          , Aa          , Aa          , Aa          , Ai          , Wo          , Ai          , Aa          , Aa          , Aa          , Aa          , Aa          , Aa          , Aa          , Aa          , Aa          , Re          , Aa          , Aa          , Aa^Fpa      , Aa^Fpa      , Aa^Fpa      , Aa^Fpa      
Ha          , Ha          , Aa          , Aa          , Aa          , Aa          , Aa          , Aa^Fpa      , Aa          , Aa          , Ai          , Ai          , Ww^Bw|      , Ai          , Ai          , Ai          , Aa          , Aa          , Aa          , Aa          , Aa          , Aa          , Aa          , Aa          , Aa          , Aa^Voa      , Re          , Aa          , Aa          , Aa^Fpa      , Aa^Fpa      , Aa^Fpa      
Aa          , Aa          , Aa          , Aa          , Aa          , Aa          , Aa          , Aa          , Ai          , Ai          , Ai          , Ch          , Re          , Ch          , Aa          , Aa          , Aa          , Aa          , Aa          , Aa          , Aa          , Aa          , Aa          , Aa          , Aa          , Aa          , Re          , Aa          , Aa          , Aa^Fpa      , Aa^Fpa      , Aa^Fpa      
Ha^Fpa      , Ha^Fpa      , Aa          , Aa          , Aa          , Re          , Aa          , Aa          , Ai          , Aa          , Aa          , Aa          , Ch          , Re          , Re^Vct      , Aa^Fpa      , Aa^Vea      , Aa          , Aa          , Aa          , Aa          , Aa          , Aa          , Aa          , Aa          , Aa          , Aa          , Re          , Aa          , Aa          , Aa^Fpa      , Aa^Fpa      
Mm          , Ha^Fpa      , Ha^Fpa      , Aa^Fpa      , Aa^Fpa      , Re          , Aa          , Ai          , Aa          , Aa          , Re^Vct      , Ch          , 5 Kh        , Ch          , Re          , Aa^Fpa      , Aa          , Aa          , Aa          , Aa          , Aa          , Aa          , Aa          , Aa          , Aa          , Aa          , Re          , Aa          , Aa          , Aa          , Aa^Fpa      , Aa^Fpa      
Mm          , Mm          , Ha          , Aa^Fpa      , Aa^Voa      , Re          , Aa          , Ai          , Ch          , Aa          , Aa          , Ch          , Ch          , Ch          , Re^Vct      , Aa^Fpa      , Aa^Fpa      , Aa          , Aa          , Aa          , Aa          , Aa          , Aa          , Aa          , Aa          , Aa          , Aa          , Re          , Aa          , Aa          , Aa          , Aa          
Mm          , Mm          , Ha          , Aa          , Aa          , Re          , Aa          , Aa          , Ww^Bw/      , Aa          , Aa          , Ch          , Ch          , Ch          , Re          , Aa^Fpa      , Aa^Vea      , Aa          , Aa          , Aa          , Aa          , Aa          , Aa          , Aa          , Aa          , Aa          , Aa          , Re          , Aa          , Aa          , Aa          , Aa          
Mm          , Mm          , Ha          , Ha          , Aa          , Aa          , Aa          , Aa          , Ai          , Ch          , Aa          , Aa          , Aa          , Re^Vct      , Aa          , Aa          , Aa^Fpa      , Aa          , Aa          , Aa          , Aa          , Aa          , Aa          , Aa^Voa      , Aa          , Aa          , Aa          , Aa^Voa      , Re          , Aa          , Aa          , Aa          
Mm          , Ha          , Ce          , Aa^Voa      , 2 Ce        , Ce          , Aa          , Aa          , Ai          , Aa          , Aa^Vha      , Aa          , Re          , Aa          , Aa          , Aa          , Aa          , Aa          , Re^Vct      , Re          , Aa          , Aa          , Aa          , Aa          , Aa          , Aa          , Aa          , Aa          , Re          , Aa          , Aa          , Aa          
Ha          , Ha          , Aa^Voa      , Ce          , 1 Ke        , 3 Ce        , Aa          , Aa          , Ai          , Aa          , Aa          , Aa          , Aa^Voa      , Re          , Aa          , Aa          , Aa^Vha      , Aa          , Aa          , Re          , Aa          , Aa          , Aa^Fpa      , Aa^Fpa      , Aa          , Aa          , Aa          , Aa          , Aa          , Re          , Re          , Re          
Re          , Ha          , Re          , Ce          , Ce          , Ce          , Aa          , Ai          , Aa          , Aa          , Aa          , Aa          , Aa          , Re          , Aa          , Aa          , Aa          , Aa          , Re          , Re          , Aa          , Aa^Fpa      , Aa^Fpa      , Aa^Fpa      , Aa          , Aa          , Aa          , Aa          , Aa          , Aa          , Aa          , Aa          
Ha          , Re          , Ha          , Aa^Voa      , Aa          , Aa          , Ai          , Ai          , Aa          , Aa          , Aa          , Aa          , Aa          , Re          , Re          , Aa          , Re          , Re          , Re^Vct      , Aa          , Aa          , Aa          , Aa^Fpa      , Aa^Fpa      , Aa^Fpa      , Aa^Fpa      , Aa^Fpa      , Aa          , Aa          , Aa          , Aa          , Aa          
Ha          , Ha          , Ha          , Aa          , Ai          , Ai          , Aa          , Aa          , Aa          , Aa          , Aa          , Aa          , Aa          , Aa          , Aa          , Re          , Aa          , Aa          , Aa          , Aa          , Aa          , Aa^Fpa      , Aa^Fpa      , Aa^Fpa      , Aa^Fpa      , Aa^Fpa      , Aa^Fpa      , Aa          , Aa          , Aa          , Aa          , Aa          
Ha          , Ha          , Ha          , Aa          , Ai          , Ai          , Aa          , Aa          , Aa          , Aa          , Aa          , Aa          , Aa          , Aa          , Aa          , Aa          , Aa          , Aa          , Aa          , Aa          , Aa          , Aa^Fpa      , Aa^Fpa      , Aa^Fpa      , Aa^Fpa      , Aa^Fpa      , Aa^Fpa      , Aa          , Aa          , Aa          , Aa          , Aa          
