border_size=1
usage=map

Mm, Mm, Mm, Mm, Mm, Mm, Mm, Mm, Mm, Mm, Mm, Mm, Mm, Ha, Ha, Ha, Ha, Mm, Mm, Mm, Ha, Ha, Aa, Aa, Aa, Aa, Aa, Aa, Aa, Aa, Aa, Aa
Mm, Mm, Mm, Mm, Mm, Mm, Mm, Mm, Mm, Mm, Mm, Mm, Mm, Ha, Ha, Ha, Ha, Mm, Mm, Mm, Ha, Ha, Aa, Aa, Aa, Aa, Aa, Aa, Aa, Aa, Aa, Aa
Mm, Mm, Mm, Mm, Mm, Mm, Ha, Mm, Mm, Mm, Ha, Ha, Ha, Ha, Ha, Ha, Ha, Ha, Mm, Ha, Ha, Aa, Aa, Aa, Aa, Aa, Aa, Aa, Aa, Aa, Aa, Aa
Mm, Mm, Mm, Mm, Ha, Ha, Ha, Ha, Ha, Mm, Mm, Ha, Ha, Ha, Re^Vct, Cha, Cha, Ha, Ha, Ha, Ha, Aa, Aa, Aa, Aa, Aa, Aa, Aa, Aa, Aa, Aa, Aa
Mm^Xm, Mm^Xm, Mm^Xm, Ha, Ha, 4 Ha, Ha, Ha, Ha, Ha, Ha, Ha, Ha, Re, Cha, 8 Kha, Cha, Aa, Ha, Ha, Aa^Vha, Aa, Aa^Fpa, Aa^Fpa, Aa, Aa, Aa, Aa^Voa, Aa, Aa, Aa^Fpa, Aa^Fpa
Mm, Mm, Mm, Mm, Mm, Ha, Mm, Ha, Ha, Ha, Ha, Mm, Mm, Ha, Ha, Cha, Cha, Re, Aa, Ha, Ha, Aa, Aa^Fpa, Aa^Fpa, Aa, Aa, Aa, Aa, Aa, Aa, Aa, Aa
Mm, Mm, Ha, Mm, Mm, Mm, Ha, Ha, Ha, Ha, Ha, Ha, Mm, Ha, Ha, Re, Re, Aa, Re^Vct, Ha, Aa, Aa, Aa^Fpa, Aa^Fpa, Aa, Aa, Aa, Aa, Aa, Aa, Aa^Fpa, Aa^Fpa
Mm, Mm, Mm, Mm, Ha, Mm, Ha, Ha, Ha, Ha, Aa, Aa, Ha, Mm, Ha, Aa, Aa, Re, Re, Aa, Aa, Aa, Aa, Aa^Fpa, Aa^Fpa, Aa, Aa, Aa, Aa, Aa, Aa, Aa
Mm, Mm, Ha, Ha, Ha, Ha, Ha, Ha, Aa, Ha, Aa, Ha, Ha, Ha, Ha, Ha, Aa, Aa, Re, Aa, Aa, Aa, Aa, Aa^Fpa, Aa, Aa, Aa, Aa, Aa, Aa^Voa, Aa^Fpa, Aa^Fpa
Mm, Mm, Mm, Ha, Ha, Ha, Ha^Voa, Ha, Aa, Ha^Fpa, Aa^Fpa, Aa, Aa, Aa, Aa, Ha, Aa, Aa, Aa, Aa, Aa, Aa, Aa, Aa, Aa^Fpa, Aa, Aa, Aa, Aa, Aa, Aa, Aa
Mm, Mm, Mm, Ha, Ha, Ha, Ha, Aa, Aa, Aa^Fpa, Aa^Fpa, Aa^Fpa, Aa, Aa, Aa, Aa, Aa, Aa, Aa, Aa, Aa, Aa, Aa, Aa, Aa, Aa, Aa, Aa, Aa, Aa, Aa, Aa
Mm, Mm, Mm, Ha, Ha, Ha, Ha, Ha, Ha, Ha^Fpa, Ha^Fpa, Aa^Fpa, Aa^Fpa, Aa, Aa, Aa, Aa, Aa, Aa, Aa, Aa, Aa, Aa, Aa, Aa, Aa, Aa, Aa, Aa, Aa, Aa, Aa
Mm, Mm, Mm, Ha, Ha, Ha, Ha, Ha, Ha, Aa, Aa, Aa^Fpa, Aa^Fpa, Aa, Aa, Aa, Aa, Aa^Voa, Aa, Aa, Aa, Aa, Aa, Aa, Aa, Aa, Aa, Aa, Aa, Aa, Re, Re
Mm, Mm, Mm, Ha, Ha, Ha, Ha, Ha, Re, Ha, Aa, Aa, Aa^Fpa, Aa^Fpa, Aa, Aa, Aa, Aa, Aa, Aa, Aa, Aa, Aa, Aa, Aa, Aa, Aa, Aa, Aa, Aa^Voa, Re, Aa
Mm, Mm, Mm, Ha, Ha, Ha, Ha, Re, Ha, Ha, Aa, Aa, Aa, Aa, Aa, Re, Re, Re, Re, Aa, Aa, Aa, Aa, Re^Vct, Aa, Aa, Aa, Aa^Fpa, Aa, Re, Aa, Aa
Mm, Mm, Mm, Ha, Ha, Ha, Ha, Re, Ha, Ha, Ha, Aa, Aa^Vea, Aa, Aa, Aa, Aa, Aa, Aa, Aa, Aa, Aa, Cha, Re, Re, Aa, Aa^Fpa, Aa^Fpa, Aa, Re, Aa, Aa
Mm, Mm, Mm, Ha, Ha, Ha, Re^Vct, Re, Re, Re, Ha, Aa, Cha, Aa, Aa, Aa, Aa, Aa, Aa^Vea, Aa, Cha, Cha, 7 Kha, Cha, Aa^Fpa, Re, Aa^Fpa, Aa, Re, Aa, Aa, Aa
Mm, Mm, Mm, Ha, Ha, Ha, Aa, Aa, Aa, Aa, Re, Aa, Cha, Cha, Cha, Aa, Aa, Ai, Ai, Ai, Ai, Cha, Cha, Cha, Aa, Aa^Fpa, Aa^Fpa, Re^Vct, Re, Aa, Aa^Fpa, Aa^Fpa
Mm, Mm, Ha, Ha, Ha, Ha, Aa, Aa, Aa, Re^Vct, Re, Aa, Cha, 6 Kha, Cha, Ai, Ai, Wo, Wo, Wo, Ai, Aa, Aa, Cha, Aa, Aa, Re, Re, Aa, Aa^Fpa, Aa^Fpa, Aa^Fpa
Mm, Mm, Mm, Ha, Ha, Ha, Ha, Aa, Aa, Aa, Re, Re, Cha, Cha, Aa, Ai, Wo, Wo, Wo, Wo, Wo, Ai, Aa, Aa, Re, Re, Re, Re, Aa, Aa^Fpa, Aa^Fpa, Aa^Fpa
Mm, Mm, Ha, Ha, Ha, Ha, Ha, Aa, Aa, Re, Aa, Aa, Aa, Re^Vct, Aa, Ai, Wo, Wo, Wo, Ai, Ai, Aa, Aa, Re, Re, Re^Vct, Aa, Aa, Aa^Fpa, Aa^Fpa, Aa^Fpa, Aa^Fpa
Mm, Mm, Mm, Ha, Ha, Aa, Aa, Ha, Aa, Aa, Re, Aa, Aa, Aa, Aa, Ai, Wo, Wo, Wo, Wo, Ai, Ai, Aa, Aa, Re, Re, Aa, Aa, Aa, Aa^Fpa, Aa^Fpa, Aa^Fpa
Mm, Mm, Ha, Ha, Aa, Aa, Aa, Aa, Aa, Aa, Re, Aa, Aa, Aa, Ai, Wo, Wo, Wo, Wo, Wo, Ai, Aa, Aa, Aa, Re, Re, Aa, Aa, Aa^Fpa, Aa^Fpa, Aa^Fpa, Aa^Fpa
Mm, Mm, Ha, Ha, Aa, Aa, Aa, Aa, Aa, Re, Re, Aa, Aa^Fpa, Aa^Fpa, Ai, Wo, Wo, Wo, Wo, Wo, Ai, Aa, Re, Re, Re, Aa, Aa, Aa, Aa^Fpa, Aa^Fpa, Aa^Fpa, Aa^Fpa
Mm, Mm, Ha, Ha, Aa, Aa^Vea, Aa, Aa, Re, Re, Aa, Aa, Aa, Ai, Wo, Wo, Ai, Ai, Ai, Ai, Aa, Re, Aa, Aa, Re, Re, Aa, Aa, Aa^Fpa, Aa^Fpa, Aa^Fpa, Aa^Fpa
Ha, Ha, Ha, Ha, Aa, Aa, Aa, Aa, Aa^Fpa, Aa, Aa, Aa, Aa, Ai, Wo, Wo, Ai, Aa, Aa^Vea, Aa, Re, Aa, Aa, Aa, Aa, Re, Re, Aa, Aa, Aa^Fpa, Aa^Fpa, Aa^Fpa
Ha, Ha, Ha, Aa, Aa, Aa, Aa, Aa^Fpa, Aa^Fpa, Aa, Aa, Aa, Aa, Ai, Wo, Ai, Aa, Aa, Aa, Re, Aa, Aa, Aa, Aa, Aa, Re, Aa, Aa, Aa^Fpa, Aa^Fpa, Aa^Fpa, Aa^Fpa
Ha, Ha, Aa, Aa, Aa, Aa, Aa, Aa^Fpa, Aa, Aa, Ai, Ai, Ww^Bw|, Ai, Ai, Ai, Re, Aa, Aa, Aa, Aa, Aa, Aa, Aa, Aa, Aa^Voa, Re, Aa, Aa, Aa^Fpa, Aa^Fpa, Aa^Fpa
Aa, Aa, Aa, Aa, Aa, Aa, Aa, Aa, Ai, Ai, Ai, Cha, Re, Cha, Re, Re, Aa, Aa, Aa, Aa, Aa, Aa, Aa, Aa, Aa, Aa, Aa, Aa, Aa, Aa^Fpa, Aa^Fpa, Aa^Fpa
Ha^Fpa, Ha^Fpa, Aa, Aa, Aa, Re, Aa, Aa, Ai, Aa, Aa, Aa, Cha, Re, Re^Vct, Aa^Fpa, Aa^Vea, Aa, Aa, Aa, Aa, Aa, Aa, Aa, Aa, Aa, Aa, Aa, Aa, Aa, Aa^Fpa, Aa^Fpa
Mm, Ha^Fpa, Ha^Fpa, Aa^Fpa, Aa^Fpa, Re, Aa, Ai, Aa, Aa, Re^Vct, Cha, 5 Kha, Cha, Re, Aa^Fpa, Aa, Aa, Aa, Aa, Aa, Aa, Aa, Aa, Aa, Aa, Aa, Aa, Aa, Aa, Aa^Fpa, Aa^Fpa
Mm, Mm, Ha, Aa^Fpa, Aa^Voa, Re, Aa, Ai, Ch, Aa, Aa, Cha, Cha, Cha, Re, Aa^Fpa, Aa^Fpa, Aa, Aa, Aa, Aa, Aa, Aa, Aa, Aa, Aa, Aa, Aa, Aa, Aa, Aa, Aa
Mm, Mm, Ha, Aa, Aa, Re, Aa, Aa, Ww^Bw/, Aa, Aa, Cha, Cha, Cha, Re, Aa^Fpa, Aa, Aa, Aa, Aa, Aa, Aa, Aa, Aa, Aa, Aa, Aa, Re, Aa, Aa, Aa, Aa
Mm, Mm, Ha, Ha, Aa, Aa, Aa, Aa, Ai, Ch, Aa, Aa, Aa, Re^Vct, Aa, Aa, Aa^Fpa, Aa, Aa, Aa, Aa, Aa, Aa, Aa^Voa, Aa, Aa, Aa, Aa, Re, Aa, Aa, Aa
Mm, Ha, Cea, Aa, 2 Cea, Cea, Aa, Aa, Ai, Aa, Aa, Aa, Re, Aa, Aa, Aa, Aa, Aa, Re^Vct, Aa, Aa, Aa, Aa, Aa, Aa, Aa, Aa, Aa, Re, Aa, Aa, Aa
Ha, Ha, Aa, Cea, 1 Kea, 3 Cea, Aa, Aa, Ai, Aa, Aa, Aa, Aa^Voa, Re, Aa, Aa, Aa, Aa, Aa, Re, Aa, Aa, Aa^Fpa, Aa^Fpa, Aa, Aa, Aa, Aa, Aa, Re, Re, Re
Re, Ha, Re, Cea, Cea, Cea, Aa, Ai, Aa, Aa, Aa, Aa, Aa, Re, Aa, Aa, Aa, Aa, Re, Aa, Aa, Aa^Fpa, Aa^Fpa, Aa^Fpa, Aa, Aa, Aa, Aa, Aa, Aa, Aa, Aa
Ha, Re, Ha, Aa^Voa, Aa, Aa, Ai, Ai, Aa, Aa, Aa, Aa, Aa, Re, Re, Aa, Re, Aa, Aa, Aa, Aa, Aa, Aa^Fpa, Aa^Fpa, Aa^Fpa, Aa^Fpa, Aa^Fpa, Aa, Aa, Aa, Aa, Aa
Ha, Ha, Ha, Aa, Ai, Ai, Aa, Aa, Aa, Aa, Aa, Aa, Aa, Aa, Aa, Re, Aa, Aa, Aa, Aa, Aa, Aa^Fpa, Aa^Fpa, Aa^Fpa, Aa^Fpa, Aa^Fpa, Aa^Fpa, Aa, Aa, Aa, Aa, Aa
Ha, Ha, Ha, Aa, Ai, Ai, Aa, Aa, Aa, Aa, Aa, Aa, Aa, Aa, Aa, Aa, Aa, Aa, Aa, Aa, Aa, Aa^Fpa, Aa^Fpa, Aa^Fpa, Aa^Fpa, Aa^Fpa, Aa^Fpa, Aa, Aa, Aa, Aa, Aa
