border_size=1
usage=map

Aa^Fpa      , Aa^Fpa      , Aa^Fpa      , Aa^Fpa      , Aa^Fpa      , Aa^Fpa      , Aa^Fpa      , Aa^Fpa      , Aa^Fpa      , Aa^Fpa      , Ha          , Ha          , Ha          , Ha          , Ha          , Aa^Fpa      , Ha          , Ha          , Ha          , Ha          , Ha          , Aa          , Ha          , Aa          , Aa          , Aa^Fpa      , Aa^Fpa      , Aa          , Aa^Fpa      , Aa^Fpa      , Aa          , Aa          , Aa          , Aa          , Aa          , Aa          , Aa          , Aa          , Ai          , Ai          , Ai          , Ai          , Ai          , Aa          , Aa          , Aa          , Aa          , Aa          , Aa          , Aa          , Aa          , Aa          , Aa          , Aa          , Aa          , Aa          , Aa          , Aa          , Re          , Aa          , Aa          , Aa          
Aa^Fpa      , Aa^Fpa      , Aa^Fpa      , Aa^Fpa      , Aa^Fpa      , Aa^Fpa      , Aa^Fpa      , Aa^Fpa      , Aa^Fpa      , Aa^Fpa      , Aa^Fpa      , Ha          , Ha^Fpa      , Ha^Fpa      , Ha          , Ha^Fpa      , Ha          , Ha          , Ha^Fpa      , Ha          , Ha          , Ha          , Ha^Fpa      , Ha          , Ha^Fpa      , Aa^Fpa      , Aa^Fpa      , Aa^Fpa      , Aa^Fpa      , Aa^Fpa      , Aa          , Aa          , Aa          , Aa          , Aa          , Aa          , Aa          , Ai          , Ai          , Ai          , Aa^Fpa      , Ai          , Ai          , Aa          , Aa^Voa      , Aa          , Aa          , Aa          , Aa          , Aa          , Aa          , Aa          , Aa          , Aa          , Aa          , Aa          , Aa          , Re          , Aa          , Aa          , Aa          , Aa          
Aa^Fpa      , Aa^Fpa      , Aa^Fpa      , Aa^Fpa      , Aa^Fpa      , Aa^Fpa      , Aa          , Aa^Fpa      , Aa^Fpa      , Aa^Fpa      , Aa^Fpa      , Aa^Fpa      , Aa          , Aa          , Aa^Fpa      , Aa^Fpa      , Aa          , Aa^Fpa      , Ha          , Ha^Fpa      , Ha          , Ha          , Ha          , Ha^Fpa      , Ha          , Aa^Fpa      , Aa          , Aa^Fpa      , Aa          , Aa          , Aa          , Aa          , Aa          , Aa          , Ai          , Ai          , Ai          , Ai          , Aa^Voa      , Aa^Fpa      , Aa          , Ai          , Ai          , Ai          , Ai          , Ai          , Aa          , Aa          , Aa          , Aa          , Aa          , Aa          , Aa          , Aa          , Aa          , Aa          , Aa^Voa      , Re          , Aa^Voa      , Aa          , Aa          , Aa          
Aa^Fpa      , Aa^Fpa      , Aa^Fpa      , Aa^Fpa      , Aa          , Aa          , Aa          , Aa          , Aa          , Aa          , Aa          , Aa          , Aa          , Aa^Fpa      , Aa^Fpa      , Aa          , Aa^Fpa      , Aa          , Aa          , Aa          , Aa          , Aa          , Aa          , Ha          , Ha          , Aa          , Aa          , Aa^Voa      , Aa          , Aa          , Aa          , Aa          , Aa          , Aa          , Aa          , Ai          , Ai          , Ai          , Aa^Fpa      , Aa^Fpa      , Ai          , Ai          , Ai          , Ai          , Aa          , Aa          , Aa          , Aa          , Aa          , Aa          , Aa          , Aa          , Aa          , Aa          , Ce          , Aa          , Re          , Re          , Aa          , Aa          , Aa          , Aa^Fpa      
Aa^Fpa      , Aa^Fpa      , Aa^Fpa      , Aa^Fpa      , Aa          , Aa          , Aa          , Aa          , Aa          , Aa          , Aa          , Aa          , Aa          , Aa^Fpa      , Aa          , Aa          , Aa^Vca      , Aa          , Aa          , Aa          , Aa          , Aa^Voa      , Rd          , Aa          , Aa          , Ha          , Aa          , Aa          , Aa          , Aa          , Aa^Fpa      , Aa          , Aa          , Aa          , Ai          , Ai          , Ai          , Ai          , Ai          , Aa          , Ai          , Ai          , Aa          , Aa          , Aa          , Aa          , Aa          , Aa          , Rd          , Rd          , Rd          , Aa          , Re          , Re          , Ce          , 1 Ke        , Ce          , Aa          , Aa          , Aa          , Aa^Fpa      , Aa^Fpa      
Aa^Fpa      , Aa^Fpa      , Aa^Fpa      , Aa^Fpa      , Aa          , Aa          , Aa          , Aa          , Aa          , Aa          , Aa          , Aa          , Aa          , Aa          , Aa          , Aa          , Aa          , Aa          , Rd          , Rd          , Rd          , Rd          , Chr         , Rd          , Rd          , Aa          , Aa          , Aa          , Aa^Fpa      , Aa^Fpa      , Aa^Fpa      , Aa          , Rd          , Aa          , Aa          , Ai          , Ai          , Ai          , Ai          , Ai          , Ai          , Ai          , Aa          , Aa^Voa      , Aa          , Aa          , Aa          , Rd          , Aa          , Aa          , Aa          , Aa          , Re^Vct      , Ce          , Ce          , Ce          , Rd          , Aa          , Aa          , Aa          , Aa^Fpa      , Aa^Fpa      
Aa^Fpa      , Aa^Fpa      , Aa^Fpa      , Aa          , Aa^Fpa      , Aa          , Aa          , Aa          , Aa          , Aa          , Aa          , Aa          , Aa          , Aa          , Aa          , Aa          , Rd          , Rd          , Aa          , Aa          , Rd          , Chr         , 2 Khr       , Chr         , Chr         , Rd          , Rd          , Aa          , Aa          , Aa^Fpa      , Rd          , Rd          , Aa          , Rd          , Rd          , Aa          , Aa          , Aa          , Aa          , Aa          , Aa          , Aa          , Aa          , Aa          , Rd          , Aa          , Rd          , Rd          , Aa          , Aa          , Aa          , Aa          , Aa          , Aa          , Re          , Ce          , Aa          , Rd          , Aa          , Aa          , Aa          , Aa^Fpa      
Aa^Fpa      , Aa^Fpa      , Aa^Fpa      , Aa^Fpa      , Aa^Fpa      , Aa          , Aa          , Aa^Voa      , Aa          , Aa          , Aa          , Aa          , Aa          , Aa^Fpa      , Aa^Fpa      , Rd          , Aa          , Aa          , Aa          , Aa          , Rd          , Chr         , Aa          , Chr         , Ha          , Aa          , Aa          , Rd          , Rd          , Rd          , Aa          , Aa          , Aa          , Aa          , Rd          , Aa          , Rd          , Rd          , Rd          , Rd          , Rd          , Aa          , Rd          , Rd          , Aa          , Rd          , Aa          , Aa          , Aa^Fpa      , Aa          , Aa^Fpa      , Aa          , Aa          , Aa          , Aa          , Re^Vct      , Aa          , Rd          , Aa          , Aa          , Aa^Fpa      , Aa^Fpa      
Aa^Fpa      , Aa^Fpa      , Aa^Fpa      , Aa          , Aa          , Aa          , Aa          , Aa          , Aa          , Aa          , Aa          , Aa          , Aa          , Aa^Fpa      , Aa          , Rd          , Aa          , Ha          , Ha          , Aa          , Aa          , Rd          , Rd          , Aa          , Aa          , Ha^Voa       , Ha          , Aa          , Aa          , Aa          , Aa          , Aa          , Aa^Voa      , Aa          , Aa          , Rd          , Aa          , Aa          , Aa          , Aa          , Aa          , Rd          , Aa          , Aa          , Aa          , Aa          , Aa          , Aa          , Aa          , Aa          , Ha          , Aa^Fpa      , Ha^Fpa      , Aa^Fpa      , Aa^Fpa      , Aa          , Aa          , Rd          , Aa          , Aa          , Aa^Fpa      , Aa^Fpa      
Aa^Fpa      , Aa^Fpa      , Aa          , Aa^Voa      , Aa          , Aa          , Aa          , Aa^Fpa      , Aa^Fpa      , Aa          , Aa          , Aa          , Aa          , Aa          , Aa          , Rd          , Aa          , Ha^Voa       , Ha          , Ha          , Ha          , Aa          , Aa          , Rd          , Aa          , Ha          , Ha          , Ha          , Ha          , Ha          , Aa          , Aa          , Ha          , Ha          , Ha          , Rd          , Ha          , Ha          , Ha^Voa       , Aa          , Ha          , Aa          , Ha          , Aa          , Aa          , Aa          , Aa          , Aa          , Aa          , Aa          , Ha          , Ha          , Ha^Fpa      , Ha^Fpa      , Aa^Fpa      , Aa^Fpa      , Aa          , Rd          , Aa          , Aa          , Aa^Fpa      , Aa^Fpa      
Aa^Fpa      , Aa^Fpa      , Aa^Fpa      , Aa          , Aa          , Aa          , Aa          , Aa^Fpa      , Aa          , Aa          , Aa          , Aa          , Aa          , Aa          , Aa          , Rd          , Aa          , Ha          , Ha          , Ha          , Ha          , Ha          , Aa          , Rd          , Aa          , Aa          , Aa          , Ha          , Ha          , Ha          , Ha          , Ha          , Ha          , Aa          , Aa          , Rd          , Rd          , Ha          , Aa          , Aa          , Aa          , Ha          , Aa          , Aa          , Aa          , Aa          , Aa          , Aa          , Aa          , Aa          , Aa          , Aa          , Aa          , Aa          , Aa          , Aa^Fpa      , Aa          , Rd          , Aa          , Aa          , Aa          , Aa^Fpa      
Aa^Fpa      , Aa^Fpa      , Aa^Fpa      , Aa^Fpa      , Aa          , Aa          , Aa          , Aa          , Aa          , Aa          , Aa          , Aa          , Aa          , Aa          , Rd          , Rd          , Ha          , Ha          , Ha^Fpa      , Ha^Vca       , Ha          , Aa          , Aa          , Rd          , Aa          , Aa          , Ha          , Ha          , Ha          , Aa          , Aa          , Ha          , Ha          , Ha          , Ha          , Ha          , Rd          , Ha          , Aa          , Aa          , Aa          , Aa          , Mm          , Aa          , Aa          , Aa          , Rd          , Aa          , Aa          , Aa          , Aa          , Aa          , Aa          , Aa          , Aa          , Aa^Fpa      , Aa          , Rd          , Aa          , Aa^Fpa      , Aa^Fpa      , Aa^Fpa      
Aa^Fpa      , Aa^Fpa      , Aa^Fpa      , Aa          , Aa          , Aa          , Aa          , Aa          , Rd          , Rd          , Rd          , Rd          , Rd          , Rd          , Aa          , Aa          , Ha          , Ha^Fpa      , Ha^Fpa      , Ha          , Ha          , Aa          , Rd          , Rd          , Rd          , Aa          , Ha          , Ha          , Aa          , Aa          , Aa          , Ha          , Ha          , Ha          , Rd          , Rd          , Aa          , Ha          , Ha          , Aa          , Aa          , Aa          , Mm          , Mm          , Mm          , Aa          , Rd          , Aa          , Aa          , Aa^Vca      , Aa          , Aa          , Aa          , Aa          , Aa          , Aa          , Aa          , Rd          , Aa          , Aa^Fpa      , Aa^Fpa      , Aa^Fpa      
Aa          , Aa^Fpa      , Aa          , Aa          , Aa          , Aa          , Rd          , Rd          , Aa          , Aa          , Aa          , Aa          , Aa          , Aa          , Aa          , Ha          , Ha^Fpa      , Ha^Fpa      , Ha          , Ha          , Rd          , Ha          , Ha          , Aa          , Ha          , Rd          , Rd          , Aa          , Rd          , Rd          , Rd          , Aa          , Aa          , Ha          , Rd          , Ha          , Ha          , Ha          , Ha          , Ha          , Ha          , Ha          , Aa          , Mm          , Mm          , Aa          , Aa          , Rd          , Aa          , Aa          , Aa          , Aa          , Aa          , Aa          , Aa          , Aa          , Aa          , Rd          , Aa          , Aa^Fpa      , Aa          , Aa^Fpa      
Aa          , Aa          , Aa          , Aa          , Rd          , Rd          , Aa          , Aa          , Aa^Voa      , Aa          , Ch          , Aa          , Aa          , Aa          , Ha          , Ha          , Ha^Fpa      , Ha^Fpa      , Ha          , Aa          , Rd          , Aa          , Ha          , Ha          , Ha          , Ha          , Aa^Fpa      , Rd          , Aa          , Aa          , Aa          , Rd          , Rd          , Rd          , Ha          , Ha          , Ha^Voa       , Ha          , Aa          , Aa          , Aa          , Aa          , Aa          , Aa          , Aa          , Mm          , Aa          , Rd          , Aa          , Aa          , Aa          , Aa          , Aa          , Aa          , Aa          , Aa          , Rd          , Rd          , Aa          , Aa          , Aa          , Aa          
Aa^Fpa      , Aa^Fpa      , Aa          , Rd          , Aa          , Aa          , Aa          , Aa          , Aa          , Ch          , 3 Kh        , Ch          , Aa          , Ha          , Ha^Voa       , Ha          , Ha          , Ha          , Ha          , Ha          , Ha          , Ha          , Ha          , Ha          , Ha^Fpa      , Ha          , Ha^Fpa      , Aa^Fpa      , Aa^Fpa      , Ha          , Ha          , Aa          , Rd          , Ha          , Aa          , Aa          , Ai          , Aa          , Mm          , Mm          , Mm          , Aa          , Aa          , Aa          , Aa          , Mm          , Rd          , Rd          , Aa          , Aa          , Aa          , Aa          , Aa          , Aa          , Rd          , Rd          , Aa          , Aa          , Aa^Fpa      , Aa^Voa      , Aa^Fpa      , Aa^Fpa      
Aa^Fpa      , Aa^Fpa      , Aa^Fpa      , Rd          , Aa          , Aa          , Aa          , Aa          , Aa          , Ch          , Ch          , Ch          , Aa          , Ha          , Aa          , Aa          , Rd          , Aa          , Rd          , Rd          , Aa          , Ha          , Ha          , Ha^Fpa      , Ha^Fpa      , Ha^Fpa      , Ha          , Aa^Fpa      , Rd          , Ha          , Aa          , Aa          , Ai^Bw|      , Aa          , Ai          , Ai          , Ww          , Ai          , Ai          , Ai          , Mm          , Mm          , Mm          , Aa          , Mm          , Mm          , Rd          , Mm          , Mm          , Aa          , Aa          , Aa          , Aa^Fpa      , Aa^Fpa      , Rd          , Aa          , Aa          , Aa          , Mm          , Mm          , Mm          , Aa^Fpa      
Aa^Fpa      , Aa^Fpa      , Rd          , Rd          , Aa          , Aa^Vca      , Aa          , Aa          , Aa          , Aa          , Aa          , Rd          , Rd          , Aa          , Rd          , Rd          , Aa^Fpa      , Rd          , Aa          , Aa          , Aa^Fpa      , Ha          , Ha          , Ha          , Ha          , Ha          , Rd          , Rd          , Aa          , Aa          , Ai          , Ai          , Ww          , Ai          , Ww          , Ww          , Ww          , Ww          , Ww          , Ww          , Ai          , Mm          , Mm          , Mm          , Mm          , Mm          , Mm          , Mm          , Mm          , Mm          , Mm          , Aa          , Mm          , Aa^Fpa      , Mm          , Ha^Voa       , Mm          , Mm          , Mm          , Mm          , Mm          , Mm          
Rd          , Rd          , Aa          , Aa          , Aa          , Aa          , Aa          , Aa          , Aa^Fpa      , Aa^Voa      , Aa^Fpa      , Aa          , Aa^Fpa      , Rd          , Aa^Fpa      , Aa^Fpa      , Ha^Fpa      , Aa^Fpa      , Ha^Fpa      , Aa^Fpa      , Ha          , Ha          , Ha          , Ha          , Aa          , Ha          , Rd          , Ha          , Aa          , Ai          , Ai          , Ww          , Ww          , Ww          , Ww          , Ww          , Ww          , Ww          , Ai          , Ww          , Ai          , Mm          , Aa^Fpa      , Aa^Fpa      , Aa^Fpa      , Ha^Fpa      , Aa          , Mm          , Aa^Fpa      , Mm          , Mm          , Mm          , Mm          , Mm          , Mm          , Mm          , Mm          , Mm          , Mm          , Mm          , Mm          , Mm          
Aa          , Aa          , Aa          , Aa          , Aa          , Aa          , Aa^Fpa      , Aa^Fpa      , Aa^Fpa      , Aa^Fpa      , Aa          , Aa^Fpa      , Aa^Fpa      , Rd          , Rd          , Aa^Fpa      , Ha^Fpa      , Ha          , Ha^Fpa      , Ha          , Aa          , Ha          , Ha          , Ha          , Aa          , Ha          , Ha^Voa       , Rd          , Aa          , Ai          , Ww          , Ww          , Ww          , Ww          , Ww          , Ai          , Ai          , Ai^Bw\      , Rd          , Ai          , Mm          , Mm          , Rd          , Aa^Voa      , Rd          , Aa^Fpa      , Aa          , Ha^Fpa      , Aa^Fpa      , Aa^Fpa      , Mm          , Mm          , Mm          , Mm          , Mm          , Mm          , Mm          , Mm          , Mm          , Mm          , Mm          , Mm          
Aa^Fpa      , Aa^Fpa      , Aa^Fpa      , Aa          , Aa^Fpa      , Aa^Fpa      , Aa^Voa      , Aa^Fpa      , Aa^Fpa      , Aa^Fpa      , Aa^Fpa      , Aa^Fpa      , Aa^Fpa      , Aa^Fpa      , Rd          , Aa^Fpa      , Aa^Fpa      , Ha^Fpa      , Aa          , Aa          , Ha          , Ha          , Ha          , Aa          , Ha          , Ha          , Aa          , Rd          , Aa          , Ai          , Ai          , Ai          , Ww          , Ww          , Ai          , Ai          , Mm          , Mm          , Rd          , Aa          , Rd          , Rd          , Ha^Fpa      , Rd          , Ha^Fpa      , Ha^Fpa      , Ha^Fpa      , Aa^Fpa      , Mm          , Mm          , Mm          , Mm          , Mm          , Mm          , Mm          , Mm          , Mm          , Mm          , Mm          , Mm          , Mm          , Mm          
Aa          , Aa^Fpa      , Aa          , Aa^Fpa      , Aa^Fpa      , Aa^Fpa      , Aa          , Aa^Fpa      , Ha^Fpa      , Aa          , Aa^Fpa      , Aa^Fpa      , Aa^Fpa      , Aa^Fpa      , Rd          , Aa          , Mm          , Aa          , Mm          , Mm          , Aa          , Ha          , Aa          , Ha          , Aa          , Ha          , Aa          , Aa          , Ai          , Ai          , Ai          , Ai          , Ai          , Ai          , Mm          , Mm          , Mm          , Mm          , Ha          , Rd          , Ha          , Ha          , Mm          , Mm          , Mm          , Mm          , Mm          , Mm          , Mm          , Mm          , Mm          , Mm          , Aa          , Mm          , Rd          , Aa          , Aa          , Aa          , Aa          , Mm          , Mm          , Mm          
Aa^Fpa      , Aa^Fpa      , Aa          , Aa^Fpa      , Aa^Fpa      , Aa^Fpa      , Aa^Fpa      , Aa^Fpa      , Ha^Fpa      , Aa^Fpa      , Ha          , Aa^Fpa      , Ha          , Ha          , Ha^Voa       , Rd          , Aa          , Mm          , Mm          , Mm          , Aa          , Aa          , Aa          , Aa          , Aa          , Aa          , Mm          , Mm          , Mm          , Mm          , Ai          , Ai          , Mm          , Mm          , Mm          , Mm          , Mm          , Mm          , Mm          , Rd          , Rd          , Rd          , Rd          , Mm          , Ha          , Mm          , Aa          , Mm          , Ha^Voa       , Mm          , Aa          , Aa^Voa      , Aa          , Aa          , Aa          , Aa          , Rd          , Aa          , Aa          , Aa          , Aa          , Mm          
Aa          , Aa^Fpa      , Aa^Fpa      , Ha^Fpa      , Ha^Fpa      , Aa          , Ha^Fpa      , Aa          , Ha^Fpa      , Ha^Fpa      , Ha          , Ha          , Mm          , Mm          , Rd          , Rd          , Mm          , Mm          , Mm          , Mm          , Mm          , Aa          , Mm          , Aa          , Mm          , Mm          , Mm          , Mm          , Mm          , Mm          , Mm          , Mm          , Mm          , Mm          , Mm          , Mm          , Mm          , Mm          , Mm          , Mm          , Mm          , Aa          , Aa          , Rd          , Aa          , Aa          , Aa          , Aa          , Aa          , Ha^Fpa      , Ha^Fpa      , Aa^Fpa      , Aa^Fpa      , Aa          , Aa          , Aa          , Rd          , Aa          , Aa          , Aa          , Aa          , Aa          
Ha          , Ha          , Ha          , Ha^Fpa      , Ha          , Ha          , Ha          , Ha          , Ha          , Ha          , Mm          , Mm          , Rd          , Rd          , Mm          , Mm          , Mm          , Mm          , Mm          , Mm          , Mm          , Mm          , Mm          , Mm          , Mm          , Mm          , Mm          , Mm          , Mm          , Mm          , Mm          , Mm          , Mm          , Mm          , Ha^Voa       , Aa          , Mm          , Mm          , Mm          , Mm          , Mm          , Mm          , Ha^Voa       , Rd          , Aa^Fpa      , Aa          , Aa          , Aa          , Aa^Fpa      , Ha^Fpa      , Ha^Fpa      , Aa^Fpa      , Aa^Fpa      , Aa          , Aa          , Co          , Rd          , Co          , Aa          , Aa          , Aa          , Aa          
Aa          , Ha          , Ha          , Ha          , Mm          , Ha          , Aa          , Ha          , Mm          , Mm          , Mm          , Mm          , Rd          , Mm          , Mm          , Mm          , Mm          , Mm          , Co          , Mm          , Mm          , Mm          , Mm          , Mm          , Aa          , Ha^Voa       , Aa          , Mm          , Rd          , Mm          , Mm          , Mm          , Aa          , Aa          , Aa          , Aa          , Aa          , Chr         , Chr         , Aa          , Aa          , Ha          , Aa          , Rd          , Aa          , Aa          , Aa          , Aa          , Aa          , Aa^Fpa      , Aa          , Aa^Fpa      , Aa          , Aa          , Rd          , Rd          , Aa          , Aa          , Aa          , Aa^Voa      , Aa          , Aa          
Aa          , Ha          , Mm          , Mm          , Mm          , Mm          , Mm          , Ha          , Ha          , Mm          , Aa          , Aa          , Rd          , Mm          , Mm          , Mm          , Co          , Co          , 4 Ko        , Co          , Mm          , Aa          , Aa          , Aa          , Aa          , Rd          , Rd          , Rd          , Mm          , Rd          , Rd          , Rd          , Rd          , Rd          , Rd          , Aa          , Aa          , Chr         , Aa          , Chr         , Aa          , Aa          , Aa          , Rd          , Rd          , Aa          , Co          , Aa          , Aa          , Aa          , Aa          , Aa          , Rd          , Rd          , Aa          , Aa          , Aa^Fpa      , Aa          , Aa          , Aa          , Mm          , Mm          
Ha          , Ha          , Ha          , Mm          , Mm          , Mm          , Mm          , Ha          , Ha          , Aa          , Ha          , Aa          , Rd          , Mm          , Mm          , Mm          , Rd          , Co          , Mm          , Co          , Mm          , Mm          , Mm          , Mm          , Mm          , Aa          , Mm          , Mm          , Mm          , Ha^Voa       , Mm          , Mm          , Mm          , Mm          , Aa          , Rd          , Rd          , Aa          , Aa          , Aa          , Aa          , Aa          , Aa          , Aa          , Co          , Co          , 5 Ko        , Co          , Aa          , Aa          , Aa          , Aa          , Rd          , Aa          , Aa          , Aa          , Mm          , Mm          , Mm          , Mm          , Mm          , Mm          
Ha^Fpa      , Ha          , Ha^Fpa      , Mm          , Mm          , Mm          , Mm          , Mm          , Mm          , Ha          , Rd          , Rd          , Aa          , Rd          , Rd          , Rd          , Mm          , Mm          , Mm          , Mm          , Mm          , Mm          , Mm          , Mm          , Mm          , Mm          , Mm          , Mm          , Mm          , Mm          , Mm          , Mm          , Mm          , Mm          , Aa          , Aa          , Aa          , Aa          , Aa          , Aa          , Aa          , Aa          , Aa^Fpa      , Aa          , Aa          , Co          , Co          , Rd          , Rd          , Aa          , Rd          , Rd          , Aa^Fpa      , Aa          , Aa^Fpa      , Mm          , Mm          , Mm          , Mm          , Mm          , Mm          , Mm          
Ha^Fpa      , Ha^Fpa      , Mm          , Mm          , Mm          , Mm          , Mm          , Mm          , Aa          , Rd          , Aa          , Mm          , Mm          , Ha^Voa       , Mm          , Mm          , Mm          , Mm          , Mm          , Mm          , Mm          , Mm          , Mm          , Mm          , Aa          , Mm          , Mm          , Mm          , Mm          , Mm          , Mm          , Mm          , Mm          , Aa          , Aa          , Aa          , Aa          , Aa          , Mm          , Mm          , Mm          , Aa          , Aa          , Aa          , Aa          , Co          , Aa          , Aa          , Aa          , Rd          , Ha^Voa       , Aa          , Aa          , Aa          , Mm          , Mm          , Mm          , Mm          , Mm          , Mm          , Mm          , Mm          
Mm          , Mm          , Mm          , Mm          , Mm          , Mm          , Aa          , Aa          , Rd          , Rd          , Mm          , Mm          , Mm          , Mm          , Mm          , Mm          , Mm          , Mm          , Aa          , Mm          , Mm          , Mm          , Mm          , Ha^Voa       , Mm          , Mm          , Mm          , Mm          , Mm          , Mm          , Mm          , Mm          , Mm          , Mm          , Mm          , Mm          , Mm          , Mm          , Mm          , Mm          , Mm          , Mm          , Mm          , Mm          , Mm          , Aa          , Mm          , Mm          , Mm          , Mm          , Mm          , Mm          , Mm          , Mm          , Mm          , Mm          , Mm          , Mm          , Mm          , Mm          , Mm          , Mm          
Mm          , Mm          , Mm          , Mm          , Mm          , Mm          , Mm          , Aa          , Rd          , Mm          , Mm          , Mm          , Mm          , Mm          , Mm          , Mm          , Mm          , Mm          , Aa          , Mm          , Mm          , Mm          , Mm          , Aa          , Mm          , Mm          , Mm          , Mm          , Mm          , Mm          , Mm          , Mm          , Mm          , Mm          , Mm          , Mm          , Mm          , Mm          , Mm          , Mm          , Mm          , Mm          , Mm          , Mm          , Mm          , Mm          , Mm          , Mm          , Mm          , Mm          , Mm          , Mm          , Mm          , Mm          , Mm          , Mm          , Mm          , Mm          , Mm          , Mm          , Mm          , Mm          
