border_size=1
usage=map

Wo, Wo, Wo, Wo, Wo, Ww, Ww, Ww, Aa, Aa, Ha, Ha, Ha, Ha, Ha, Ha, Ha, Ha, Aa, Aa, Aa, Aa, Aa, Aa, Ha, Aa, Aa, Aa, Aa, Aa, Aa^Fpa, Aa, Aa, Aa^Fpa, Aa^Fpa, Aa, Aa, Aa, Aa, Aa, Aa, Aa, Aa, Aa, Aa, Aa, Aa
Wo, Wo, Wo, Wo, Wo, Ww, Ww, Ww, Aa, Aa, Aa, Ha, Aa, Aa, Aa, Aa, Aa, Aa, Aa, Aa, Aa, Aa, Ha^Fpa, Ha, Ha, Aa, Aa, Aa, Aa^Fpa, Aa, Aa^Fpa, Aa^Fpa, Aa, Aa^Fpa, Aa^Fpa, Aa, Aa, Aa^Fpa, Aa, Aa, Aa, Aa, Aa, Aa, Aa, Aa, Aa^Fpa
Wo, Wo, Wo, Wo, Ww, Ww, Aa, Aa, Aa, Aa, Gg, Aa, Gg, Aa, Gg, Gg, Aa^Fpa, Aa^Fpa, Aa^Fpa, Aa, Aa, Ha, Gg, Ha^Fpa, Ha, Aa, Gg, Aa, Aa, Aa^Fpa, Aa, Aa, Gg, Aa^Fpa, Gg, Aa^Fpa, Aa^Fpa, Aa, Aa, Aa, Gg, Aa, Aa, Aa, Aa, Aa^Fpa, Gg
Wo, Wo, Wo, Ww, Ww, Ww, Aa, Aa, Gg, Aa, Gg, Gg, Gg, Aa, Aa, Aa^Fpa, Aa, Aa^Fpa, Aa^Fpa, Gg, Gg, Aa, Ha, Ha^Fpa, Aa^Fpa, Aa, Gg, Gg, Aa, Aa, Aa, Aa, Gg, Aa, Aa^Voa, Aa, Gg, Aa, Aa, Gg, Aa, Gg, Aa^Fpa, Gg, Aa, Aa^Fpa, Gg
Wo, Wo, Wo, Ww, Ww, Ww, Ww, Gg, Aa, Gg, Aa, Aa, Aa, Aa^Fpa, Gg, Gg, Gg, Gg, Aa^Fpa, Gg, Aa, Ha, Aa^Fpa, Ha^Fpa, Gg, Gg, Gg, Aa, Gg, Gg, Gg, Aa, Aa^Fpa, Gg, Aa, Aa, Gg, Aa, Aa^Fpa, Aa, Aa, Aa, Aa, Aa^Fpa, Gg, Aa, Gg
Wo, Wo, Wo, Ww, Ww, Aa, Gg, Gg, Gg, Gg, Aa, Aa, Aa^Fpa, Aa^Fpa, Gg, Gg, Aa, Aa, Aa^Fpa, Aa^Fpa, Aa^Fpa, Gg, Aa, Aa^Fpa, Aa, Aa, Aa, Aa, Gg, Aa, Gg, Gg, Aa, Aa, Ha^Fpa, Aa, Ha, Aa, Ha^Fpa, Aa, Aa, Aa, Aa, Aa, Aa, Aa, Gg
Wo, Wo, Ww, Ww, Ww, Ww, Aa, Aa, Ha, Aa, Aa^Fpa, Aa^Fpa, Ha, Gg, Gg, Gg, Aa^Fpa, Gg, Aa^Fpa, Aa^Fpa, Aa, Aa, Gg, Gg, Aa^Fpa, Gg, Gg, Aa, Aa, Aa, Gg, Aa^Fpa, Aa, Aa^Fpa, Ha^Fpa, Ha, Ha, Ha^Fpa, Ha, Ha^Fpa, Ha^Fpa, Aa^Fpa, Aa, Aa, Aa, Gg, Gg
Wo, Wo, Ww, Ww, Ww, Aa, Gg, Aa, Ha, Ha^Fpa, Aa^Fpa, Gg, Ha^Fpa, Ha, Gg, Aa^Fpa, Gg, Gg, Gg, Gg, Aa, Aa, Gg, Gg, Aa^Fpa, Aa^Fpa, Ha, Aa, Gg, Gg, Aa, Aa^Fpa, Ha, Ha, Ha, Ha, Ha, Ha, Aa, Aa, Aa^Fpa, Aa, Aa, Aa^Voa, Aa, Gg, Gg
Wo, Wo, Ww, Ww, Ww, Ww, Gg, Ha, Hh, Ha, Ha, Ha, Ha, Gg, Gg, Gg, Gg, Gg, Gg, Gg, Gg, Aa, Aa, Aa^Fpa, Aa^Fpa, Ha, Ha, Aa, Aa, Aa, Gg, Aa, Gg, Aa, Aa, Ha, Aa, Aa, Gg, Aa, Aa, Gg, Gg, Aa, Aa, Gg, Aa
Wo, Wo, Wo, Ww, Ww, Ww, Gg, Hh, Hh, Hh, Hh, Hh, Aa, Gg, Gg, Gg, Gg, Gg, Re^Gvs, Re, Aa, Aa, Gg, Gg, Gg, Ha, Aa, Aa, Aa, Aa, Aa, Aa, Coa, Aa, Aa, Aa, Gg, Gg, Gg, Gg, Aa, Aa, Aa, Aa, Cea, Cea, Aa
Wo, Wo, Wo, Ww, Ww, Ww, Gg, Hh, Gg, Gg, Gg, Aa, Gg, Gg, Aa, Aa, Gg, Re^Gvs, Gg, Gg, Gg, Gg, Aa, Aa, Aa, Aa, Aa^Fpa, Aa^Fpa, Aa, Gg, Gg, Coa, 3 Koa, Coa, Aa, Aa, Gg, Gg, Gg, Gg, Gg, Gg, Aa, Gg, Cea, 1 Kea, Gg
Wo, Wo, Wo, Ww, Ww, Ww, Ds, Gg, Hh, Hh, Re^Gvs, Hh, Hh, Aa, Re, Re, Gg, Re^Gvs, Re^Gvs, Aa, Gg, Gg, Gg, Gg, Gg, Gs^Fp, Gs^Fp, Aa^Fpa, Gg, Gs^Fp, Gs^Fp, Co, Co, Coa, Aa, Aa, Aa^Voa, Gg, Gg, Gg, Gg, Aa, Aa, Aa, Rb, Cea, Re
Wo, Wo, Wo, Wo, Ww, Ww, Ds, Gg, Re^Gvs, Re^Gvs, Gg, Hh, Gg, Re, Gg, Gg, Re^Gvs, Re^Gvs, Gg, Gg, Re, Gg, Aa, Gg, Gg, Gs^Fp, Gg, Gg, Re^Gvs, Re^Gvs, Gg, Gg, Re, Aa, Aa, Gg, Aa, Gg, Aa, Gg, Gg, Gg, Re, Re, Aa, Re, Gg
Wo, Wo, Wo, Wo, Ww, Ww, Ds, Gg, Gg, Re^Gvs, Re^Gvs, Re^Gvs, Re, Gg, Re, Re, Gg, Re^Gvs, Gg, Re, Re, Gg, Gg, Aa, Re, Re, Gg, Re^Gvs, Re^Gvs, Re^Gvs, Gg, Re, Re, Gg, Gg, Aa, Gg, Aa, Aa, Gg, Re, Re, Aa, Aa, Aa, Aa, Aa
Wo, Wo, Wo, Wwr, Wwr, Ww, Ww, Ds, Gg, Re, Re, Re, Gg, Gg, Co, Re, Gg, Gg, Re, Re, Re, Gg, Gg, Re, Gg, Gg, Gg, Re^Gvs, Re^Gvs, Gg, Re, Re, Gg, Gg, Gg, Gg, Gg, Aa, Gg, Gg, Re, Gg, Aa, Aa, Aa, Aa, Gg
Wo, Wo, Wo, Wwr, Wwr, Ww, Ww, Ds, Gg^Vo, Gg, Co, Gg, Gg, Co, Re, Co, Gg, Gg, Gg, Re, Re, Gg, Re, Re, Re, Gg, Gg, Gg, Re, Re, Gg, Gg, Gg, Gg, Re, Gg, Re, Aa, Re, Re, Gg, Gg, Gg, Gg, Aa, Aa, Gg
Wo, Wo, Wo, Wo, Wwr, Ww, Ww, Co, Co, Co, Re, Re, Re, Re, Re, Gg, Re, Gg, Re, Re, Hh, Re, Hh, Hh, Hh, Re, Re, Re, Re, Re, Re, Gg, Re, Re, Gg, Re, Gg, Re, Gg, Aa, Gg, Aa, Aa, Gg, Aa, Aa, Gg
Wo, Wo, Wo, Wo, Wo, Wwr, Ww, Ww, Re, Co, Re, Co, Re, Co, Re, Re, Re, Re, Gg, Gg, Gg, Hh^Vo, Hh, Hh, Re, Re, Gg, Gg, Gg, Re, Gg, Re, Gg, Gg, Gg, Re, Re, Aa^Voa, Aa, Aa, Gg, Gg, Aa, Gg, Gg, Gg, Gg
Wo, Wo, Wo, Wo, Wo, Wo, Ww, Ww, Ww, Re, Gg^Vo, Re, Ch, Re, Re, Co, Re, Gg, Gg, Co, Co, Hh, Re, Re, Gg, Re, Re, Re, Gs^Fp, Gg, Gs^Fp, Gs^Fp, Gs^Fp, Gg, Re, Gg, Re, Aa, Aa, Gg, Gg, Gg, Gg, Gg, Gg, Gg, Gs^Fp
Wo, Wo, Wo, Wo, Wo, Wo, Ww, Ww, Ww^Bw/, Ds, Ch, Ch, Kh, 2 Ch, Re, Co, Re, Re, Gg, Gg, Co, Gg, Re, Gg, Re, Re, Gs^Fp, Gs^Fp, Gg, Re, Re, Gs^Fp, Gs^Fp, Gs^Fp, Gg, Gg, Co, Coa, Co, Gg, Gg, Gg, Gg, Gg, Gs^Fp, Gs^Fp, Gs^Fp
Wo, Wo, Wo, Wo, Wo, Wo, Ww, Ww, Ww, Ds, Kh, Ch, Ch, Ch, Re, Re, Re, Re, Gg, Co, Gg, Gg, Re, Re, Gs^Fp, Gs^Fp, Re^Gvs, Re^Gvs, Re^Gvs, Gs^Fp, Gs^Fp, Gs^Fp, Gs^Fp, Gg, Re, Re, Co, 4 Ko, Co, Gg, Ss, Ss, Ss, Gs^Fp, Gs^Fp, Gs^Fp, Gs^Fp
Wo, Wo, Wo, Wo, Wo, Wo, Ww, Ww, Ww^Bw/, Ds, Ds, Ch, Gg, Re, Re, Co, Re, Re, Gg, Gg, Gg, Re, Gg, Gg, Gs^Fp, Gs^Fp, Re^Gvs, Re^Gvs, Gs^Fp, Gs^Fp, Gs^Fp, Gs^Fp, Re, Re, Re, Re, Gg, Co, Ss, Ss, Ww, Ww, Ss, Gs^Fp, Gs^Fp, Gs^Fp, Gs^Fp
Wo, Wo, Wo, Wo, Wo, Wo, Wo, Ww, Ww, Ww, Ww^Bw/, Gg, Re, Re, Co, Re, Re, Gg^Vc, Gg, Gg, Gg, Gg, Gg, Gs^Fp, Gg, Gg, Gg, Gs^Fp, Gg, Gs^Fp, Gg, Re, Gs^Fp, Gg, Gs^Fp, Gg, Ss, Gg, Ss, Ss, Ss, Ss, Gs^Fp, Gs^Fp, Gs^Fp, Gs^Fp, Gs^Fp
Wo, Wo, Wo, Wo, Wo, Wo, Wo, Wo, Wo, Ww, Ww, Ww, Ww, Re, Re, Re, Re, Re, Re, Gg, Co, Gg, Gg, Gg, Ds, Ds, Ds, Gg, Ds, Ds, Gg, Gs^Fp, Gs^Fp, Gs^Fp, Gs^Fp, Gg, Ss, Ss, Ss, Gg, Gg, Gg, Gg^Vc, Gs^Fp, Gs^Fp, Gs^Fp, Gs^Fp
Wo, Wo, Wo, Gs^Fp, Gs^Fp, Wo, Wo, Wo, Wo, Ww, Ww, Ww, Ww, Re, Gg, Gg, Ds, Gg, Gg, Co, Gg, Gg, Ds, Ds, Gg, Ds, Ds, Ds, Ds, Ds, Ds, Gg, Ds, Gg, Gg, Gg, Ss, Ww, Ww, Gg, Gg, Gg, Gg, Gs^Fp, Ds, Gs^Fp, Gs^Fp
Wo, Wo, Wo, Gs^Fp, Gs^Fp, Wo, Wo, Wo, Wo, Wwr, Ww, Ww, Ww, Ds, Ds, Ds, Ss, Ss, Ss, Co, Gg, Gg, Ds, Ds, Ds, Ds, Ds, Gg, Ds, Ds, Ds, Ds, Gg, Gg, Gg, Gg, Ss, Ww, Ww, Ww, Ww, Gg, Ds, Ds, Ds, Ds, Ds
Wo, Wo, Wo, Wo, Wo, Wo, Wo, Wo, Wo, Wo, Wwr, Ww, Ww, Ds, Ss, Ss, Co, Co, Ss, Gg, Gg, Ds, Gg, Gg, Ds, Ds, Ds, Gg, Gg, Ds, Gg, Gg^Vc, Gg, Gg, Ss, Ss, Ss, Ss, Ww, Ww, Ww, Ds, Gg, Ds, Ss, Ds, Ss
Wo, Wo, Wo, Wo, Wo, Wo, Wo, Wo, Ww, Wo, Wwr, Wwr, Ww, Co, Co, Co, Ss, Ss, Ss, Gg, Gg, Gg, Gg, Ds, Gg, Ds, Gg, Gg, Gg, Ss, Gg, Gg, Gg, Gg, Gg, Ss, Ss, Ss, Ww, Ss, Ds, Ds, Ds, Gg, Gg, Ss, Gg
Wo, Wo, Wo, Wo, Wo, Wo, Hh, Gs^Fp, Gg, Ww, Ww, Ww, Ww, Ww, Ds, Ds, Ds, Ss, Ss, Gg, Ss, Ss, Ds, Gg, Ds, Ss, Gg, Gg, Gg, Ss, Gg, Gg, Gg, Ss, Gg, Chs, Khs, Chs, Chs, Ss, Ss, Ds, Gg, Gg, Ss, Ss, Ss
Wo, Wo, Wo, Wo, Wo, Wo, Gs^Fp, Hh^Fp, Gg, Gs^Fp, Ww, Ww, Ww, Ww, Ds, Ds, Ss, Ss, Ww, Ss, Ss, Ss, Ss, Ds, Ss, Ss, Gg, Ss, Ds, Ds, Ds, Gg, Ss, Gg, Ss, Ss, Ss, Ss, Gg, Gg, Ss, Ds, Ss, Ss, Ss, Ss, Ss
Wo, Wo, Wo, Wo, Wo, Wo, Ww, Hh^Vc, Hh, Hh^Fp, Ww, Ww, Ww, Ww, Ds, Ss, Ss, Ww, Ww, Ss, Ds, Ss, Ds, Ds, Ss, Gg, Ss, Ds, Ss, Ss, Ss, Gg, Gg, Ss, Ss, Ww, Ds, Ds, Ss, Ss, Ss, Ss, Gg, Gg, Gs^Fp, Ss, Gg
Wo, Wo, Wo, Wo, Wo, Wo, Wwr, Ww, Ww, Gg, Ww, Ww, Ww, Ww, Ds, Ss, Ss, Ss, Ss, Ss, Gg, Ds, Ss, Ss, Gg, Gg, Ss, Ss, Gg, Gg, Ss, Gg, Ss, Ww, Ss, Ds, Ds, Ss, Gg, Ss, Gg, Gg, Gs^Fp, Gs^Fp, Gs^Fp, Gs^Fp, Gg
Wo, Wo, Wo, Wo, Wo, Wo, Wwr, Wwr, Wwr, Ww, Ww, Ww, Ww, Ww, Ds, Ss, Ss, Ds, Ds, Gg, Ss, Ss, Ww, Ww, Ss, Ss, Ss, Gg, Ww, Ww, Ww, Ss, Ss, Ww, Ss, Ds, Ss, Ss, Gg, Gg, Gs^Fp, Gg, Gs^Fp, Gs^Fp, Gs^Fp, Gg, Gg
Wo, Wo, Wo, Wo, Wo, Wo, Wo, Wwr, Wo, Wwr, Wwr, Ww, Ww, Ww, Ss, Ss, Ss, Ss, Ss, Ss, Ww, Ss, Ww, Ww, Ss, Ss, Ww, Ww, Ss, Ss, Ww, Ww, Ww, Ss, Ds, Ss, Ds, Ss, Gg, Gs^Fp, Gg, Gg^Vo, Gs^Fp, Gs^Fp, Gg, Gs^Fp, Gs^Fp
Wo, Wo, Wo, Wo, Wo, Wo, Wo, Wo, Wo, Wwr, Wo, Wo, Ww, Ww, Ss, Ss, Ss, Ss, Ww, Ww, Ww, Ww, Ww, Ds, Ww, Ds, Ds, Gg, Ss, Ss, Gg, Gg, Ss, Ss, Ss, Ds, Ds, Gg, Gg, Gg, Gg, Gs^Fp, Gs^Fp, Gs^Fp, Gg, Gs^Fp, Gg
Wo, Wo, Wo, Wo, Wo, Wo, Wo, Wo, Wo, Wo, Wo, Wo, Ww, Ww, Ww, Ww, Ss, Ww, Ww, Ww, Ds, Ss, Ss, Ww, Ss, Ds, Ss, Ss, Ss, Ss, Ss, Ss, Gg, Ss, Ds, Ds, Gg, Gg, Gg, Gg, Gg, Gs^Fp, Gg, Gs^Fp, Gs^Fp, Gs^Fp, Gg
Ww, Wo, Wo, Wo, Wo, Wo, Wo, Wo, Wo, Wo, Wo, Wo, Ww, Ww, Ww, Ww, Ww, Ww, Ww, Ss, Ss, Gg, Ss, Ss, Gg, Ss, Ss, Ss, Ss, Ss, Ss, Ss, Ss, Ss, Gg, Gg, Gg, Gg, Gg, Gg, Gg, Gg, Gs^Fp, Gs^Fp, Gg, Gg, Gg
