border_size=1
usage=map

Ai          , Ai          , Ai          , Ai          , Mm          , Mm          , Mm          , Mm          , Mm          , Mm          , Aa^Fpa      , Aa^Fpa      , Aa^Fpa      , Aa^Fpa      , Ha          , Ha          , Ha          , Ha          , Ha          , Ai          , Ai          , Aa          , Aa          , Aa          , Aa          , Aa          , Aa          , Aa          , Aa^Fpa      , Aa^Fpa      , Aa^Fpa      , Aa^Fpa      
Ai          , Ai          , Ai          , Ai          , Mm          , Mm          , Mm          , Mm          , Mm          , Mm          , Aa^Fpa      , Aa^Fpa      , Ha^Fpa      , Ha^Fpa      , Ha          , Ha^Vhha     , Ha          , Ha          , Ha          , Ai          , Ai          , Aa          , Aa          , Aa          , Aa          , Aa          , Aa          , Aa          , Aa^Fpa      , Aa^Fpa      , Aa^Fpa      , Aa^Fpa      
Ai          , Ai          , Ai          , Ai          , Ai          , Mm          , Mm          , Mm          , Mm^Vhh      , Aa^Fpa      , Aa^Fpa      , Aa^Fpa      , Aa^Fpa      , Ha^Fpa      , Ha          , Ha          , Co          , Co          , Co          , Co          , Ai          , Aa          , Aa          , Aa          , Aa          , Aa^Vca      , Aa^Fpa      , Aa^Fpa      , Aa^Fpa      , Aa^Fpa      , Aa^Fpa      , Aa^Fpa      
Ai          , Ai          , Ai          , Ai          , Mm          , Ai          , Mm          , Mm          , Mm          , Mm          , Mm          , Aa          , Aa          , Aa^Fpa      , Mm          , Co          , Co          , 4 Ko        , Co          , Ai          , Ai          , Aa          , Aa          , Aa          , Aa          , Aa          , Co          , Aa^Fpa      , Aa^Fpa      , Aa^Fpa      , Aa^Fpa      , Aa^Fpa      
Ai          , Ai          , Aa          , Aa^Vha      , Mm          , Ai          , Ai          , Mm          , Mm          , Mm          , Mm          , Mm          , Mm          , Ha          , Ha          , Ha          , Co          , Co          , Aa          , Aa^Voa      , Ai          , Aa          , Ha          , Ha          , Co          , Co          , Co          , Aa^Fpa      , Aa^Fpa      , Aa^Fpa      , Aa^Fpa      , Aa^Fpa      
Aa          , Aa          , Mm          , Mm          , Mm          , Mm          , Mm          , Ai          , Ai          , Mm          , Mm          , Mm          , Mm          , Ha          , Ha          , Ha^Voa      , Aa^Fpa      , Aa          , Aa^Fpa      , Ai          , Ai          , Aa          , Ai          , Aa          , Aa          , Co          , 5 Ko        , Co          , Aa^Fpa      , Aa^Fpa      , Aa^Fpa      , Aa^Fpa      
Mm          , Mm          , Mm          , Mm          , Mm          , Mm          , Mm          , Mm          , Aa^Fpa      , Ai          , Ai          , Ha^Vca      , Ha          , Ha          , Ha^Fpa      , Ha          , Ha^Fpa      , Aa^Fpa      , Aa^Fpa      , Aa          , Aa^Fpa      , Ai          , Aa^Voa      , Ai          , Ai          , Co          , Co          , Co          , Aa^Fpa      , Aa^Fpa      , Aa^Fpa      , Aa^Fpa      
Mm          , Mm          , Mm          , Mm          , Mm          , Mm          , Mm          , Aa^Fpa      , Aa^Fpa      , Aa^Fpa      , Ai          , Aa^Fpa      , Ha          , Ha          , Aa^Fpa      , Aa^Fpa      , Aa          , Ha          , Aa          , Aa^Fpa      , Aa^Fpa      , Aa^Fpa      , Aa^Fpa      , Ha          , Mm          , Ai          , Ai          , Ai          , Aa^Fpa      , Aa^Fpa      , Aa^Fpa      , Aa^Fpa      
Mm          , Mm^Vhh      , Mm          , Mm          , Aa          , Aa^Voa      , Aa^Fpa      , Aa^Fpa      , Aa^Fpa      , Aa^Fpa      , Aa^Fpa      , Ai          , Ha          , Ha          , Aa^Fpa      , Ha^Vhha     , Aa          , Aa          , Aa          , Aa          , Aa^Fpa      , Aa^Fpa      , Ha^Fpa      , Ha^Fpa      , Ha^Fpa      , Ha          , Ha          , Ai          , Ai          , Aa^Fpa      , Aa^Fpa      , Aa^Fpa      
Mm          , Mm          , Mm          , Mm          , Aa          , Aa          , Aa^Fpa      , Aa^Fpa      , Ha^Fpa      , Aa^Fpa      , Aa^Fpa      , Ai          , Ai          , Ai          , Aa          , Aa          , Aa          , Aa          , Aa^Fpa      , Aa^Fpa      , Aa^Fpa      , Aa^Fpa      , Ha          , Ha^Fpa      , Ha          , Ha          , Ha^Voa      , Mm          , Ai          , Aa^Fpa      , Aa^Fpa      , Aa^Fpa      
Mm          , Mm          , Mm          , Mm          , Mm          , Aa          , Aa^Fpa      , Ha^Fpa      , Ha          , Aa^Fpa      , Aa^Fpa      , Aa^Fpa      , Ai          , Aa^Fpa      , Aa          , Aa          , Aa          , Aa          , Aa          , Ha          , Aa          , Ha^Vhha     , Ha          , Ha          , Ha          , Ha          , Mm          , Mm          , Ai          , Aa^Fpa      , Aa^Fpa      , Aa^Fpa      
Mm          , Mm          , Ce          , Ha          , Ha          , Mm          , Ha          , Ha          , Mm          , Mm          , Aa          , Aa^Fpa      , Ai          , Aa          , Aa          , Aa          , Aa^Voa      , Aa          , Aa          , Aa          , Aa          , Ha          , Mm          , Mm          , Mm          , Mm          , Mm          , Mm          , Mm          , Ai          , Mm          , Mm          
Ha          , Ce          , 3 Ke        , Ce          , Ha          , Ha          , Ha          , Mm          , Ai          , Ha          , Ai          , Ai          , Aa          , Aa          , Aa          , Aa          , Aa          , Aa          , Aa          , Aa          , Ha          , Mm          , Mm          , Mm          , Mm          , Mm          , Mm          , Mm          , Ai          , Ai          , Mm          , Mm          
Ha          , Ce          , Ce          , Ce          , Ha          , Ha          , Ha^Voa      , Ha          , Ai          , Ai          , Ai          , Aa          , Aa          , Aa          , Aa          , Aa          , Aa          , Aa          , Ha          , Ha          , Ha          , Mm          , Mm          , Mm          , Mm^Vhh      , Mm          , Mm          , Ai          , Mm          , Mm          , Mm          , Mm          
Ha          , Ha          , Ha          , Ha          , Ai          , Ha          , Ai          , Ai          , Ai          , Ai          , Ai          , Aa          , Aa^Voa      , Ha          , Ha          , Ha          , Ha          , Ha          , Ha          , Ha          , Ha          , Mm          , Mm          , Mm          , Mm          , Mm          , Mm          , Ai          , Mm          , Mm          , Mm          , Mm          
Ha          , Ha          , Ai          , Ai          , Ha^Voa      , Ai          , Ce          , Aa          , Aa          , Aa          , Aa          , Aa          , Ha          , Ha          , Ha^Fpa      , Ha          , Ha          , Ha^Vhha     , Ha          , Ha          , Mm          , Mm          , Mm          , Mm          , Mm          , Mm          , Mm          , Ai          , Mm          , Mm          , Mm          , Mm          
Ha          , Ha          , Ai          , Ha          , Aa          , Ce          , 1 Ke        , Ce          , Aa          , Aa          , Aa^Fpa      , Aa^Fpa      , Aa^Fpa      , Aa^Fpa      , Ha          , Ha          , Ha          , Ha          , Ha          , Ha          , Mm          , Mm          , Mm          , Aa          , Aa          , Aa^Vha      , Ai          , Ai          , Mm          , Mm          , Mm          , Mm          
Ai          , Ai          , Aa          , Aa          , Aa          , Ce          , Ce          , Ce          , Aa^Fpa      , Aa^Fpa      , Mm          , Ha          , Ce          , Ce          , Ce          , Ha          , Aa^Fpa      , Ha          , Ha          , Mm^Vhh      , Mm          , Mm          , Mm          , Mm          , Aa          , Aa          , Ai          , Mm          , Mm          , Mm          , Mm          , Mm          
Ai          , Ai          , Aa          , Aa^Voa      , Aa          , Aa          , Aa^Fpa      , Aa^Fpa      , Aa^Fpa      , Aa^Fpa      , Mm          , Mm          , Ce          , 2 Ke        , Ce          , Ha          , Mm          , Aa^Fpa      , Ha^Fpa      , Ha^Fpa      , Mm          , Mm          , Mm          , Mm          , Mm          , Ai          , Ai          , Ai          , Ai          , Mm          , Mm          , Mm          
Ai          , Ai          , Aa          , Aa          , Aa          , Aa^Fpa      , Aa^Fpa      , Aa^Fpa      , Aa^Fpa      , Aa^Fpa      , Mm          , Mm          , Mm          , Ce          , Mm          , Aa^Fpa      , Mm          , Mm          , Ha^Fpa      , Ha^Fpa      , Aa^Fpa      , Mm          , Mm          , Mm          , Mm          , Ai          , Ai          , Ai          , Mm          , Mm          , Mm          , Mm          
Aa          , Aa          , Aa          , Aa          , Aa^Fpa      , Aa^Fpa      , Aa^Fpa      , Aa^Fpa      , Mm          , Mm          , Mm          , Mm          , Mm          , Mm          , Mm          , Mm          , Mm          , Aa^Fpa      , Ha          , Ha          , Aa^Fpa      , Mm          , Mm          , Mm          , Mm          , Mm          , Ai          , Mm          , Mm          , Mm          , Mm          , Mm          
Aa          , Aa          , Aa          , Aa          , Aa^Fpa      , Aa^Fpa      , Aa^Fpa      , Aa^Fpa      , Mm          , Mm          , Mm          , Mm          , Mm          , Mm          , Mm          , Mm          , Mm          , Aa^Fpa      , Aa^Fpa      , Ha          , Aa^Fpa      , Mm          , Mm          , Mm          , Mm          , Mm          , Ai          , Mm          , Mm          , Mm          , Mm          , Mm          
