border_size=1
usage=map

Aa          , Aa          , Ha          , Ha          , Ha          , Mm          , Mm          , Mm          , Mm          , Mm          , Mm          , Mm          , Mm          , Mm          , Mm          , Mm          , Mm          , Mm          , Mm          , Mm          , Mm          , Mm          , Mm          , Mm          , Ha          , Ha          , Mm          , Mm          , Mm          , Mm          , Mm          , Mm          , Mm          , Mm          , Mm          , Mm          , Mm          , Mm          , Mm          , Mm          
Aa^Fpa      , Aa          , Ha          , Ha          , Ha          , Mm          , Mm          , Mm          , Mm          , Mm          , Mm          , Mm          , Mm          , Mm          , Mm          , Mm          , Mm          , Mm          , Mm          , Mm          , Mm          , Mm          , Mm          , Mm          , Ha          , Ha          , Mm          , Mm          , Mm          , Mm          , Mm          , Mm          , Mm          , Mm          , Mm          , Mm          , Mm          , Mm          , Mm          , Mm          
Aa^Fpa      , Aa^Fpa      , Aa^Fpa      , Aa^Fpa      , Ha          , Mm          , Ha          , Mm          , Mm          , Mm          , Mm          , Mm          , Mm          , Mm          , Mm          , Mm          , Mm          , Mm          , Ha          , Ha          , Ha          , Ha          , Ha          , Ha          , Ha          , Ha          , Mm          , Mm          , Mm          , Mm          , Mm          , Mm          , Mm          , Mm          , Mm          , Mm          , Mm          , Mm          , Mm          , Mm          
Aa          , Aa^Fpa      , Aa^Fpa      , Ha          , Aa          , Ha          , Ha          , Mm          , Mm          , Mm          , Ha          , Mm          , Mm          , Mm          , Ha          , Ha          , Aa^Fpa      , Ha          , Ha          , Ha          , Ha          , Ha          , Ha          , Ha          , Ha          , Mm          , Mm          , Mm          , Mm          , Mm          , Mm          , Mm          , Mm          , Mm          , Mm          , Mm          , Mm          , Mm          , Mm          , Mm          
Aa          , Aa          , Aa^Fpa      , Aa^Fpa      , Aa          , Ha          , Ha          , Ha          , Ha          , Ha          , Ha          , Ha          , Ha          , Ha          , Aa^Fpa      , Aa^Fpa      , Aa^Fpa      , Aa^Fpa      , Ha          , Aa^Vha      , Ha          , Ha          , Ha          , Ha          , Ai          , Mm          , Ai          , Mm          , Mm          , Mm          , Mm          , Mm          , Mm          , Mm          , Mm          , Mm          , Mm          , Ha          , Mm          , Mm          
Aa          , Aa^Fpa      , Aa^Fpa      , Aa^Fpa      , Aa          , Aa          , Ha          , Ha          , Ha          , Ha          , Ha          , Ha          , Ha          , Ha          , Ha          , Aa          , Ha          , Ha          , Ha          , Ha          , Ha          , Ha          , Ha          , Ai          , Ai          , Ai          , Ww          , Ai          , Ha          , Mm          , Mm          , Mm          , Mm          , Mm          , Mm          , Mm          , Ha          , Ha          , Ha          , Ha          
Aa          , Aa          , Aa          , Aa          , Aa          , Aa          , Aa          , Aa          , Aa          , Aa          , Ha          , Ha          , Aa          , Aa          , Aa          , Aa          , Aa          , Aa          , Aa          , Ha          , Ha          , Ha          , Ww          , Ww          , Ww          , Ww          , Ai          , Ai          , Ha          , Ha          , Ha          , Mm          , Mm          , Mm          , Mm          , Mm          , Mm          , Mm          , Mm          , Mm          
Gg          , Gg          , Gg          , Gg          , Gg          , Aa          , Aa          , Aa          , Aa          , Aa          , Aa          , Aa          , Aa          , Aa          , Aa          , Aa          , Aa          , Aa          , Ha          , Ha          , Aa^Vha      , Ha          , Ww          , Ww          , Ai          , Ww          , Ai          , Ha          , Ha          , Ha          , Ha          , Mm          , Ha          , Mm          , Ha          , Mm          , Mm          , Mm          , Ha          , Ha          
Gg          , Gg          , Gg          , Gg          , Gg          , Gg          , Gg          , Aa          , Gg          , Aa          , Gg          , Aa          , Gg          , Gg          , Re          , Gg          , Ha          , Gg          , Re          , Re          , Ha          , Ai          , Ww          , Ww          , Ha          , Ai          , Ha          , Ha          , Ha          , Ha          , Ha          , Ha          , Ha          , Ha          , Ha          , Mm          , Ha          , Ha          , Ha          , Ha          
Gs^Fp       , Gs^Fp       , Gs^Fp       , Gg          , Gg          , Gg          , Gg          , Gg          , Gg          , Gg          , Re^Gvs      , Gg          , Re^Gvs      , Re          , Gg^Vc       , Re          , Gg          , Gg          , Re          , Gg          , Ww          , Ww          , Ai          , Ha          , Ha          , Ha          , Ha          , Ha          , Aa^Fpa      , Ha          , Aa^Fpa      , Ha          , Ha          , Ha          , Ha          , Mm          , Ha          , Ha          , Ha          , Ha          
Gs^Fp       , Gs^Fp       , Gs^Fp       , Gs^Fp       , Gs^Fp       , Gg          , Gg          , Gg          , Re^Gvs      , Re^Gvs      , Gs^Fp       , Re^Gvs      , Gg          , Re          , Re^Gvs      , Re          , Re          , Re          , Hh          , Gg          , Ww          , Ai          , Ha          , Ha          , Ha          , Ha          , Aa^Fpa      , Ha          , Aa^Fpa      , Aa^Fpa      , Aa^Fpa      , Aa^Fpa      , Ha          , Ha          , Ha          , Ha          , Mm          , Mm          , Mm          , Mm          
Gs^Fp       , Gs^Fp       , Gs^Fp       , Gs^Fp       , Gs^Fp       , Gg          , Gg          , Gg^Vc       , Gg          , Re^Gvs      , Re^Gvs      , Re^Gvs      , Re^Gvs      , Re^Gvs      , Re          , Re          , Re          , Re          , Hh          , Hh          , Ww          , Ai          , Aa          , Aa          , Aa          , Aa          , Aa^Fpa      , Aa^Fpa      , Aa          , Aa          , Aa          , Aa^Fpa      , Aa^Fpa      , Ha          , Ha          , Ha          , Ha          , Mm          , Mm          , Mm          
Gs^Fp       , Gs^Fp       , Gg          , Gg          , Gg          , Gg          , Gg          , Gg          , Gs^Fp       , Gs^Fp       , Re^Gvs      , Re^Gvs      , Re^Gvs      , Gg          , Gg^Vc       , Gg          , Re          , Hh          , Hh          , Ww          , Gs^Fp       , Gg          , Gg          , Aa          , Ha          , Aa          , Aa^Fpa      , Aa^Fpa      , Aa          , Aa^Fpa      , Aa^Fpa      , Aa^Fpa      , Aa^Fpa      , Ha          , Aa^Vha      , Ha          , Ha          , Mm          , Ha          , Ha          
Gs^Fp       , Gs^Fp       , Gg^Vh       , Gg          , Gg          , Gg          , Gg          , Gs^Fp       , Gs^Fp       , Re^Gvs      , Re          , Gg          , Re          , Re          , Re          , Gg          , Re          , Gg          , Ww          , Ww          , Gg          , Gg          , Ha          , Gs^Fp       , Gs^Fp       , Aa^Fpa      , Ha          , Aa          , Ha          , Aa^Fpa      , Ha          , Aa^Fpa      , Aa^Fpa      , Ha          , Ha          , Ha          , Ha          , Ha          , Ha          , Ha          
Gg          , Gg          , Gg          , Gg          , Gg          , Gg          , Gs^Fp       , Gg          , Gs^Fp       , Gg          , Re          , Re          , Gg^Vc       , Re          , Gg          , Re          , Gg          , Gg          , Ww          , Gg          , Gg          , Aa          , Aa          , Gs^Fp       , Aa          , Ha          , Aa          , Ha          , Aa          , Aa          , Aa          , Aa          , Gg          , Aa^Fpa      , Ha          , Ha          , Ha          , Ha          , Aa^Vha      , Aa          
Gg          , Gg          , Chr         , Gg          , Gg          , Gg          , Gg          , Gs^Fp       , Gs^Fp       , Re          , Gs^Fp       , Gg          , Gg          , Gg          , Re          , Re          , Hh          , Hh          , Hh          , Ww          , Gg          , Gg          , Aa^Vha      , Gg          , Gg          , Aa          , Gg          , Aa          , Gg          , Gg          , Gg^Vc       , Gg          , Gg          , Gg          , Ch          , Ch          , Ch          , Ha          , Ha          , Ha          
Gg          , Chr         , 1 Khr       , Chr         , Gg          , Gg^Vc       , Gg          , Gs^Fp       , Gs^Fp       , Gs^Fp       , Gs^Fp       , Gg          , Gg          , Gg          , Re          , Hh          , Hh          , Hh          , Ww          , Ww          , Gg          , Gg          , Gg          , Gg          , Aa          , Aa          , Gg          , Gg          , Aa          , Gg          , Gg          , Gg          , Gg          , Ch          , Ch          , 2 Kh        , Ch          , Ha          , Ha          , Ha          
Gg          , Chr         , Chr         , Chr         , Re          , Gg          , Gg          , Gg          , Gs^Fp       , Gs^Fp       , Gs^Fp       , Gg          , Gg          , Gg          , Re          , Hh          , Hh          , Hh          , Ww          , Gg          , Re          , Gg          , Re          , Re          , Gg          , Gg          , Gg          , Gg          , Gg          , Gg          , Rr          , Rr          , Rr          , Gg          , Rr          , Rr          , Ch          , Ha          , Aa^Fpa      , Aa^Fpa      
Gg          , Gg          , Gg^Vh       , Gg          , Gg          , Re          , Re          , Gg          , Re          , Gs^Fp       , Gs^Fp       , Gg          , Gg^Vc       , Re          , Hh          , Hh          , Ww          , Ww          , Gg          , Gg          , Re          , Re          , Re          , Gg          , Gg          , Gg          , Gg          , Gg          , Gg          , Rr          , Gg          , Gg          , Gg          , Rr          , Gg          , Gg          , Ha          , Ha          , Aa^Fpa      , Aa^Fpa      
Gg          , Gg          , Gg          , Gg          , Gs^Fp       , Gg          , Gg          , Re          , Gg          , Re          , Re          , Gg          , Chr         , Chr         , Gg          , Hh          , Ww^Bw/      , Gg          , Gg          , Re          , Re          , Gg^Vc       , Gg          , Gg          , Hh          , Gg          , Gg          , Gg          , Gg          , Rr          , Gg          , Gg          , Gg          , Gg          , Gg          , Aa          , Aa          , Aa          , Aa^Fpa      , Aa^Fpa      
Gs^Fp       , Gs^Fp       , Gs^Fp       , Gg          , Gg          , Gs^Fp       , Gs^Fp       , Gg          , Gg          , Gg          , Gg          , Re          , Chr         , Chr         , Gg          , Chr         , Ww          , Gg          , Gg          , Re          , Gg          , Gg          , Chr         , Chr         , Gs^Fp       , Hh          , Gg          , Gg          , Rr          , Rr          , Gg          , Gg          , Gg          , Gg          , Gg          , Gg          , Gg          , Gs^Fp       , Aa^Fpa      , Ha          
Gs^Fp       , Gs^Fp       , Gs^Fp       , Gs^Fp       , Gg          , Gg          , Gg          , Gg          , Gg          , Gg^Vc       , Gg          , Gg          , Gg          , Chr         , Gg          , Gg          , Gg          , Ww          , Ww          , Gg          , Gg          , Gg          , Chr         , Chr         , Gg          , Gs^Fp       , Gg          , Gg          , Rr          , Gg          , Gg          , Gg          , Gg          , Gg^Vc       , Gg          , Gg          , Gs^Fp       , Gs^Fp       , Gs^Fp       , Gg          
Gs^Fp       , Gs^Fp       , Gs^Fp       , Gs^Fp       , Gs^Fp       , Gs^Fp       , Gs^Fp       , Gs^Fp       , Chr         , Gg          , Chr         , Gg          , Gg          , Gg          , Gg          , Gg          , Hh          , Ww          , Ww          , Gg          , Gg          , Gg          , Gg          , Rr          , Rr          , Gg          , Rr          , Rr          , Gg          , Gg          , Gg          , Gg          , Re^Gvs      , Re          , Re^Gvs      , Re^Gvs      , Gg^Vc       , Gg          , Gs^Fp       , Gs^Fp       
Gs^Fp       , Gs^Fp       , Gs^Fp       , Gs^Fp       , Gs^Fp       , Gs^Fp       , Gs^Fp       , Gs^Fp       , Chr         , Chr         , Re          , Gg          , Gg          , Gg          , Gg          , Gg          , Hh          , Hh          , Ww          , Gg          , Hh          , Hh          , Hh          , Gg          , Gg          , Rr          , Gg          , Gg          , Gs^Fp       , Gg          , Re          , Re^Gvs      , Re^Gvs      , Re^Gvs      , Re^Gvs      , Gg          , Gs^Fp       , Gs^Fp       , Gs^Fp       , Gs^Fp       
Gs^Fp       , Gs^Fp       , Gs^Fp       , Gs^Fp       , Gs^Fp       , Gs^Fp       , Gg          , Gs^Fp       , Gg          , Gg          , Re          , Gg          , Re          , Re          , Gg          , Gg          , Gg          , Gg          , Ww          , Gg          , Gg          , Hh          , Gg          , Gg          , Gg          , Gs^Fp       , Gs^Fp       , Gs^Fp       , Gs^Fp       , Re          , Gg          , Re          , Gg          , Re          , Gg          , Gg          , Gs^Fp       , Gs^Fp       , Gs^Fp       , Gs^Fp       
Gs^Fp       , Gs^Fp       , Gs^Fp       , Gs^Fp       , Gs^Fp       , Gg          , Gg          , Gg          , Gg          , Gg          , Gg          , Re          , Re          , Gg^Vc       , Re          , Re          , Gg          , Chr         , Ww          , Gg          , Gg          , Gg          , Ww          , Ww          , Ww          , Gg          , Gg          , Gs^Fp       , Gg          , Gg          , Gg          , Gg          , Gg          , Gg          , Gg          , Gs^Fp       , Gs^Fp       , Gs^Fp       , Gs^Fp       , Gs^Fp       
Gs^Fp       , Gs^Fp       , Gs^Fp       , Gs^Fp       , Gg          , Gg          , Gg          , Gs^Fp       , Re          , Re          , Re          , Re^Gvs      , Re^Gvs      , Re          , Gg          , Re          , Gg          , Chr         , Chr         , Ww          , Ww          , Ww^Bw\      , Gg          , Gg          , Gg          , Ww          , Ww          , Gg          , Gg          , Gg          , Gg          , Gg          , Gg          , Gg          , Gg          , Gs^Fp       , Gs^Fp       , Gs^Fp       , Ww          , Ww          
Gs^Fp       , Gs^Fp       , Gg          , Gg          , Gs^Fp       , Gs^Fp       , Gs^Fp       , Gs^Fp       , Gs^Fp       , Gs^Fp       , Gg          , Gg          , Re^Gvs      , Re^Gvs      , Gg^Vc       , Gg          , Gg          , Chr         , Ww          , Ww          , Gg          , Gg          , Gg          , Gg          , Gg          , Gg          , Gg          , Ww          , Ww          , Gg          , Gg          , Gg^Vc       , Gg          , Gg          , Gg          , Gg          , Ww          , Gs^Fp       , Ww          , Ww          
Gs^Fp       , Gs^Fp       , Gs^Fp       , Gs^Fp       , Gs^Fp       , Gs^Fp       , Hh          , Gg          , Hh          , Hh          , Hh          , Re          , Re          , Re          , Gg          , Gg          , Ww          , Ww          , Ww          , Gg^Vc       , Gg          , Gg          , Ww^Bw\      , Gg          , Gg          , Gg          , Gg          , Ww          , Gg          , Ww          , Ww          , Gg          , Ww^Bw|      , Gg          , Ww          , Ww          , Gg          , Ww          , Gg          , Gg          
Gs^Fp       , Gs^Fp       , Gs^Fp       , Gs^Fp       , Gs^Fp       , Gs^Fp       , Hh          , Hh          , Hh          , Hh          , Hh          , Gg          , Gs^Fp       , Gs^Fp       , Gs^Fp       , Gg          , Ww          , Gg          , Gg          , Ww          , Ww          , Ww          , Ww          , Ww          , Ww          , Ww          , Ww          , Gg          , Gg          , Gg          , Gg          , Ww          , Gg          , Ww          , Gg          , Gg          , Gg          , Gg          , Gg          , Gg          
Gs^Fp       , Gs^Fp       , Gs^Fp       , Gs^Fp       , Gs^Fp       , Gs^Fp       , Gs^Fp       , Hh          , Gg          , Gs^Fp       , Gs^Fp       , Gs^Fp       , Gs^Fp       , Gs^Fp       , Ww          , Ww          , Gg          , Gg          , Gg          , Gg          , Ww          , Ww          , Wo          , Ww          , Ww          , Ww          , Gg          , Gg          , Gg          , Gg          , Gg          , Gg          , Gg          , Gg          , Gg          , Gg          , Gg          , Gg          , Gg          , Gg          
Gs^Fp       , Gs^Fp       , Gs^Fp       , Gs^Fp       , Gs^Fp       , Gs^Fp       , Gs^Fp       , Gs^Fp       , Gg          , Gs^Fp       , Gs^Fp       , Gs^Fp       , Gs^Fp       , Gs^Fp       , Ww          , Ww          , Gg          , Gg          , Gg          , Gg          , Ww          , Wo          , Wo          , Wo          , Wo          , Ww          , Gg          , Gg          , Gg          , Gg          , Gg          , Gg          , Gg          , Gg          , Gg          , Gg          , Gg          , Gg          , Gg          , Gg          
