border_size=1
usage=map

1 Ch   ,1 Ch   , Ch     , Ch     , Gg     , Gg     , Gg     , Gg     , Gg    , Gg     , Gg     , Gg     , Gg     , Gg     , Gg     , Gg     , Gg     , Gg     , Gg     , Gg     , Ww     , Ww     , Gg     , Gg     , Gg     , Gg     , Gg     , Gg     , Gg     , Gg     , Gg     , Gg     , Gg     , Gg     , Gg     , Gg     , Gg     , Gg     , Gg     , Gg     
1 Ch   ,1 Kh   , Ch     , Ch     , Gg     , Gg     , Gg     , Gg     , Gg^Ve    , Gg     , Gg     , Gg     , Gg     , Gg     , Gg     , Gg     , Gg     , Gg     , Gg     , Gg     , Ww     , Ww     , Gg     , Gg     , Gg     , Gg     , Gg     , Gg     , Gg     , Gg     , Gg     , Gg     , Gg     , Gg     , Gg     , Gg     , Gg     , Gg     , Gg     , Gg     
Ch     ,Ch     , Ch     , Ch     , Gg     , Gg     , Gg     , Gg     , Gg     , Gg     , Gg     , Gg     , Gg     , Gg     , Gg     , Gg^Ve    , Gg     , Gg     , Gg     , Gg     , Ww     , Gg     , Gg     , Gg     , Gg     , Gg     , Gg     , Gg     , Gg     , Gg     , Gg     , Gg     , Gg     , Gg     , Gg     , Gg     , Gg     , Gg     , Gg     , Gg     
Ch     ,Ch     , Gg     , Gg     , Gg     , Gg     , Gg     , Gg     , Gg     , Gg     , Gg^Ve    , Gg     , Gg     , Gg     , Gs^Fp     , Gg     , Gs^Fp     , Gs^Fp     , Gg     , Ww     , Gg     , Gg     , Gg     , Gg     , Gg     , Gg     , Gg     , Gg     , Gg     , Gg     , Gs^Fp     , Gg     , Gg     , Gg     , Gg     , Gg     , Gg     , Gg     , Gg     , Gg     
Gg     ,Gg     , Gg     , Gg     , Gg     , Gg^Ve    , Gg     , Gg     , Gg     , Gg     , Gg     , Gg     , Gs^Fp     , Gs^Fp     , Gs^Fp     , Gs^Fp     , Gg     , Gg     , Ww     , Ww     , Ww     , Gg     , Gg     , Gg^Ve    , Gg     , Gg     , Gg     , Gg     , Gs^Fp     , Gs^Fp     , Gs^Fp     , Gs^Fp     , Gg     , Gg     , Gg     , Gg     , Gg     , Gg     , Gg     , Gg     
Gg     ,Gg     , Gg^Ve    , Gg     , Gg     , Gg     , Gg     , Gg     , Gg     , Gg     , Gs^Fp     , Gg     , Gs^Fp     , Gs^Fp     , Gs^Fp     , Gg     , Gg     , Gg     , Ww     , Ww     , Ww^Bw/   , Gg     , Gg     , Gg     , Gg     , Gg     , Gs^Fp     , Gs^Fp     , Gs^Fp     , Gs^Fp     , Gs^Fp     , Gs^Fp     , Gg     , Gg     , Gg^Ve    , Gg     , Gg     , Gg     , Gg     , Gg     
Gg     ,Gg     , Gg     , Gg     , Gg     , Gg     , Gg     , Gg     , Gg     , Gs^Fp     , Gs^Fp     , Gs^Fp     , Gs^Fp     , Gs^Fp     , Gg     , Gg     , Ww     , Ww     , Gs^Fp     , Gg     , Gg     , Ww     , Gg     , Gs^Fp     , Gs^Fp     , Gs^Fp     , Gs^Fp     , Gs^Fp     , Gs^Fp     , Gs^Fp     , Gs^Fp     , Gs^Fp     , Gg     , Gg     , Gg     , Gg     , Gg     , Gg     , Gg     , Gg     
Gg     ,Gg     , Gg     , Gg     , Gg     , Gg     , Gg     , Gg     , Gg     , Gg     , Gg     , Gg^Ve    , Gg     , Gg     , Gg     , Ww     , Gg     , Gs^Fp     , Gs^Fp     , Gs^Fp     , Gg     , Ww     , Ww     , Gs^Fp     , Gs^Fp     , Gs^Fp     , Gs^Fp     , Gs^Fp     , Gs^Fp     , Gs^Fp     , Gs^Fp     , Gs^Fp     , Gg     , Gg     , Gg     , Gg     , Gg     , Gg     , Gg     , Gg     
Gg     ,Gg     , Gg^Ve    , Gg     , Gg     , Gg     , Gg     , Gg     , Gs^Fp     , Gg     , Gs^Fp     , Gg     , Gg     , Gg     , Ww     , Ww     , Gs^Fp     , Gs^Fp     , Gs^Fp     , Gs^Fp     , Gs^Fp     , Gg     , Ww     , Gs^Fp     , Gs^Fp     , Gs^Fp     , Gs^Fp     , Gs^Fp     , Gs^Fp     , Gs^Fp     , Gg     , Gs^Fp     , Gg     , Gg     , Gg     , Gg     , Gg     , Gg     , Gg     , Gg     
Gg     ,Gg     , Gg     , Gg     , Gg     , Gg     , Gs^Fp     , Gg     , Gs^Fp     , Gs^Fp     , Gs^Fp     , Gs^Fp     , Ww     , Ww     , Gs^Fp     , Gs^Fp     , Gs^Fp     , Gs^Fp     , Gs^Fp     , Gs^Fp     , Gs^Fp     , Gg     , Ww     , Gs^Fp     , Gs^Fp     , Gs^Fp     , Gs^Fp     , Gs^Fp     , Gg     , Gs^Fp     , Gg     , Gg     , Gg     , Gg     , Gg     , Gg     , Gg^Ve    , Gg     , Gg     , Gg     
Gg     ,Gg     , Gg     , Gg     , Gg     , Gg     , Gg     , Gs^Fp     , Gg     , Gg     , Gg     , Gs^Fp     , Ww     , Gg     , Gg^Ve    , Gs^Fp     , Gs^Fp     , Gs^Fp     , Gs^Fp     , Gs^Fp     , Gs^Fp     , Gs^Fp     , Gg     , Ww     , Gs^Fp     , Gs^Fp     , Gs^Fp     , Gg     , Gg     , Gg     , Gg     , Gg     , Gg     , Gg     , Gg     , Gg     , Gg     , Gg     , Gg     , Gg     
Gg     ,Gg     , Gg     , Gg     , Gs^Fp     , Gg     , Gg     , Gg     , Gg     , Gg     , Gg     , Gg     , Ww     , Gg     , Re     , Re     , Gs^Fp     , Gs^Fp     , Gs^Fp     , Gs^Fp     , Gg     , Gg     , Gg     , Ww     , Ds     , Gs^Fp     , Ds     , Gg     , Gg     , Gg     , Gg     , Gg     , Gs^Fp     , Gs^Fp     , Gs^Fp     , Gg     , Gg     , Gg     , Gg     , Gg     
Gg     ,Gg     , Gg     , Gs^Fp     , Gs^Fp     , Gg     , Gs^Fp     , Gs^Fp     , Re     , Gs^Fp     , Gs^Fp     , Ww     , Gs^Fp     , Gs^Fp     , Gs^Fp     , Re     , Re     , Gs^Fp     , Gg     , Gg^Ve    , Gg     , Gg     , Gg     , Ww     , Ds     , Ds     , Ds     , Gg     , Gg     , Gg     , Gg     , Gs^Fp     , Gs^Fp     , Gs^Fp     , Gg     , Gg     , Gg     , Gg     , Gg     , Gg     
Gg     ,Gg     , Gg^Ve    , Gs^Fp     , Gs^Fp     , Gs^Fp     , Re     , Re     , Re     , Gs^Fp     , Gs^Fp     , Ww     , Gs^Fp     , Gs^Fp     , Gs^Fp     , Re     , Re     , Re     , Re     , Gg     , Gg     , Gg     , Ww     , Ww     , Ds     , Ds     , Ds     , Gg     , Gg     , Gg     , Gg     , Gs^Fp     , Gs^Fp     , Gs^Fp     , Gg     , Gg     , Gg     , Gg     , Gg     , Gg     
Gg     ,Gg     , Gg     , Gg     , Re     , Gs^Fp     , Re     , Re     , Re     , Gs^Fp     , Gs^Fp     , Gs^Fp     , Gs^Fp     , Gs^Fp     , Gs^Fp     , Gs^Fp     , Gs^Fp     , Re     , Gs^Fp     , Gs^Fp     , Gs^Fp     , Gg     , Ww     , Ds     , Ds     , Ds     , Gs^Fp     , Gg     , Gg     , Gg     , Gg     , Gs^Fp     , Gs^Fp     , Gg     , Gg     , Gg     , Gg     , Gg     , Gg     , Gg     
Re     ,Re     , Re     , Re     , Re     , Re     , Re     , Re     , Gs^Fp     , Gs^Fp     , Gs^Fp     , Gs^Fp     , Gs^Fp     , Gs^Fp     , Gs^Fp     , Gs^Fp     , Gs^Fp     , Re     , Gg     , Gs^Fp     , Gg     , Gg     , Ww^Bw\   , Ds     , Ds     , Gs^Fp     , Gs^Fp     , Gs^Fp     , Gg     , Gg     , Gg     , Gg     , Gg     , Gg     , Gg     , Gg     , Gg     , Gg     , Gs^Fp     , Gs^Fp     
Re     ,Re     , Gs^Fp     , Re     , Re     , Re     , Gs^Fp     , Gs^Fp     , Gs^Fp     , Gs^Fp     , Gs^Fp     , Gs^Fp     , Gs^Fp     , Gs^Fp     , Gs^Fp     , Gs^Fp     , Gg^Ve    , Re     , Gg     , Gg     , Ww     , Ww     , Ds     , Ds     , Gg     , Gs^Fp     , Gg     , Gg     , Gg     , Gg     , Gg     , Gg     , Gg     , Gg     , Gg     , Gg     , Gg     , Gs^Fp     , Gs^Fp     , Gs^Fp     
Gs^Fp     ,Gs^Fp     , Gs^Fp     , Gs^Fp     , Re     , Gs^Fp     , Gs^Fp     , Gs^Fp     , Gs^Fp     , Gs^Fp     , Gg^Ve    , Gs^Fp     , Gs^Fp     , Gs^Fp     , Gs^Fp     , Gs^Fp     , Gg     , Gg     , Gg     , Ww     , Ww     , Ds     , Ds     , Gs^Fp     , Gg     , Gg     , Gg^Ve    , Gg     , Gg     , Gg     , Gg     , Gg     , Gg     , Gg     , Gg     , Gg     , Gg     , Gs^Fp     , Gs^Fp     , Gs^Fp     
Gs^Fp     ,Gs^Fp     , Gs^Fp     , Gs^Fp     , Gs^Fp     , Re     , Re     , Gs^Fp     , Gs^Fp     , Gs^Fp     , Gs^Fp     , Gs^Fp     , Gs^Fp     , Gs^Fp     , Gs^Fp     , Gg     , Gg     , Gg     , Ww     , Ww     , Ww     , Ds     , Gg     , Gs^Fp     , Gg     , Gg     , Gg     , Gg     , Gg     , Gg     , Gg     , Gg^Ve    , Gg     , Gg     , Gs^Fp     , Gg     , Gs^Fp     , Gs^Fp     , Gs^Fp     , Gs^Fp     
Gs^Fp     ,Gs^Fp     , Gs^Fp     , Gs^Fp     , Gs^Fp     , Re     , Re     , Gg^Ve    , Gs^Fp     , Gs^Fp     , Gs^Fp     , Gs^Fp     , Gs^Fp     , Gs^Fp     , Gg     , Gg     , Gg     , Ww     , Ww     , Ww     , Ds     , Ds     , Gg     , Gg     , Gg     , Gg     , Gg     , Gg     , Gg     , Gg     , Gs^Fp     , Gg     , Gg     , Gg     , Gs^Fp     , Gs^Fp     , Gs^Fp     , Gs^Fp     , Gs^Fp     , Gs^Fp     
Gs^Fp     ,Gs^Fp     , Gs^Fp     , Gs^Fp     , Gs^Fp     , Gs^Fp     , Gs^Fp     , Re     , Re     , Gs^Fp     , Gs^Fp     , Gs^Fp     , Gs^Fp     , Gg     , Gs^Fp     , Gg     , Ww     , Ww     , Ww     , Ds     , Gg     , Gg     , Gg     , Gg     , Gg     , Gg     , Gs^Fp     , Gs^Fp     , Gs^Fp     , Gs^Fp     , Gs^Fp     , Gg     , Gg     , Gs^Fp     , Gs^Fp     , Gs^Fp     , Gs^Fp     , Gg^Ve    , Gs^Fp     , Gs^Fp     
Gs^Fp     ,Gs^Fp     , Gs^Fp     , Gs^Fp     , Gs^Fp     , Gs^Fp     , Gs^Fp     , Gs^Fp     , Gs^Fp     , Re     , Gs^Fp     , Gs^Fp     , Re     , Gg     , Gg     , Gg     , Ww     , Ww     , Ds     , Ds     , Gg     , Gg     , Gg     , Gg     , Gg     , Gg     , Gs^Fp     , Gs^Fp     , Gg     , Gs^Fp     , Gg     , Gg     , Gs^Fp     , Gs^Fp     , Ch     , Gs^Fp     , Gs^Fp     , Gs^Fp     , Gs^Fp     , Gs^Fp     
Gs^Fp     ,Gs^Fp     , Gs^Fp     , Gs^Fp     , Gs^Fp     , Gs^Fp     , Gs^Fp     , Gs^Fp     , Gs^Fp     , Re     , Re     , Re     , Gg^Ve    , Gs^Fp     , Gg     , Ww     , Ww     , Ww     , Ds     , Ds     , Ds     , Gg     , Gg     , Gg     , Gg     , Gg     , Gs^Fp     , Gg     , Gg^Ve    , Gg     , Gg     , Gs^Fp     , Gs^Fp     , Ch     , 2 Kh   , Ch     , Gs^Fp     , Gs^Fp     , Gs^Fp     , Gs^Fp     
Gs^Fp     ,Gs^Fp     , Gs^Fp     , Gs^Fp     , Gs^Fp     , Gs^Fp     , Gs^Fp     , Gs^Fp     , Gs^Fp     , Gs^Fp     , Re     , Re     , Gs^Fp     , Gs^Fp     , Gg     , Ww     , Ww     , Ds     , Ds     , Ds     , Gs^Fp     , Gg     , Gg     , Gg     , Gg     , Gs^Fp     , Gg     , Gg     , Gs^Fp     , Gg     , Gg     , Gs^Fp     , Gs^Fp     , Ch     , Ch     , Ch     , Gs^Fp     , Gs^Fp     , Gs^Fp     , Gs^Fp     
Gs^Fp     ,Gs^Fp     , Gg^Ve    , Gs^Fp     , Gs^Fp     , Gs^Fp     , Gs^Fp     , Gs^Fp     , Gs^Fp     , Gs^Fp     , Re     , Re     , Gg     , Gg     , Ww     , Ww^Bw\   , Ds     , Ds     , Gg     , Gs^Fp     , Gg     , Gs^Fp     , Gs^Fp     , Gg     , Gg     , Gs^Fp     , Gg     , Gg     , Gs^Fp     , Gg     , Gg     , Gs^Fp     , Gs^Fp     , Gs^Fp     , Gs^Fp     , Gs^Fp     , Gs^Fp     , Gs^Fp     , Gs^Fp     , Gs^Fp     
Gs^Fp     ,Gs^Fp     , 3 Kh   , Ch     , Ch     , Gg^Ve    , Gs^Fp     , Gs^Fp     , Gs^Fp     , Gs^Fp     , Re     , Gg     , Gg     , Gg     , Ww     , Ww     , Ds     , Ds     , Gs^Fp     , Gg     , Gg^Ve    , Gg     , Gg     , Gs^Fp     , Gg     , Gg     , Gg     , Gg     , Gs^Fp     , Gs^Fp     , Gg     , Gg     , Gs^Fp     , Gs^Fp     , Gs^Fp     , Gs^Fp     , Gs^Fp     , Gg^Ve    , Gs^Fp     , Gs^Fp     
Gs^Fp     ,Gs^Fp     , Gs^Fp     , Ch     , Gs^Fp     , Gs^Fp     , Gs^Fp     , Gs^Fp     , Gs^Fp     , Gs^Fp     , Re     , Gg     , Ww     , Ww     , Ds     , Ds     , Ds     , Gs^Fp     , Gs^Fp     , Gs^Fp     , Gg     , Gg     , Gg     , Gg     , Gg     , Gg     , Gs^Fp     , Gs^Fp     , Gs^Fp     , Gg     , Gg     , Gs^Fp     , Gs^Fp     , Gs^Fp     , Gg^Ve    , Gs^Fp     , Gs^Fp     , Gs^Fp     , Gs^Fp     , Gs^Fp     
Gs^Fp     ,Gs^Fp     , Gs^Fp     , Gs^Fp     , Gs^Fp     , Gs^Fp     , Gs^Fp     , Gs^Fp     , Re     , Re     , Gg     , Gg     , Ww     , Ww     , Ds     , Ds     , Ds     , Ds     , Gg     , Gs^Fp     , Gs^Fp     , Gg     , Gs^Fp     , Gg     , Gg     , Gg     , Gg     , Gg     , Gg     , Gg     , Gg     , Gs^Fp     , Gs^Fp     , Gs^Fp     , Gs^Fp     , Gs^Fp     , Gs^Fp     , Gs^Fp     , Gs^Fp     , Gs^Fp     
Gs^Fp     ,Gs^Fp     , Gs^Fp     , Gs^Fp     , Gs^Fp     , Gs^Fp     , Gs^Fp     , Gs^Fp     , Re     , Re     , Gg     , Ww     , Ww     , Ds     , Ds     , Ds     , Ds     , Ds     , Ds     , Gg     , Gg     , Gg     , Gg     , Gg     , Gg     , Gg     , Gg     , Gg     , Gg     , Gg     , Gs^Fp     , Gs^Fp     , Gs^Fp     , Gs^Fp     , Gs^Fp     , Gs^Fp     , Gs^Fp     , Gs^Fp     , Gs^Fp     , Gs^Fp     
Gs^Fp     ,Gs^Fp     , Gs^Fp     , Gs^Fp     , Gs^Fp     , Gs^Fp     , Gs^Fp     , Re     , Re     , Gg     , Ww     , Ww     , Ds     , Ds     , Ds     , Ds     , Ds     , Ds     , Ds     , Ds     , Gg     , Gg     , Gg     , Gg     , Gg     , Gg     , Gg     , Gg     , Gg     , Gg     , Gs^Fp     , Gs^Fp     , Gs^Fp     , Gs^Fp     , Gs^Fp     , Gs^Fp     , Gs^Fp     , Gs^Fp     , Gs^Fp     , Gs^Fp     
Gs^Fp     ,Gs^Fp     , Gs^Fp     , Gs^Fp     , Gs^Fp     , Gs^Fp     , Gs^Fp     , Re     , Gg     , Gg     , Ww     , Ww     , Ds     , Ds     , Ds     , Ds     , Ds     , Ds     , Ds     , Ds     , Ds     , Gg     , Gg     , Gg     , Gg     , Gg     , Gg     , Gg     , Gs^Fp     , Gs^Fp     , Gs^Fp     , Gs^Fp     , Gs^Fp     , Gs^Fp     , Gs^Fp     , Gs^Fp     , Gs^Fp     , Gs^Fp     , Gs^Fp     , Gs^Fp     
Gs^Fp     ,Gs^Fp     , Gs^Fp     , Gs^Fp     , Gs^Fp     , Gs^Fp     , Gs^Fp     , Re     , Gg     , Gg     , Ww     , Ww     , Ds     , Ds     , Ds     , Ds     , Ds     , Ds     , Ds     , Ds     , Ds     , Gg     , Gg     , Gg     , Gg     , Gg     , Gg     , Gg     , Gs^Fp     , Gs^Fp     , Gs^Fp     , Gs^Fp     , Gs^Fp     , Gs^Fp     , Gs^Fp     , Gs^Fp     , Gs^Fp     , Gs^Fp     , Gs^Fp     , Gs^Fp     
