Ss, Ss, Ss, Ss, Sm^Qhux, Sm^Qhux, Sm^Qhux, Sm^Qhu, Ss, Sm^Qhux, Sm^Qhux, Sm^Qhu, Sm^Qhux, Sm^Qhu, Ss, Ss, Ss, Ss, Ss, Ss, Ss, Ss, Wwrg^Qhux, Sm^Qhux, Sm^Qhux, Sm^Qhux, Ss, Ss, Ss, Ss, Gs, Gs, Gs, Hh, Hhd, Hh, Gd^Es, Re, Hh, Hh
Ss, Ss, Ss, Ss, Ss, Sm^Qhux, Ss, Ss, Ss, Ss, Ss, Sm^Qhux, Ss, Ss, Ss, Ss, Wwg^Qhux, Ss, Wwrg^Qhux, Ss, Ss, Ss, Ss, Sm^Qhux, Ss, Ss, Rb, Ss, Gg, Rb, Gs, Gs, Gs, Hh^Vo, Hhd^Es, Cer, Rb, Re, Hhd^Edt, Hh^Es
Ss, Ss, Ss, Ss, Ss, Ss, Ss, Ss, Ss, Ss^Vhs, Ss^Bw\r, Ss, Ss, Ss, Ss, Sm^Qhux, Sm^Qhux, Wwg^Qhux, Ss, Ss, Ss, Ss, Ss, Ss, Ss, Rb, Rb, Gg, Hh, Gg, Hh, Gg^Vo, Gg^Es, Gd, Rb^Edt, Re^Edt, Cer^Edt, Hhd^Vo, Cer, Hh^Edt
Ss, Ss, Ss, Ss, Wwg^Qhux, Ss, Wwrg^Qhux, Wwrg^Qhux, Sm^Qhux, Ss, Ss, Ss^Bw\r, Ss^Bw|r, Ss, Sm^Qhux, Sm^Qhux, Ss, Sm^Qhux, Gd, Gs, Gs, Ss, Gg, Ss, Ss, Ss, Gg, Gg, Hh, Hh, Gs, Gg, Hh^Es, Gd^Es, Hhd, Re^Edt, Cer, 8 Ker, Hhd^Edt, Hh^Edt
Ss, Ss, Ss, Ss, Ss, Sm^Qhux, Sm^Qhux, Ss, Ss, Ss, Ss, Ss, Rb, Ss, Ss, Sm^Qhux, Ss, Ss, Gs, Gs, Gg, Ss, Ss, Gg, Gs, Gg, Gg, Hh, Gg, Hh, Gs, Gd, Gd, Gs, Re^Vo, Re, Gd, Hhd, Gd, Hh
Sm^Qhux, Ss, Ss, Ss, Ss, Sm^Qhux, Sm^Qhux, Sm^Qhux, Ss, Ss, Ss, Rb, Rb, Ss, Gg, Ss, Gd, Gd, Ss, Ss, Gg, Ss, Gg^Es, Gs, Gg, Gg, Gg, Gg, Gs, Gs, Gd, Cer, Gd, Gs, Gd^Edt, Re, Cer, Hhd, Gs, Gg^Es
Sm^Qhux, Ss, Ss, Ss, Ss, Sm^Qhux, Ss, Rb, Rb, Rb, Gs, Rb, Gs, Gd, Gd, Gd, Gs, Gs, Gg, Ss, Gg, Gg, Hh^Es, Hh, Hh, Hh, Hh, Gg, Gs, Gg, Hh^Edt, Hhd^Edt, 6 Ker, Hhd^Edt, Rb^Edt, Gd^Edt, Gg^Edt, Gg^Edt, Cer, Hhd^Es
Sm^Qhux, Sm^Qhux, Ss, Ss, Ss, Ss, Ss, Rb, Rb, Gs, Gg, Gs, Gs, Gd, Gd, Gg, Hh, Gs, Gg, Gg, Gs, Gg, Gg, Gg^Vo, Gg, Gg, Gg, Gg, Gg, Hh, Hh, Cer^Edt, Cer, Cer, Gd, Rb^Edt, Gs, Cer^Edt, 7 Ker, Hhd
Sm^Qhux, Sm^Qhux, Sm^Qhux, Ss, Ss, Ss, Ss, Ss^Dr, Chr^Dr, Gs, Gd, Gd, Rb^Gvs, Rb^Gvs, Rb^Gvs, Gs, Gs^Es, Hh, Gg, Gg^Es, Gs, Gg, Gg, Gg, Gg, Gg, Gg, Hh, Gg, Gg, Hh, Hh, Hh^Edt, Hhd, Hhd^Edt, Gd^Es, Re, Hhd, Hh, Cer
Rb, Ss, Sm^Qhux, Sm^Qhux, Ss, Ss, Ss^Dr, Khs, Rb, Gs^Vh, Re, Rb^Gvs, Rb^Gvs, Rb^Gvs, Rb^Gvs, Rb^Gvs, Rb^Eff, Gg, Gg, Gg, Gs, Gs, Gs, Hh, Hh, Gg^Es, Gg, Gg, Gg, Gg, Gs, Gs, Gs, Gg, Gg, Rb, Gs, Hh, Gg, Hh
Rb, Rb, Rb^Edt, Rb^Edt, Ss, Rb, Rb, Chs, Rb, Gs, Gg, Re, Rb, Rb^Gvs, Rb^Gvs, Rb^Gvs, Rb^Gvs, Rb^Eff, Gg^Eff, Gg^Efm, Gs^Efm, Gs, Gs, Gg, Gg, Gg, Gg, Hh, Hh, Gg, Gg, Gg, Gg, Gg, Re, Re, Gg, Gg, Gs, Gs
Ss, Ss, Rb, Rb^Edt, Ss, Rb, Ss, Rb, Rb, Rb, Gs, Re, Re, Re, Gs^Vwm, Rb^Gvs, Rb^Gvs, Rb^Eff, Gg, Gg, Gg, Gs, Gs, Gg, Gg, Gg, Gg, Gg, Gg, Gg, Gg, Gg, Gg, Gg, Gg, Hh, Gg^Es, Gg, Hh^Vo, Gg
Rb, Ss, Ss, Ss, Ss, Ss, Sm^Qhux, Rb, Sm^Qhux, Gd, Gs, Gs^Vh, Gg, Gg, Gs, Gs, Gg, Gs, Gg, Gs^Efm, Gg, Gg, Gg, Gg, Gg, Gg, Gg, Gg, Gg, Gg, Hh, Hh^Es, Gg, Re, Gg, Hh^Es, Gg, Gg, Gg, Hh
Rb, Rb, Ss, Ss, Ss, Ss, Sm^Qhux, Sm^Qhux, Rb^Edt, Rb, Gs, Gd, Gs, Gg, Gg, Gg, Gs, Gg, Gg^Efm, Gg^Efm, Gg, Gg^Efm, Gg, Gg, Gg, Gg^Es, Gs, Gg, Gs, Gg, Gg, Hh, Gg, Re, Gs, Gg, Gg, Gs, Gs, Gg
Ss, Ss, Cer^Edt, Ss, Ss, Ss, Ss, Sm^Qhux, Rb, Rb, Ss, Gs, Rb, Rb, Gg, Gg, Gg, Gs, Gg, Gg, Gg, Gg^Efm, Gs, Gg, Gs, Gg, Gg, Gg, Gg, Gs, Gs, Gg^Es, Rb, Gs, Gg, Gg, Hh, Gg^Vo, Gg, Gg
Rb, Ss, Rb^Ecf, Rb^Edt, Rb, Rb, Ss, Rb, Rb, Rb, Ss, Ss, Rb, Rb, Rb, Rb, Gs, Gs, Gs, Gs, Gs, Gg, Gs, Gs, Gg, Gs, Gg, Gg, Gg, Gg, Gg, Gg, Re, Gs, Gs, Gg, Gg, Hh, Hh, Gg
Ss^Edt, Cer, Cer^Dr, Ss, Ss, Ss, Ss^Vhs, Ss, Ss, Ss, Wwg^Qhux, Wwrg^Qhux, Wwrg^Qhux, Ss, Gg, Gg, Gg, Gg, Gg, Gg, Gs, Gs, Gg, Gg, Gg, Gg, Gg, Gg, Gg, Gg, Gg, Rb, Hh^Es, Gg, Gs, Gs^Es, Gg, Gg, Gg, Gg
Cer, 3 Ker, Cer^Edt, Rb, Cer^Dr, Rb, Rb^Edt, Ss, Ss, Ss, Sm^Qhux, Sm^Qhux, Ss, Ss, Ss, Gg, Ss, Gg, Gg, Gg, Gg, Gs, Gg, Gs, Gs^Es, Gs, Gg, Gg^Es, Gg, Gg, Gg, Gs, Gg, Gg, Gg, Gg, Gg, Gg^Es, Gg, Gg
Rb, Ss^Vhs, Ss^Edt, Ss, Ss, Rb, Rb, Ss, Ss, Ss, Ss, Sm^Qhux, Rb, Ss, Rb, Rb, Gg, Ss, Gg, Gg, Gg, Gg, Gg, Gs, Gg, Gg, Gg, Gg, Re, Gg, Re, Gs, Gg, Gg, Gg, Gg, Gg^Efm, Gg, Gg^Efm, Gg^Efm
Rb, Rb, Ss, Rb^Edt, Rb^Ecf, Rb^Edt, Ss, Rb, Ss, Ss, Ss, Ss, Ss, Ss, Rb, Rb, Rb, Ss, Rb, Rb, Rb, Gg, Gg, Gg, Gg, Gg, Gg, Re, Gg, Gg, Gg, Gg, Gg, Gg, Gg, Gg^Efm, Gg, Gg^Efm, Gg^Efm, Gg
Ss, Ss, Ss, Rb, Rb^Edt, Rb^Edt, Ss^Edt, Rb^Edt, Rb^Edt, Rb, Ss, Ss, Ss, Rb, Sm^Qhux, Rb, Rb, Ss, Gg, Gg, Gg, Gs, Gs, Gs, Gg, Gg, Rb, Re, Gg, Gg, Gg, Gg, Gg, Gg, Gg, Gg, Gg, Gg, Gg, Gg^Efm
Ss, Ss, Rb^Edt, Ss, Ss, Ss, Cer^Edt, Rb, Rb, Ss, Rb, Ss, Ss, Sm^Qhux, Sm^Qhux, Sm^Qhux, Gg, Gg, Gg, Gg, Gg, Gs, Gg, Gg, Gg, Gg, Re, Re, Gg, Gg, Rb, Gg, Gs, Gg, Gg, Gg, Gg, Gg, Gg^Efm, Gg^Efm
Ss, Rb, Ss, Ss, Ss, Ss, Ss, Rb, Rb, Rb, Ss, Ss, Rb, Rb, Gs, Gg, Gg, Gg, Gg, Re, Gg, Gg, Gg, Gg, Rb, Rb, Gg, Re, Gg, Re, Gg, Gs, Rb, Rb, Gs, Gg, Rb, Gg, Gg, Gg^Efm
Rb, Rb, Ss, Wwrg^Qhux, Wwg^Qhux, Sm^Qhux, Sm^Qhux, Ss, Ss, Ss, Rb, Ss, Ss, Ss, Gs, Ss, Ss, Gg, Gg, Re, Re, Re, Rb, Rb, Rb, Gg, Gg, Gg, Gg, Gg, Gg, Gg, Gs, Rb, Gg, Rb, Gs^Vh, Rb, Re, Gg
Rb, Rb, Wwrg^Qhux, Wwg^Qhux, Ss, Ss^Vhs, Sm^Qhux, Rb, Rb, Rb, Rb, Rb, Ss, Gd, Gd^Vh, Gs, Gs, Gg, Rb, Re, Re, Rb, Gg, Gg, Gg, Rb, Gg, Gg, Gg^Efm, Gg, Gg^Efm, Gg, Gg, Gg, Gg, Gs, Rb^Gvs, Rb^Gvs, Rb^Gvs, Re
Ss, Sm^Qhux, Sm^Qhux, Sm^Qhux, Sm^Qhux, Sm^Qhux, Ss, Ss, Ss, Ss, Ss, Ss, Gs, Gd, Gs, Ss, Ss, Gg, Gg, Gg, Gg, Gg^Edt, Gg, Gg, Gg^Edt, Re, Re, Re, Gs, Gg, Gg, Gg^Efm, Gg^Efm, Gg, Gg^Eff, Gg^Eff, Rb^Gvs, Rb^Gvs, Rb^Gvs, Rb^Gvs
Ss, Sm^Qhux, Rb, Sm^Qhux, Sm^Qhux, Sm^Qhux, Sm^Qhux, Ss, Ss, Gs, Gd, Ss, Gg, Ss, Gs, Ss, Ss, Gg, Re, Gg, Gg, Gg, Ce^Edt, Gg^Edt, Gg^Edt, Re, Gg, Gs, Gs, Gg^Edt, Gg, Gg, Gg, Gg, Gg, Gs^Eff, Rb^Eff, Rb^Gvs, Rb^Gvs, Rb^Gvs
Sm^Qhux, Ss, Sm^Qhux, Rb, Rb, Sm^Qhux, Rb, Rb, Ss, Ss, Gd, Gs, Gg, Gg, Gg, Gs, Gs, Gs, Gs, Gg, Gs, Gg^Edt, Ce^Edt, Ce, Re, Gs, Gs, Gs^Edt, Ce^Edt, Ce, Ce^Edt, Gs, Gg, Gs^Edt, Gs, Gs, Gg, Rb^Eff, Gs^Eff, Rb^Efm
Sm^Qhux, Sm^Qhux, Sm^Qhux, Rb, Ss, Rb, Ss, Rb, Ss, Ss, Gg, Ss, Gg, Gg, Gs, Gg, Gg, Gg, Gs, Gg, Gs, Gs, Gg, Gs^Vh, Gd^Edt, Gg, Gs, Ce, Ce, 4 Ket, Ce^Qhh, Gd^Qhh, Ce^Qhh, Gg, Gg^Edt, Gg, Gg, Gg^Efm, Gg^Efm, Gs^Eff
Sm^Qhux, Sm^Qhux, Ss, Ss, Ss, Ss, Gd, Ss, Ss, Ss, Ss, Gs, Gg, Gg, Gs, Gs, Gs, Gs, Gg^Edt, Gs, Ce^Qhh, Gd^Qhh, Gd^Qhh, Gs^Edt, Rb^Edt, Rb, Re, Gd^Edt, Gd^Qhh, Gd^Qhh, Rb^Xo, Rb^Xo, Re^Xo, Ce^Qhh, Ce^Qhh, Gs, Gs, Gg, Gd, Gg
Rb, Rb, Rb, Ss, Gs, Ss, Ss, Gd, Gs, Ss, Gg, Gg, Gs, Gs, Gg, Gs^Edt, Gg, Gg, Ce, Ce^Qhh, Re^Xo, Re^Xo, Re^Xo, Gd^Qhh, Gd^Qhh, Rb, Re, Rb, Gd^Qhh, Rb^Xo, Re^Vct, Re^Vct, Rb^Edt, Re^Xo, Re^Xo, Gs^Qhh, Gs^Qhh, Gg^Edt, Gd, Gd
Rb, Rb, Gd, Ss, Ss, Gs, Gd, Gs, Gs, Gg, Gd, Gs^Fds, Gs^Fds, Gg, Gs, Gs, Gs, Gs, Ce^Qhh, 1 Ke^Qhh, Rb^Xo, Rb^Vct, Rb^Vct, Re^Xo, Re^Xo, Gs^Qhh, Gs^Edt, Gd, Gs^Qhh, Rb^Xo, Rb^Xo, Re^Vct, Rb^Ecf, Re^Vct, Rb^Edt, Re^Xo, Rb^Xo, Ce^Qhh, Ce^Qhh, Gd^Edt
Ss, Ss, Gs, Gd, Gg, Gs, Gs, Gd, Gs, Gs, Gs, Gs^Fms, Gs, Gs, Gs, Gs, Gs, Gd^Edt, Gd^Qhh, Rb^Xo, Re^Vct, Rb^Ecf, Rb^Edt, Rb^Vct, Re^Xo, Gd^Qhh, Ce, Gs, Gs^Vh, Gd^Qhh, Gd^Qhh, Rb^Xo, Re^Vct, Rb^Edt, Rb^Edt, Re^Vct, Rb^Vct, Re^Xo, Re^Xo, Ce^Qhh
Gs, Gd, Gd, Gs, Gg, Gs, Gs, Gs^Fms, Gs^Fds, Gs, Gs, Gs, Re, Gs, Gg, Gs, Gs^Edt, Gd, Ce^Qhh, Rb^Xo, Re^Vct, Re^Vct, Re^Xo, Re^Xo, Gd^Qhh, Gd^Qhh, 5 Ket, Ce^Edt, Ce^_mh, Ce, Gd^Qhh, Rb^Xo, Rb^Vct, Re^Vct, Re^Vct, Rb^Ecf, Rb^Vct, Re^Vct, Re^Xo, Ce^Qhh
Gg, Gs, Gs^Fms, Gs^Fds, Gs^Fds, Gg, Gs^Fms, Gs^Fds, Gs^Fms, Gs, Gs^Fds, Gs, Gs^Fms, Gg, Gg, Gg, Ce^Qhh, Ce^Qhh, Rb^Xo, Rb^Xo, Rb^Ecf, Rb^Edt, Re^Xo, Gd^Qhh, Ce, Ce, Ce, Ce, Ce, Ce, Gd^Qhh, Re^Xo, Rb, Rb^Vct, Re, Re^Edt, Re, Re, Re^Vct, Rb^Xo
