Mm^Qhh, Gs^Qhh, Hh^Qhh, Gs^Efm, Ww, Gg, Hh, Gg, Hh, Gs, Gg^Efm, Hh, Hh, Hh, Mm, Mm, Mm, Hh, Mm, Mm, Mm, Gg^Qhh, Hh^Qhh, Hh, Gg, Gs^Fms, Gg, Gs^Fds, Gs^Fms, Gg, Gs^Fds, Gg^Efm, Gg^Efm, Gs^Fms, Gs^Fms, Gg, Gg, Gg^Efm, Gg^Efm
Hh^Qhh, Hh^_mhh, Mm^_mhh, Hh^Qhh, Hh^Qhh, Ww, Wo, Hh, Hh, Gs, Gg, Gs^Efm, Gg, Hh, Gg, Co, Co^Edt, Ko, Co^Edt, Mm, Mm, Mm, Mm, Hh, Hh, Gs^Fms, Gs^Fds, Gg, Gg, Gs^Fms, Gg, Gg, Gg, Gg^Vl, Gs^Fms, Gs^Fms, Gg, Gg^Efm, Gs^Fms
Hh^Qhh, Hh^_mhh, Hh^Qhh, Mm^_mhh, Mm^_mhh, Hh^Qhh, Wo, Gg, Hh, Hh, Hh, Gg^Efm, Gg, Gg^Efm, Gg^Efm, Gg^Efm, Gg^Efm, Co^Edt, Gg^Edt, Hh, Hh, Mm, Hh, Hh, Hh, Gg, Gg, Gg, Gg, Gg, Gs^Fms, Gg, Gg, Gg^Efm, Gg, Gg, Gg, Gs^Fms, Gs^Fms
Hh^Qhh, Mm^_mhh, Mm^Qhh, Hh^Qhh, Mm^Qhh, Mm^Qhh, Hh^Qhh, Wo, Gg, Gg, Gg, Gg, Gg, Gg, Gg, Gg, Gg, Gg, Gs, Gg, Gg, Gg, Gg, Gg, Gg, Hh, Gg, Gg, Gg^Vl, Gs^Fms, Gs^Fms, Gg, Gg, Gg, Gg, Gg, Gg, Gg, Gs^Fds
Hh^Qhh, Hh^_mhh, Mm^_mhh, Hh^Qhh, Mm^_mhh, Hh^_mhh, Hh^Qhh, Ww, Ww, Gg, Hh, Gg, Hh, Hh^Edt, Hh, Hh, Mm, Hh, Gs, Gs, Hh, Co, Hh, Gg, Gg, Gg, Gg, Hh, Hh, Gs^Fds, Hh, Gg, Hh, Gg, Gg^Edt, Gg, Gg, Gg, Gg^Efm
Hh^Qhh, Mm^Qhh, Mm^Qhh, Hh^_mhh, Hh^Qhh, Mm^_mhh, Mm^_mhh, Hh^Qhh, Hh, Ww, Ww, Hh, Mm, Mm, Hh, Mm, Hh^Vo, Wwf, Wwf, Gg^Efm, Wo, Mm, Mm, Hh, Hh, Gg, Gg, Gg^Efm, Gg^Efm, Mm, Mm, Mm, Mm, Hh, Hh, Gg, Gs^Fds, Gs^Fms, Gs^Fms
Mm^Qhh, Mm^Qhh, Mm^Qhh, Mm^Qhh, Hh, Mm^Qhh, Mm^Qhh, Mm^Qhh, Hh, Gg^Efm, Hh, Wo, Wo, Ww, Ww, Hh^Edt, Wwf, Wwf, Ww, Ww, Wo, Wo^Ewf, Hh, Mm, Mm, Gg, Gs, Gg, Gg^Efm, Hh, Hh, Mm, Hh^Edt, Mm, Mm, Mm, Mm, Hh, Hh
Ww, Mm, Mm, Hh, Hh^Edt, Hh^Edt, Hh^Vo, Mm, Hh, Hh, Mm, Hh, Hh^_mh, Mm, Wo, Ww, Mm, Mm, Mm, Wo, Wo, Wo, Wo^Ewl, Hh, Hh, Mm, Hh, Gs, Gs, Gg, Gg, Hh, Gg, Hh, Mm, Mm, Hh^Vhhr, Hh, Mm
Wo, Wo, Wo, Mm, Hh, Hh, Hh^Edt, Gg^Edt, Mm, Mm, Mm^Qhh, Hh^Edt, Mm, Mm, Wo^Ewf, Ww, Ww, Mm, Wo, Wo, Wo, Wo, Hh^Edt, Gg, Hh, Mm, Mm, Hh, Hh, Gs, Gg, Gg, Gg, Hh, Hh, Mm, Hh, Hh, Mm
Wo, Wo, Mm, Wo, Hh^Vo, Mm, Mm^Qhh, Mm, Mm^Qhh, Co^Qhh, Hhd^Edt, Mm^Qhh, Mm^Qhh, Mm^Qhh, Mm^Qhh, Wo^Ewl, Wo, Wo, Ww^Ewl, Ww, Hh^Qhh, Hh^Edt, Mm, Mm, Mm, Hh, Hh, Mm, Mm, Hh, Hh, Gg^Efm, Gg^Efm, Gg, Gs, Gg, Gg, Hh, Gg
Hh, Mm, Mm, Mm, Mm, Hh^Qhh, Hh^Edt, Hh^Qhh, Hhd, Hhd, Hhd^Edt, Hhd^Edt, Hhd, Hhd^Vo, Hh^Qhh, Mm^Qhh, Hh^Qhh, Hh^Qhh, Mm^Qhh, Hh^Qhh, Hhd^Vo, Hh^Qhh, Mm^Qhh, Mm, Hh, Hh, Mm, Mm, Mm, Mm, Hh, Hh, Hh, Gg, Gs, Gg, Gg, Gg, Gg
Gg, Hh, Hh, Hh, Hh, Mm^Qhh, Hhd^Edt, Hh^Edt, Hhd, Gs^Edt, Co, Md, Co, Hhd, Hhd^Edt, Hh^Qhh, Hh, Co, Gs, Hhd^Edt, Gd, Hh^Qhh, Co, Mm^Qhh, Hh^Qhh, Mm, Hh^Qhh, Mm, Hh^Qhh, Hh^Qhh, Gg^Qhh, Gg, Gs, Gg^Efm, Gg, Gg, Gg, Gs^Efm, Gg^Efm
Rb, Gs, Re, Gs, Hh, Hh^Qhh, Gg^Qhux, Hhd, Hh, Gs, Gd^Vo, 6 Ko, Co^Edt, Co, Gs^Edt, Gd^Edt, Gs, Gs, Gg^Edt, Gs, Gs, Gs, Gs, Hh, Hhd^Edt, Hh^Qhh, Hhd, Hh^Qhh, Re, Rb, Re^Vhr, Gg^Qhh, Hh^Qhh, Gg, Gs, Gg, Gg, Gg^Efm, Hh
Re, Re, Rb, Hh, Hh^Qhux, Gg^Qhux, Hh^Qhux, Mm^Qhu, Co, Hhd, Co, Co^Edt, Co^Edt, Gd, Gd, Gs, Gd, Gd, Co^Edt, Hhd, Hhd, Gs, Gs, Gd^Edt, Gd^Edt, Gs^Edt, Gs, Gd, Re, Re, Rb, Hhd, Gg^Qhh, Hh, Hh, Gg, Hh, Hh, Mm
Gs^Qhh, Gs^Qhh, Hh^Qhux, Hh^Qhux, Mm^Qhux, Mm^Qhux, Hh^Qhux, Mm^Qhux, Mm^Qhux, Hh^Qhux, Hhd^Edt, Gs, Gd^Edt, Gd, Gd, Gs, Gd, Co, 5 Ko, Md, Mm, Co^Edt, Gs, Gd, Gs, Gs, Gg, Gs, Gs, Gd, Rb, Re^Vhr, Gg^Qhh, Hh, Hh, Hh, Hh, Mm, Gg
Gg^Qhux, Gg^Qhux, Mm^Qhux, Mm^Qhux, Mm^Qhux, Mm^Qhux, Hh^Qhux, Hh^Qhux, Mm^Qhux, Hh^Qhux, Hhd^Vo, Hhd, Gs^Edt, Gs, Gd, Gd, Gd, Co, Md, Md, Md, Hhd, Gs^Edt, Gs^Edt, Gs^Edt, Gs, Gs, Gs, Gs, Gd, Gd, Hhd, Hh^Qhh, Hh, Mm, Mm, Mm, Hh, Hh
Hh^Qhux, Hh^Qhux, Mm^Qhux, Hh^Qhux, Mm^Qhux, Mm^Qhux, Mm^Qhux, Mm^Qhux, Hh^Qhux, Hh^Qhux, Hh^Qhux, Hhd, Hh, Gd^Vo, Gs, Gs, Gs, Gd, Md, Mm, Mm, Mm, Hh, Hhd^Edt, Hhd, Gd, Gs, Gg, Gs, Gs, Gs, Hh, Hh, Hh^Qhh, Hh^Qhh, Mm, Hh, Hh, Hh
Mm^Qhux, Mm^Qhux, Hh^Qhux, Hh^Qhux, Mm^Qhux, Mm^Qhux, Mm^Qhux, Mm^Qhux, Mm^Qhux, Mm^Qhux, Hh^Qhux, Hh^Qhux, Mm^Qhux, Hh^Qhux, Mm^Qhux, Gs^Edt, Gs, Gs, Gs, Co, Hh^Edt, Mm, Mm, Mm, Mm, Gs, Hh, Hh, Hh, Gs, Gs, Hh, Hh, Hh, Hh, Hh^Qhh, Hh^Qhh, Gg, Gg^Qhh
Hh^Qhux, Mm^Qhux, Gs^Qhux, Hh^Qhux, Mm^Qhux, Mm^Qhux, Hh^Qhux, Mm^Qhux, Mm^Qhux, Hh^Qhux, Hh^Qhux, Mm^Qhux, Mm^Qhux, Hh^Qhux, Mm^Qhux, Co^Edt, Gs, Gs, Gs, Gs^Edt, Hhd, Hhd^Edt, Mm, Hh, Hhd, Gs, Gs, Hh, Mm, Gs, Gg, Gs, Gg, Gg, Hh, Hh, Hh, Gg^Qhh, Hh
Gg^Qhux, Gs^Qhux, Hh^Qhux, Hh^Qhux, Mm^Qhux, Mm^Qhux, Mm^Qhux, Mm^Qhux, Mm^Qhux, Hh^Qhux, Mm^Qhux, Mm^Qhux, Mm^Qhux, Hh^Qhux, Hh^Qhux, Hh^Qhux, Gs, Gd^Edt, Gd, Gs, Hh, Mm, Mm, Mm, Gs, Hh, Gs, Hh, Hh, Hh, Hh, Gg, Gg, Gg, Gg, Gg, Gg, Gg, Gg
Gs^Qhux, Gs^Qhux, Gg^Qhux, Hh^Qhux, Gs^Qhux, Hh^Qhux, Mm^Qhux, Mm^Qhux, Gg^Qhux, Hh^Qhux, Gg^Qhux, Mm^Qhux, Gg^Qhux, Gg^Qhux, Gg^Qhux, Mm^Qhux, Mm^Qhux, Gd, Gs, Gs^Edt, Gg, Hh, Hh, Hhd, Gs, Gs, Hh, Gg, Hh, Hh, Hh, Hh, Gs, Gs, Gg, Gg, Gg, Gg, Gg
Gs^Qhux, Gs^Qhux, Gg^Qhux, Gg^Qhux, Gs^Qhux, Hh^Qhux, Hh^Qhux, Mm^Qhux, Hh^Qhux, Hh^Qhux, Gg^Qhux, Gg^Qhux, Gg^Qhux, Ww^Qhux, Ww^Qhux, Hh^Qhux, Mm^Qhux, Gs, Gs, Gs^Edt, Gg^Edt, Gg, Hh, Hh, Gg, Mm, Hh, Hh, Gg, Mm, Mm, Gg, Gg, Gg, Hh, Gg, Gg, Gg, Gg
Gs^Qhux, Gg^Qhux, Gg^Qhux, Gs^Qhux, Hh^Qhux, Gs^Qhux, Hh^Qhux, Mm^Qhux, Mm^Qhux, Mm^Qhux, Mm^Qhux, Hh^Qhux, Hh^Qhux, Ww^Qhux, Ww^Qhux, Hh^Qhux, Hh^Qhux, Hh^Qhux, Gs, Gs, Gg, Gg, Gg, Gg, Gs, Hh, Gs, Hh, Gg, Hh, Mm, Hh, Gg, Gg, Gg, Hh, Mm, Hh, Hh
Gs^Qhux, Gs^Qhux, Hh^Qhux, Hh^Qhux, Hh^Qhux, Hh^Qhux, Hh^Qhux, Hh^Qhux, Hh^Qhux, Hh^Qhux, Hh^Qhux, Mm^Qhux, Wo^Qhux, Wo^Qhux, Wo^Qhux, Ww^Qhux, Wo^Qhux, Wo^Qhux, Gg, Gg, Gg, Gg, Gs, Gs, Gs, Gg, Gg, Hh, Gg, Gs, Hh, Hh, Gs, Gs, Gg^Edt, Hh, Mm, Mm, Hh
Hh^Qhux, Hh^Qhux, Mm^Qhux, Mm^Qhux, Mm^Qhux, Hh^Qhux, Gg^Qhux, Gg^Qhux, Hh^Qhux, Hh^Qhux, Gg^Qhux, Ww^Qhux, Gg, Wo^Qhux, Gg, Gg, Gg, Gg, Gs, Hh, Gg, Gg, Gs, Gg, Gg, Gs, Gg, Gg, Gg, Gg, Ce, Ce, Gg, Gg, Ce, Ce, Hh, Mm, Gg
Mm^Qhux, Mm^Qhux, Hh^Qhux, Mm^Qhux, Hh^Qhux, Hh^Qhux, Hh^Qhux, Hh^Qhux, Mm^Qhux, Hh^Qhux, Gs, Gs, Gg, Gs, Gg, Hh, Hh, Gs, Gg, Hh, Gg, Gg, Gg, Gs, Gs, Gg, Gg, Gg, Hh, Gg, Gg^Edt, Ce, Gg, 3 Ke, Gg^Vct, Ce^Edt, Gg, Mm, Mm
Mm^Qhux, Mm^Qhux, Mm^Qhux, Hh^Qhux, Gg^Qhux, Gg^Qhux, Hh^Qhux, Mm^Qhux, Hh^Qhux, Hh^Qhux, Hh, Gs, Gg, Gg, Gs, Gs, Hh, Gg, Gg, Gg, Hh, Hh, Gg, Gg, Gg, Gg, Gg, Hh, Hh, Gg, Gg, Gs, Gg, Ce, Hh, Gg, Hh, Hh, Mm
Hh^Qhux, Mm^Qhux, Hh^Qhux, Hh^Qhux, Gg^Qhux, Hh^Qhux, Mm^Qhux, Mm^Qhux, Hh^Qhux, Hh^Qhux, Hh, Gg, Hh, Hh, Gg, Hh, Gg, Gg, Ce, Gg, Gg^Vct, Hh, Gg, Ce, Gg, Gg, Gg, Gg, Gg, Hh, Gg, Gs, Gs, Gs, Gg, Hh, Mm, Hh, Mm
Gg^Qhux, Hh^Qhux, Hh^Qhux, Gg^Qhux, Hh^Qhux, Hh^Qhux, Hh^Qhux, Hh^Qhux, Gs, Hh, Gg, Gg, Gg, Gs, Gs, Gs, Gs, Ce, Gs^Vct, Gs, Ce, Ce, Ce, Gg, Hh, Gg, Gg, Gg, Gg, Gg, Ce^Edt, Gg^Edt, Gg, Gg, Gg, Hh, Mm, Mm, Mm
Mm^Qhux, Mm^Qhux, Hh^Qhux, Hh^Qhux, Mm^Qhux, Hh^Qhux, Hh^Qhux, Hh, Gs, Gs, Gg, Gg, Hh, Gg, Hh, Gg, Gg, Ce, Gs, Gs, 4 Ket, Ce, Gg^Vct, Gg, Hh, Hh, Gs, Gs, Ce, Ce, 2 Ke, Gs^Vct, Ce, Gg, Gg, Hh, Hh, Mm, Mm
Hh^Qhux, Hh^Qhux, Gg^Qhux, Hh^Qhux, Mm^Qhux, Hh^Qhux, Hh^Qhux, Gg, Gs, Gg, Hh, Hh, Gg, Hh, Gg, Hh, Gg, Gs, Gg, Ce, Ce, Ce, Ce, Gg, Hh, Hh, Hh, Gs, Gg, Ce, Gg, Gs, Ce, Ce, Gg, Gg, Hh, Hh, Hh
