Mm^Qhh, Mm^Qhh, Hhd^Qhh, Mm^Qhh, Hhd^Qhh, Mm^Qhh, Hh^Qhh, Gg^Qhh, Gg^Fds, Gg, Re^Qhu, Re^Qhu, Re^Qhu, Gg^Efm, Gg^Efm, Gg^Qhh, Gg^Qhh, Gg^Qhh, Gg^Qhh, Hh^Qhh, Hh^Qhh, Mm^Qhh, Hh^Qhh, Mm, Mm^Qhh, Gg, Mm^Xm, Mm^Xm, Mm^Xm, Hh, Hh^Fp, Gg^Fms, Hh^Qhh, Hh^Qhh, Mm^Qhh, Mm^Qhh, Mm^Qhh, Hh^Qhh, Hh^Qhh, Mm^Qhh, Mm, Mm
Hd^Qhh, Md, Hd, Md, Md, Hhd^Qhh, Hh^Fds, Gg^Fms, Gs^Fp, Gg^Qhu, Rb^Qhu, Re, Gg^Efm, Gg^Vhr, Gg^Efm, Gg^Qhu, Gg^Qhu, Gg^Efm, Gs^Efm, Gg^Qhh, Gg^Qhh, Hh^Qhh, Hh^Qhh, Mm^Qhh, Hh^Qhh, Mm^Qhh, Hh^Fp, Mm^Xm, Mm, Mm^Xm, Hh, Gg^Fms, Gg, Hh^Fp, Gg^Fms, Gg^Fp, Hh, Mm^Qhh, Gg^Qhh, Hh^Qhh, Hh^Qhh, Hh^_mhh
Hhd^Qhh, Dd^_mh, Dd, Dd, Hd, Hhd^Qhh, Hhd^Qhh, Gg^Fp, Gg^Fds, Gg^Fms, Gg^Qhuf, Re, Re, Rb, Re^Qhu, Rb, Re, Gg^Efm, Gg^Efm, Gs^Efm, Gs^Qhu, Gs^Qhu, Gd^Qhu, Hd^Qhu, Dd^Qhu, Hh^Qhh, Hh^Qhh, Gg^Fms, Gs^Qhh, Hh^Es, Hh, Gs, Gs, Gg, Gg, Gg^Fms, Gg, Hh, Hh^Vhh, Hh^Qhh, Gg, Gg^Qhh
Gg, Hd^Qhh, Hd^Qhh, Gg, Dd, Gg, Gg^Fds, Hh^Qhh, Gg^Qhhf, Gg, Gg, Re^Qhu, Gg^Qhuf, Re^Qhu, Gg, Re^Qhu, Rb^Qhu, Rb, Rb, Rb, Gs^Efm, Gs, Gd, Ds, Ds, Ds^Qhu, Ds^Qhu, Ds^Qhh, Dd^Qhu, Gg^Qhh, Ds^Qhh, Hh, Gs, Hh, Mm, Gg^_mh, Hh^Es, Gg, Gg, Hh, Gs, Gg
Hh, Gs^Fds, Gs^Fp, Hh^Qhhf, Hh^Qhh, Hhd^Es, Mm, Gg^Qhh, Hh^Qhhf, Gg^Qhhf, Hh^Qhhf, Gg, Gs^Fp, Gg, Gs^Fp, Gs^Fms, Gs^Fp, Re^Qhu, Gg^Qhuf, Re, Rb, Re, Re, Gs, Gs, Gd, Ds^Edp, Ds^_ml, Dd^Qhu, Dd^Qhu, Ds^Qhu, Ds^Qhh, Gg^Qhh, Gs^Qhh, Hh^Qhh, Mm^Qhh, Mm^Qhh, Mm^Qhh, Mm^Qhh, Gs, Gs, Gg
Gg, Gg, Gg^Fds, Gg^Fp, Gg, Hh^Qhh, Mm^Qhh, Mm^Xm, Mm^Xm, Mm^Qhh, Mm^Xm, Hh, Gs^Fms, Gg, Gg, Gg, Gs^Fp, Gs^Fms, Gs^Fds, Rb^Qhu, Rb, Re, Rb, Re, Rb, Gs, Gd, Dd^Qhu, Gs^Efm, Dd^Qhu, Dd^Qhu, Ds^Qhu, Ds^Qhu, Dd^Qhu, Hd^Qhu, Hh^Qhh, Hh^Qhh, Mm^Qhh, Mm^Qhh, Hh^Fp, Gg, Gs
Gg, Gg^Edb, Gg, Gg, Hh^Vo, Hh, Hh, Mm^Qhh, Hh^Qhh, Mm^Xm, Mm^Qhh, Hh^Qhhf, Hh, Gg, Gs^Fms, Gs^Fds, Gs^Fds, Gg, Gs^Fms, Gg^Qhu, Gg^Qhu, Gg, Gg, Re, Re, Re, Rb, Gg^Qhu, Gs^Qhu, Gs^Efm, Gs, Hd^Qhu, Ds, Ds^Qhu, Dd^Qhu, Hd^Qhu, Ds, Gs, Hh, Hh^Qhh, Hh^Qhh, Hh
Cer, Cer^Edb, Cer^Edb, Gg, Gg, Hh, Gs, Hh, Gg, Hh^Qhh, Gg, Mm^Qhh, Hh^Qhh, Gg, Gg, Gg, Gg, Gs^Fms, Gg^Qhuf, Gg^Qhuf, Gg, Gg^Qhu, Gg^Qhu, Gg, Re, Rb, Re, Gg, Gg^Qhu, Gs^Efm, Gs, Ds, Ds, Gs, Gs, Gs, Ds, Gs^Efm, Gg^Efm, Hh, Gg, Hh^Qhh
Gs, Ker, Cer, Gs^Edb, Gs^Edb, Gg, Gs^Vo, Gg, Gg^Fp, Gs, Gg^Fms, Hh, Hh, Hh^Qhh, Hh^Qhh, Gg^Fms, Gg^Qhu, Gg^Qhu, Gg^Qhu, Cer^Dr, Gg^Fms, Cer^Edb, Cer^Edb, Gg^Efm, Gg^Efm, Rb, Rb, Re, Gs, Gs^Qhu, Gs^Qhu, Gg, Gg^Efm, Gg, Gg, Gs, Gg, Gg, Gg, Ds, Ds, Gg
Cer, Gs^Edb, Gs, Gs^Edb, Gs, Gs, Gg^Fms, Gg^Fms, Gg, Gg^Fp, Gg^Fds, Gg, Gg, Gg, Gs, Gg, Gg, Gg, Gg, Gs, Gs, Ker^Qhu, Rb, Cer^Dr, Gg^Fms, Gg^Efm, Re, Re^Edb, Re, Gg^Edb, Gs^Vhr, Gd^Qhu, Gs, Gs^Efm, Gs, Gs, Cer^Edb, Gs, Gg, Gg, Ds, Ds^Edp
Gs, Gg, Gd^Ecf, Gs^Edb, Gg, Gs, Gg, Gg^Fp, Gg, Gg, Gg, Gg^Fds, Gg, Gg, Gg, Gs, Gs, Gs, Rb^Dr, Rb^Vct, Rb, Rb, Re^Vct, Gg^Qhu, Gg^Fms, Re, Rb^Qhu, Re, Gg, Gs^Edb, Gs^Qhu, Gd^Qhu, Gs, Gg^Dr, Cer^Dr, Cer^Edb, Ker, Cer^Dr, Gg, Gg, Gg, Ds
Ds, Gd, Gd, Gg, Gg, Gg, Gg, Gg, Gg, Gg, Gs, Gg, Cer^Edb, Gg, Re^Dr, Gs, Gs, Gs^Ecf, Re^Edb, Re^Edb, Gs^Dr, Gs^Edb, Rb, Rb^Fp, Gs, Rb^Qhu, Rb^Edb, Gs^Edb, Gg^Edb, Gg, Gs^Qhu, Gs, Gg, Gg, Gg^Edb, Gg, Gg, Gg^Edb, Gg, Gg^Edb, Gs, Gg
Ds, Ds, Gg^Fds, Gs, Gs, Gg, Gs, Gg, Gs^Fms, Gg, Gs^Edb, Gs^Edb, Cer^Edb, Re^Dr, Ker^Qhu, Rb, Gd, Gd^Edb, Rb^Edb, Gd^Dr, Gs^Vct, Gg, Gg, Gs, Re^Edb, Gs^Ecf, Re, Re, Gs, Gg^Edb, Gs^Qhu, Gs, Gs^Efm, Gg, Gs, Gg, Gd^Edb, Gs, Gd, Gd, Gs^Vc, Gs^Edb
Ww, Ds, Ds, Gg^Fms, Gs^Vl, Gg^Fms, Gg, Gs^Fp, Gs, Gs, Gs, Gs, Gs^Edb, Gs, Cer, Cer^Dr, Gs, Gs^Vct, Re, Rb, Rb^Ecf, Rb, Gs, Gs^Ecf, Gd^Edb, Re, Rb, Rb, Gs^Edb, Gs^Edb, Gg^Ecf, Gd^Qhu, Gs, Gg, Gg^Efm, Gs^Edb, Gs^Vc, Gd^Edb, Rb, Rb^Edb, Rb, Re
Ww, Ww, Ww, Gs^Fp, Gs, Gs, Gs^Edb, Gg, Gg, Gs^Edb, Gd, Gd, Gs, Gg, Gg^Edb, Gs, Gs^Edb, Re, Gs^Dr, Re, Re, Rb, Gd, Gd, Re, Re, Re, Gs^Edb, Gg^Vct, Gg, Gg, Gd^Qhu, Gd^Qhu, Gg^Efm, Gg^Edb, Gs, Gs, Gd, Gs, Gs, Gd, Gd^Dr
Wwr, Ww, Ww, Ww, Gg^Fms, Gg^Fp, Gg^Fms, Gg, Gg, Co^Edt, Co^Edt, Gd^Dr, Co, Hh, Hh, Hh^Edb, Gg, Gs^Edb, Gs^Ecf, Re^Edb, Gs^Edb, Gs^Dr, Rb, Gd, Re, Re, Gd^Ecf, Re^Vct, Gg^Vct, Gg^Edb, Gg, Gg^Vct, Gs^Edb, Gd^Qhu, Gg^Efm, Gs, Cer, Cer^Dr, Ker, Cer, Gd^Dr, Gs
Wo, Wwr, Wwr, Ww, Gg^Fms, Gg^Fms, Hh, Gg^Fds, Hh, Co^Dr, Co^Kov, Rb^Dr, Gs^Edb, Hh^Edb, Co^Edb, Co^Dr, Gg^Dr, Gg^Dr, Gg, Gs^Edb, Re, Re^Edb, Re, Gs^Vct, Rb, Rb, Rb, Co, Gs, Gg, Ds, Gg, Gg^Vct, Ds^Qhu, Hd^Qhu, Gg, Gg^Edb, Gg, Ds, Cer^Dr, Ds, Gg
Wo, Wwr, Ww, Ww, Ww, Ds, Ds, Hh, Hh, Hh, Hh, Gd, Hhd^Dr, Gd, Gd^Vo, Co^Dr, Co^Edt, Gg^Edb, Gs^Dr, Gg, Gg, Rb^Edb, Gg^Qhu, Re, Rb^Dr, Re, Wwg, Rb^Dr, Wwg, Ds, Ds, Gd^Dr, Ds^Edb, Ds, Wwg^Qhu, Gg, Wwg^Qhu, Wwg^Qhu, Wwg^Qhu, Ds, Ds, Ds
Wo, Wo, Wo, Ww, Ww, Ww, Ds^Edb, Hh^Fp, Gg^Edb, Co^Dr, Co, Gs^Edb, Gd^Vo, Gd, Hd^Dr, Co^Kov, Ds^Edt, Ds^Edb, Ds, Ds, Wwrg, Gg, Gg, Co^Dr, Gg, Wwg, Wwg, Wwg, Wwg, Wwg, Wwg, Ds, Wwg, Wwg, Wwg^Qhu, Wwg^Qhu, Wwg, Wwg^Qhu, Ww^Qhu, Ww^Qhu, Ww^Qhu, Ww^Qhu
Wo, Wo, Wo, Ww, Ww, Ww, Ds, Ds, Gg, Gs^Edb, Ds, Ds, Ds, Co^Dr, Hh^Edb, Ds^Dr, Ds, Ds, Wwg, Wwrg, Wwg, Wwg, Wwg, Gg, Wwf, Wwg, Wwg, Wwg, Wwg, Wwg, Wwg, Wwg, Wwg, Wwg, Ww^Qhu, Ww, Ww, Ww, Ww, Ww, Ww, Ww
Wo, Wo, Ww, Ww, Ww, Ww, Ww, Ds, Wwg, Ds, Wwg, Ds^Edb, Ds^Edb, Hh^Edb, Hh, Ds, Wwrg, Ds, Wwg, Wwg, Wog, Wog, Wog, Wwf, Wwf, Wwg, Wwg, Wwg, Wog, Wog, Wog, Wwg, Ww, Ww, Ww, Ww, Ww, Ww, Ww, Ww, Ww, Ww
Ww, Ww, Ww, Ww, Wwg, Ww, Wwg, Wwg, Wwg, Wwg, Wwg, Wwg^Edb, Wwg, Wwg, Wwg, Wwg, Wwg, Wwg, Wwg, Wwg, Wog, Wog, Ds, Wog, Ds, Wwf, Ww, Ww, Wo, Wo, Ww, Ww, Ww, Ww, Wo, Ww^_ml, Ww, Ww, Wo, Ww, Ww, Ww
Dd^Do, Ww, Wwg, Wwg, Wwg, Wwg, Wwg, Wwg, Wwg, Wwg, Wog, Wog, Wog, Wwg, Wwg, Wwg, Wwg, Wwg, Wog, Wog, Ds, Ds, Ds, Ds, Wwf, Wwf, Wwf, Wo, Wo, Wo, Ww, Ww, Ww, Wo, Wo, Wo, Wo, Wo, Wo, Wo, Ww, Ww
