Ww, Gll^Fdf, Gll^Fdf, Gll^Fdf, Gll^Fdf, Gll^Fdf, Gll^Fdf, Gll^Fdf, Gll^Fdf, Ww, Ww, Ww, Ww, Ww, Ww, Ww, Ww, Ww, Ww, Ww, Ss, Ss, Gll^Fdf, Gll^Fdf, Gll^Fdf, Gll^Fdf, Gll^Fdf, Gll^Fdf, Gll^Fdf, Gll^Fmf, Gll^Fmf, Gll^Fdf, Gll^Fmf, Gll^Fmf, Gll^Fdf, Gll^Fdf, Gll^Fdf, Gll^Fdf, Gll^Fdf, Gll^Fdf, Gll^Fdf, Gll^Fdf, Gll^Fdf, Gll^Fdf, Gll^Fdf, Gll^Fdf
Wo, Ww, Ww, Gll^Fdf, Gll^Fdf, Gll^Fdf, Ss, Ss, Gll^Fdf, Ss, Ss, Ww, Ww, Ww, Ww, Ww, Ss, Ss, Ss, Ss, Ss, Ss, Gll^Fdf, Gll^Fdf, Gll^Fdf, Gll^Fdf, Gll^Fdf, Gll^Fdf, Gll^Fdf, Gll^Fdf, Gll^Fdf, Gll^Fmf, Gll^Fmf, Gll^Fdf, Gll^Fdf, Gll^Fdf, Gll^Fdf, Gll^Fdf, Gll^Fdf, Gll^Fdf, Gll^Fdf, Gll^Fdf, Gll^Fdf, Gll^Fdf, Gll^Fdf, Gll^Fdf
Ww, Wo, Wo, Ww, Gll^Fmf, Gll^Fdf, Ss, Gll^Fdf, Gll^Fdf, Gll^Fdf, Ss, Ww, Ss, Ww, Ss, Ss, Gll^Fmf, Gll^Fdf, Gll^Fdf, Gll^Fdf, Gll^Fdf, Gll^Fdf, Gll^Fdf, Gll^Fdf, Gll^Fdf, Gll^Fdf, Gll^Fdf, Gll^Fdf, Gll^Fdf, Gll^Fdf, Gll^Fdf, Gll^Fmf, Gll^Fdf, Gll^Fdf, Gll^Fdf, Gll^Fdf, Gll^Fmf, Gll^Fmf, Gg^Ve, Gll^Fmf, Gll^Fmf, Gll^Fmf, Gg^Fdf, Gll^Fmf, Gll^Fmf, Gg^Fdf
Gll^Fmf, Ww, Ww, Ww, Ww, Gll^Fdf, Gll^Fdf, Ss, Ss, Gll^Fdf, Ss, Ss, Gll^Fdf, Ss, Gll^Fmf, Ss, Gll^Fmf, Gll^Fdf, Gll^Fdf, Gll^Fdf, Gll^Fdf, Gll^Fdf, Gll^Fdf, Gll^Fdf, Gll^Fdf, Gll^Fdf, Gll^Fdf, Gll^Fdf, Gll^Fdf, Gll^Fdf, Gll^Fdf, Gll^Fdf, Gll^Fdf, Gll^Fdf, Gll^Fdf, Gll^Fmf, Gll^Fdf, Gll^Fdf, Gll^Fdf, Gll^Fmf, Gll^Fdf, Gll^Fdf, Gll^Fmf, Gg^Fdf, Gll^Fmf, Gll^Fmf
Gll^Fmf, Ww, Ww, Wo, Ww, Gll^Fdf, Gll^Fdf, Gll^Fdf, Gll^Fdf, Ss, Ss, Ss, Gll^Fdf, Ss, Ss, Gll^Fdf, Gll^Fdf, Gll^Fdf, Gll^Fdf, Gll^Fdf, Gg^Eff, Gg^Eff, Gg^Edb, Gg^Eff, Gg^Eff, Gll^Fdf, Gll^Fdf, Gll^Fdf, Gll^Fdf, Gll^Fmf, Gll^Fmf, Gll^Fdf, Gll^Fdf, Gll^Fdf, Gll^Fdf, Gll^Fmf, Gll^Fmf, Gll^Fdf, Gll^Fdf, Gll^Fmf, Gll^Fmf, Gll^Fdf, Gll^Fmf, Gll^Fmf, Gll^Fmf, Gll^Fmf
Gll^Fmf, Gll^Fmf, Ww, Wo, Wo, Ww, Gll^Fp, Gll^Fdf, Ss, Ss, Ss, Ss, Gll^Fdf, Gll^Fdf, Gll^Fdf, Gll^Fdf, Gll^Fdf, Gll^Fdf, Gll^Fdf, Gll^Fdf, Gll^Fdf, Gg^Edb, Gll^Cov, Gg^Edb, Gll^Fdf, Gll^Fdf, Gll^Fdf, Gll^Fdf, Gll^Fdf, Gll^Fdf, Gll^Fmf, Gll^Fmf, Gll^Fmf, Gll^Fdf, Gll^Fdf, Gg^Fet, Gll^Fdf, Gll^Fmf, Cv, Gll^Fdf, Gll^Fmf, Gll^Fdf, Gll^Fdf, Gll^Fmf, Gll^Fdf, Gll^Fmf
Gll^Fmf, Gll^Fmf, Ww, Ww, Wo, Ww, Gll^Fmf, Gll^Fmf, Gll^Fdf, Ss, Ss, Ss, Gll^Fdf, Gll^Fdf, Gll^Fdf, Gll^Fdf, Gll^Fdf, Gll^Fdf, Gg^Eff, Gg^Eff, Gll^Cov, 5 Gll^Kov, Gg^Edb, Gll^Fdf, Gll^Fdf, Gll^Fdf, Gll^Fdf, Gll^Fdf, Gll^Fdf, Gll^Fdf, Gll^Fdf, Gll^Fdf, Gll^Fdf, Gll^Fdf, Gll^Fdf, Gll^Fmf, Gll^Fdf, Cv, Gll^Fmf, Gll^Fdf, Gg^Fet, Gll^Fmf, Gll^Fmf, Gll^Fmf, Gll^Fdf, Gll^Fdf
Gll^Fmf, Gll^Fmf, Gll^Fmf, Ww, Wo, Ww, Gll^Fmf, Gll^Fdf, Gll^Fdf, Ss, Ss, Ss, Ss, Gll^Fmf, Gll^Fmf, Gll^Fmf, Gll^Fdf, Gll^Fdf, Gg^Eff, Gg^Edb, Gg^Edb, Gg^Edb, Gg^Eff, Gg^Eff, Gg^Em, Gll^Fdf, Gll^Fdf, Gll^Fdf, Gll^Fdf, Gll^Fdf, Gll^Fmf, Gg^Ve, Gll^Fdf, Gll^Fmf, Gll^Fdf, Cv, Cv, 3 Kv, Cv, Gll^Fdf, Gll^Fdf, Gll^Fdf, Gg^Ve, Gll^Fdf, Gll^Fdf, Gll^Fdf
Gll^Fmf, Gll^Fmf, Gll^Fmf, Ww, Wo, Ww, Ww, Gll^Fmf, Gll^Fdf, Ss, Ss, Ss, Ss, Ss, Ss, Gll^Fmf, Gll^Fdf, Gll^Fdf, Gll^Fdf, Gg^Eff, Gll^Fdf, Gll^Fdf, Gll^Fdf, Gll^Fdf, Gll^Fdf, Gg^Em, Gll, Gll^Fdf, Gll^Fdf, Gll^Fdf, Gll^Fdf, Gll^Fmf, Gll^Fdf, Gll^Fdf, Gll^Fdf, Gll^Fdf, Gll^Fdf, Gll^Fmf, Cv, Gll^Fdf, Gg^Fdf, Gll^Fmf, Gll^Fdf, Gll^Fmf, Gll^Fmf, Gll^Fdf
Ss, Ss, Gll^Fmf, Ww, Ww, Wo, Ww, Gll^Fdf, Gll^Fdf, Gg^Fmf, Ss, Gll^Fdf, Ss, Ss, Ss, Ss, Gll^Fdf, Gll^Fdf, Gll^Fdf, Gll^Fdf, Gll^Fdf, Gll^Fdf, Gll^Fdf, Gll^Fdf, Gll^Fdf, Gll^Fdf, Gll^Fdf, Gll, Gll^Fdf, Gll^Fdf, Gll^Fdf, Gll^Fdf, Gll^Fdf, Gll^Fdf, Gll^Fdf, Gll^Fdf, Gg^Fet, Gll^Fmf, Gll^Fdf, Gll^Fmf, Gll^Fdf, Gll^Fdf, Gll^Fdf, Gll^Fmf, Gll^Fdf, Gll^Fdf
Ss, Ss, Gll^Fmf, Gll^Fdf, Ww, Wo, Ww, Gll^Fp, Gll^Fdf, Gg^Fmf, Gll^Fdf, Ss, Ss, Ss, Ss^Fdf, Ss, Ss, Gll^Fdf, Ss, Gll^Fdf, Gll^Fdf, Gll^Fdf, Gll^Fdf, Gll^Fdf, Gll^Fdf, Gll^Fdf, Gll^Fdf, Gg^Em, Gg^Em, Gll^Fdf, Gll^Fdf, Gll^Fdf, Gll^Fdf, Gll^Fdf, Gll^Fdf, Gll^Fdf, Gll^Fdf, Gll^Fdf, Gll^Fdf, Gll^Fdf, Gs^Fdf, Gll^Fdf, Gll^Fdf, Gll^Fdf, Gll^Fdf, Gll^Fdf
Ss, Gll^Fmf, Gll^Fmf, Gll^Fdf, Ww, Ww, Ww, Gll^Fp, Gll^Fdf, Gll^Fdf, Gg^Fmf, Ss, Ss, Ss, Gll^Fdf, Ss, Gll^Fdf, Ss, Ss, Gll^Fdf, Ss, Gg^Fmf, Ss, Gll^Fdf, Gg^Fmf, Gll^Fdf, Gll^Fdf, Gll^Fdf, Gll^Fdf, Gg^Em, Gll^Fdf, Gll^Fdf, Gll^Fdf, Gll^Fdf, Gll^Fdf, Gll^Fdf, Gll^Fdf, Gll^Fdf, Gg^Em, Gg^Em, Gg^Em, Gg^Em, Gg^Em, Gll^Fdf, Gll^Fdf, Gll^Fdf
Gll^Fmf, Ss, Ss, Gll^Fp, Ww, Wo, Ww, Gll^Fdf, Gll^Fdf, Gll^Fdf, Gll^Fdf, Ss, Ss, Ss, Gll^Fdf, Gll^Fdf, Gll^Fdf, Gll^Fdf, Gll^Fdf, Ss, Gll^Fdf, Ss, Ss, Ss, Gll^Fdf, Gll^Fdf, Gll^Fdf, Gll^Fdf, Gll^Fdf, Gll, Gg^Em, Gll^Fdf, Gll^Fdf, Gll^Fdf, Gll^Fdf, Gll^Fdf, Gll^Fdf, Gll^Fdf, Gg^Em, Gg^Em, Gg^Fetd, Gg^Efm, Gg^Em, Gll^Fdf, Gll^Fdf, Gll^Fdf
Gll^Fmf, Gll^Fmf, Ss, Ss, Ww, Wo, Wo, Ww, Gll^Fdf, Gll^Fdf, Gll^Fdf, Ss, Gll^Fdf, Gll^Fdf, Gll^Fdf, Gll^Fdf, Gll^Fdf, Gll^Fdf, Gll^Fdf, Gll^Fdf, Gll^Fdf, Gg^Fmf, Gg^Fmf, Ss, Ss, Gll^Fdf, Gll^Fdf, Gll^Fdf, Gll^Fdf, Gll^Fdf, Gg^Em, Gll^Fdf, Cv^Em, Cvr^Fdf, Cvr^Fdf, Gll^Fdf, Gll^Fdf, Gg^Em, Gg^Em, Gg^Efm, Gg^Efm, Gg^Em, Gs^Fdf, Gll^Fdf, Gll^Fdf, Gll^Fdf
Ss, Gll^Fmf, Ss, Ss, Ss, Ww, Wo, Ww, Gll^Fdf, Gll^Fdf, Gll^Fdf, Gll^Fdf, Gll^Fdf, Gll^Fdf, Gg^Ve, Gll^Fdf, Gll^Fdf, Gll^Fdf, Gll^Fdf, Gll^Fdf, Gg^Ve, Gll^Fdf, Gll^Fdf, Gll^Fdf, Gll^Fdf, Gll^Fdf, Gll^Fdf, Ss, Gll^Fmf, Gll^Edt, Cvr^Fdf, 2 Kvr, Ww^Ewf, Ww^Ewl, Gll^Fdf, Cv^Em, Rp, Gg^Em, Gll^Fdf, Gg^Em, Gll^Fdf, Gg^Em, Gll^Fmf, Gll^Fmf, Gll^Fdf, Gll^Fdf
Ss, Gll^Fmf, Gll^Fmf, Ss, Ss, Ww, Wo, Ww, Ww, Gll^Fdf, Gll^Fdf, Gll^Fdf, Gll^Fdf, Gll^Fdf, Gll^Fdf, Gll^Fdf, Gll^Fdf, Gll^Fdf, Gll^Fdf, Gll^Fdf, Gll^Fdf, Gll^Fdf, Gll^Fdf, Gll^Fdf, Gll^Fdf, Gll^Fdf, Gll^Fdf, Gll^Fmf, Gll^Fmf, Gll^Fmf, Wwrg, Ww^Bs|, Rp, Rp, Rp, Rp, Gg^Em, Gll^Fdf, Gll^Fdf, Gll^Fdf, Gll^Fmf, Gll^Fdf, Gll^Fmf, Gll^Fmf, Gll^Fmf, Gll^Fdf
Ss, Ss, Gll^Fmf, Ss, Ss, Ww, Ww, Wo, Wo, Ww, Gll^Fdf, Gll^Fdf, Gll^Fdf, Gll^Fdf, Ss, Gll^Fdf, Gll^Fdf, Gll^Fdf, Gll^Fdf, Gll^Fdf, Gll^Fdf, Gll^Fdf, Gll^Fdf, Gll^Fdf, Gll^Fdf, Gll^Fdf, Gll^Fdf, Gll^Fdf, Gll^Fdf, Cvr, Gg^Em, Rp, Gll^Fdf, Cvr, Gll^Fdf, Gll^Fdf, Gll^Fdf, Gll^Fdf, Gll^Fdf, Gll^Fmf, Gll^Fmf, Gg^Ve, Ss, Gll^Fdf, Gll^Fdf, Gll^Fdf
Ss, Ss, Ss, Ss, Ss, Ss, Ss, Ww, Wo, Ww, Ww, Gll^Fdf, Gll^Fdf, Gll^Fdf, Ss, Gll^Fdf, Ss, Gll^Fdf, Cv, Gll^Fdf, Gll^Fdf, Gll^Fdf, Gll^Fdf, Gll^Fdf, Gll^Fdf, Gll^Fdf, Gll^Fdf, Gll^Fdf, Gll^Fdf, Cvr^Fdf, Rp, Rp, Ww^Ewl, Cvr^Fdf, Gll^Fmf, Gll^Fdf, Gll^Fdf, Gll^Fdf, Gll^Fdf, Gg^Em, Gll^Fdf, Ss, Gll^Fdf, Ss, Ss, Ss
Gg^Fdf, Ss, Ss, Ss, Gll^Fmf, Ss, Ss, Ww, Ww, Wo, Ww, Ww, Gll^Fdf, Gll^Fdf, Gll^Fdf, Ss, Cv, Cv, Cv, Ss, Ss, Gll^Fdf, Gll^Fdf, Gg^Ve, Gll^Fdf, Gll^Fdf, Rp, Rp, Rp, Rp, Ww^Ewl, Ww^Bs|, Cvr^Fdf, Cvr^Fmf, Gll^Fdf, Gll^Fmf, Gll^Fdf, Gg^Em, Gll^Fdf, Gll^Fdf, Gll^Fdf, Gll^Fdf, Gll^Fdf, Gll^Fdf, Ss, Gll^Fdf
Gg^Fdf, Ss, Ss^Fmf, Ss, Gll^Fmf, Ss, Ss, Ss, Ss, Ww, Wo, Ww, Ww, Gll^Fdf, Gll^Fdf, Cv, Cv, 6 Kv, Cv, Ss, Gll^Fdf, Ss, Gll^Fdf, Gll^Fdf, Rp, Rp, Gll^Fdf, Cvr, Cvr^Fdf, Ss^Ewl, Cvr, Kvr, Gll^Fdf, Gll^Fdf, Gll^Fdf, Gll^Fdf, Gll^Fdf, Gll^Fdf, Gll^Fp, Gll^Fdf, Gll^Fmf, Gll^Fdf, Gll^Fdf, Ss, Gll^Fp, Gll^Fdf
Ss, Ss, Ss, Ss, Gll^Fmf, Ss, Gll^Fmf, Gll^Fmf, Gll^Fmf, Ww, Ww, Wo, Wo, Ww, Ww, Ww, Ww, Cv, Cv, Gll^Fdf, Gll^Fdf, Gll^Fdf, Rp, Rp, Gll^Fdf, Gll^Fdf, Gll^Fdf, Gll^Fdf, Gll^Fdf, Cvr^Fdf, Ss, Gll^Fmf, Gll^Fdf, Ss, Ss, Gg^Ve, Ss, Gll^Fdf, Gll^Fdf, Gll^Fdf, Gll^Fdf, Gll^Fmf, Ss, Ss, Gll^Fdf, Gll^Fdf
Ss, Ss, Ss, Gll^Fmf, Ss, Gll^Fmf, Ss, Ss, Ss, Gll^Fmf, Gll^Fmf, Ww, Wo, Wo, Wo, Ww, Ww, Wwf, Gll^Fdf, Gll^Fdf, Rp, Rp, Gll^Fdf, Gll^Fdf, Gll^Fdf, Gll^Fdf, Gll^Fdf, Gll^Fdf, Gll^Fdf, Gll^Fdf, Ss, Gll^Fdf, Ss, Gll^Fdf, Ss, Ss, Ss^Fdf, Ss, Gll^Fdf, Gll^Fdf, Gll^Fdf, Gll^Fmf, Gll^Fdf, Ss, Gll^Fp, Gll^Fdf
Ss, Ss, Ss, Ss, Ss, Gll^Fmf, Gll^Fmf, Gll^Fmf, Gll^Fmf, Ss, Ww, Ww, Ww, Ww, Ww, Ww, Wwr, Wwf, Ww^Bsb/, Rp, Gll^Fdf, Gll^Fdf, Gll^Fdf, Ss, Ss, Ss, Ss, Gll^Fdf, Gll^Fmf, Gll^Fdf, Ss, Gll^Fmf, Ss, Gll^Fdf, Ss, Ss^Fdf, Ss^Fp, Ss^Fmf, Ss, Gll^Fdf, Ss, Gll^Fdf, Ss, Ss, Gll^Fp, Gll^Fdf
Ss, Gll^Fmf, Gll^Fp, Ss, Gll^Fmf, Gll^Fmf, Ss, Gll^Fmf, Gll^Fmf, Ss, Gll^Fmf, Ww, Gll^Fmf, Gll^Fdf, Ss^Fmf, Wwr, Ww^Bsb/, Ww^Bsb/, Ww, Wwr, Cv, Gll^Fdf, Gll^Fdf, Gll^Fdf, Gll^Fdf, Ss, Ss, Gll^Fdf, Ss, Gll^Fmf, Gll^Fmf, Ss, Gll^Fdf, Gll^Fdf, Ss, Ss^Fmf, Ss, Ss, Ss, Ss, Ww^Vm, Ss, Gll^Fdf, Gll^Fdf, Gll^Fdf, Gll^Fdf
Gll^Fp, Gll^Fp, Ss, Ss, Gll^Fmf, Ss, Gll^Fmf, Gll^Fmf, Ss, Gll^Fmf, Gll^Fmf, Gll^Fdf, Gll^Fdf, Gll^Fdf, 1 Gll, Rp, Wwf, Wwr, Ww, Ww, Ww, Gll^Fdf, Gll^Fdf, Gll^Fdf, Gll^Fdf, Ss, Ss, Ss, Gll^Fdf, Gll^Fmf, Gll^Fdf, Ss, Ss, Gll^Fp, Ss, Ss, Ww, Ss, 4 Kme, Ww, Ww, Ss, Gll^Fdf, Gll^Fmf, Gll^Fmf, Gll^Fdf
Gll^Fp, Gll^Fp, Gll^Fp, Ss, Ss, Gll^Fmf, Ss, Ss, Ss, Ss, Ss, Ss^Fp, Gll^Fdf, Gll, Ds, Gs^Fmf, Ss^Fp, Ww, Ww, Wo, Ww, Gll^Fdf, Gll^Fdf, Gll^Fdf, Ss, Ss, Ss, Gll^Fdf, Gll^Fdf, Gll^Fmf, Gll^Fmf, Gll^Fdf, Gll^Fdf, Ss, Ss, Ww^Ewl, Ww, Cme, Ww, Ww, Ww, Ww^Ewl, Ww^Ewf, Gll^Fdf, Gll^Fdf, Gll^Fmf
Gll^Fp, Ss^Fmw, Ss, Ss, Ss, Ss, Ss, Ss, Ss^Fmw, Ss, Ss^Fp, Ss^Fmf, Ss, Gll, Gll^Fmf, Ss, Gll^Fmf, Ss^Fp, Ww, Ww, Ww, Ww, Gll^Fdf, Gll^Fdf, Ss, Ss, Gll^Fdf, Gll^Fdf, Gll^Fdf, Gll^Fdf, Gll^Fdf, Gll^Fdf, Ss, Ss, Ss, Ww, Ww^Ewl, Ww, Ww, Ww, Ww, Ww^Ewl, Ww^Ewl, Gll^Fdf, Gll^Fmf, Gll^Fmf
Gll^Fp, Gll^Fp, Ss, Ss, Ss^Fms, Ss^Fms, Ss, Ss^Fmw, Ss, Ss, Ds, Ds, Ss, Ss^Fp, Ss, Ss, Gll^Fmf, Gll^Fdf, Ww, Wo, Wo, Ww, Gll^Fdf, Gll^Fdf, Gll^Fdf, Gll^Fdf, Gll^Fdf, Gll^Fdf, Gll^Fdf, Gll^Fdf, Ss, Ss, Ss, Ss, Ss, Ww^Ewl, Ss, Ww, Ww, Ww^Ewf, Ww^Ewl, Ww, Gll^Fdf, Gll^Fdf, Gll^Fmf, Gll^Fmf
Ss, Ss, Ss, Ss, Ss, Ss, Ss^Fp, Ss, Ss, Ds, Ss, Ss, Ss, Gll^Fmf, Ss, Ss, Ss, Wwt, Ww, Wo, Ww, Ww, Gll^Fmf, Gll^Fdf, Gll^Fdf, Gll^Fdf, Gll^Fmf, Gll^Fdf, Gll^Fmf, Gll^Fdf, Ss, Ss, Gll^Fdf, Ss, Gll^Fdf, Ss, Gll^Fdf, Gll^Fdf, Ww, Ww, Ww, Ww^Ewl, Ss, Gll^Fdf, Gll^Fmf, Gg^Fdf
Ss^Fds, Ss^Fds, Ss, Ss^Fmw, Ds, Ds, Ds, Ds, Ss, Ss, Ss^Fdw, Ss, Ss, Ss, Ss, Ss, Ss, Wwt, Ww, Wo, Ww, Gll^Fmf, Ss, Gll^Fmf, Gll^Fmf, Gll^Fmf, Ss, Gll^Fp, Ss, Gll^Fmf, Ss, Ss, Gll^Fmf, Gll^Fdf, Gll^Fdf, Gll^Fdf, Gll^Fdf, Gll^Fdf, Ww, Ww^Vm, Ww, Ss, Gll^Fdf, Gll^Fdf, Gll^Fdf, Gll^Fmf
Ds, Ds, Ss^Fmw, Ds, Ds, Ss^Fp, Ss^Fp, Ss^Fp, Ss, Ss, Ss, Ss, Ss, Ss, Ss, Ss, Ss^Fp, Ss, Ww, Wo, Wo, Ww, Gll^Fmf, Ss, Ss, Ss, Ss, Ss, Ss, Gll^Fp, Ss, Ss, Gll^Fdf, Gll^Fdf, Gll^Fdf, Gll^Fdf, Ss, Ww, Ww^Ewl, Ww, Ss, Ss, Ss, Ss, Gll^Fmf, Gll^Fdf
Ss, Ss, Ss, Ds^Fms, Ss^Fms, Ss, Ss, Ss, Ss, Ss, Ds^Fp, Ss, Ss, Ss, Ss, Ss^Fmf, Ss^Fmf, Ss^Fp, Ww, Ww, Wo, Ww, Gll^Fdf, Gll^Fdf, Gll^Fmf, Ss, Ss, Ss, Ss, Ss, Ss, Ss, Gll^Fmf, Gll^Fdf, Gll^Fdf, Gll^Fdf, Gll^Fdf, Ss, Ss, Ss, Ss, Gll^Fmf, Gll^Fp, Gll^Fmf, Gll^Fmf, Gll^Fdf
Gll^Fp, Gll^Fp, Gll^Fp, Ss, Ss, Ss, Gll^Fp, Gll^Fp, Gll^Fms, Ds^Fp, Ss, Ss, Ss, Ss, Ss, Ss^Fmf, Ss^Fmf, Ss^Fmf, Ww, Ww, Wo, Ww, Ss, Gll^Fdf, Gll^Fmf, Ss, Gll^Fp, Ss, Gll^Fmf, Ss, Gll^Fmf, Gll^Fmf, Gll^Fmf, Gll^Fdf, Gll^Fdf, Gll^Fdf, Gll^Fdf, Gll^Fdf, Ss, Ss, Ss, Gll^Fmf, Gll^Fmf, Gll^Fdf, Gll^Fdf, Gll^Fdf
Gll^Fp, Gll^Fp, Ss, Ss, Ss, Ss, Gll^Fp, Gll^Fp, Ss, Ss, Ss, Ss, Ss, Ss, Ss, Ss^Fmf, Ss^Fmf, Ww, Wo, Wo, Ww, Ww, Gll^Fdf, Gll^Fdf, Gll^Fdf, Gll^Fdf, Gll^Fdf, Gll^Fp, Gll^Fdf, Gll^Fdf, Gll^Fdf, Gll^Fdf, Gll^Fdf, Gll^Fdf, Gll^Fdf, Gll^Fdf, Gll^Fdf, Ss, Ss, Ss, Gll^Fmf, Ss, Gll^Fmf, Gll^Fmf, Gll^Fdf, Gll^Fdf
Ss, Ss, Ss, Ss, Gll^Fp, Gll^Fp, Gll^Fp, Ss, Ss, Ss, Ss, Ss, Gg^Fdf, Ss, Ss^Fmf, Ss^Fmf, Ss^Fmf, Ww, Wo, Ww, Gll^Fdf, Gll^Fdf, Gll^Fdf, Gll^Fdf, Gll^Fdf, Gll^Fdf, Gll^Fdf, Gll^Fdf, Gll^Fdf, Gll^Fdf, Gll^Fdf, Gll^Fdf, Gll^Fdf, Gll^Fdf, Gll^Fdf, Gll^Fdf, Gll^Fdf, Ss, Ss, Ss, Gll^Fmf, Gll^Fmf, Gll^Fmf, Gll^Fmf, Gll^Fdf, Gll^Fdf
