Aa, Ha, Aa, Ms, Ms, Ms, Ms, Ms, Ms, Ms, Ms, Ms, Ms, Ms, Wwf, Ms, Ha, Ha, Wwr, Ww, Ww, Ha^Fp, Ha, Ha, Ww, Ms, Ms, Ms, Aa^Fp, Aa^Fp, Aa, Ms, Ha^Fp, Ha, Aa, Ha^Fp, Aa, Aa, Gs, Gd
Aa, Aa^Fp, Aa^Fp, Ha, Ha^Fp, Ms, Ms^Xm, Ms^Xm, Ms^Xm, Ms^Xm, Ms^Xm, Ms^Xm, Ms^Xm, Ms, Ms, Wwf, Wwf, Wwf, Aa, Aa^Fp, Aa^Fp, Ww, Ha^Fp, Ha^Fp, Ww, Aa^Fp, Aa^Fp, Aa, Wwt, Wwt, Wwt, Aa, Aa, Aa^Fp, Wwt, Aa, Aa, Ms, Hhd, Md
Aa, Aa^Fp, Aa, Aa, Ha^Fp, Ms^Fp, Ms, Ms^Xm, Ms^Xm, Ms^Xm, Ms^Xm, Ms^Xm, Ms, Ms, Ms, Ms, Ms, Ha^Fp, Aa^Fp, Aa^Fp, Aa, Ww, Ww, Wwr, Ww, Aa^Fp, Wwt, Wwt, Ur, Gs, Gs, Wwrt, Wwrt, Wwt, Aa^Fdw, Wwt, Wwt, Wwrt, Wwt, Md
Ha, Aa, Aa, Ha^Fp, Ms, Ms, Ms, Ms^Xm, Ms^Xm, Ms^Xm, Ms^Xm, Ms^Xm, Ms^Xm, Ms, Ms, Ms, Ms, Ms, Ha, Ha, Aa, Aa^Fdw, Aa^Fdw, Ww, Aa^Fdw, Wwt, Gs, Gd, Mv, Md, Md, Ur, Ur, Gs, Hhd, Aa^Fdw, Wwt, Wot, Wot, Wwrt
Ms^Xm, Ha, Ha, Ha, Ms, Ms, Ms, Ms, Ms, Ms^Xm, Ms, Ms^Xm, Ms, Ms, Ms, Ms, Ms, Ms, Ha, Aa^Fdw, Gs, Gs, Hhd, Gs, Gd, Gs, Ur, Md, Md, Md, Qlf, Md, Ur, Hhd, Mv, Hhd, Hhd, Wwt, Wwt, Wwrt
Ms^Xm, Ms^Xm, Ms^Xm, Aa, Aa, Ms, Ms, Ms, Ms, Ms, Ms, Ms, Ms, Ms, Ms, Ms, Ha^Fp, Aa^Fdw, Gs, Gs, Hhd, Gd, Ur, Hhd, Hhd, Ur, Qlf, Qlf, Qlf, Qlf, Md, Qlf, Qlf, Md, Md, Md, Wwt, Wwt, Ms, Ha
Ms^Xm, Ms^Xm, Ms, Ms, Ms, Ha, Ms, Ms, Ms, Ms, Ms, Ms, Ms, Ms, Ms, Ms, Ms, Gs, Gd, Ur, Qlf, Hhd, Qlf, Qlf, Qlf, Qlf, Hhd, Md, Md, Md, Qlf, Qlf, Md, Md, Wot, Wwt, Ms, Ms, Ms, Ms
Ms, Ms, Wo, Wo, Wo, Ha, Ha, Ms, Ms, Ms, Ms, Ms, Ha, Ha, Wwf, Ms, Ha, Gs, Gd, Ur, Hhd, Qlf, Ur, Ur, Hhd, Qlf, Hhd, Md, Md, Qlf, Qlf, Qlf, Md, Ur, Wwrt, Wwt, Aa, Aa, Aa^Fp, Ms
Wo, Wo, Ww, Wo, Ww, Wwr, Ww, Wwr, Ha, Ha, Ha, Ha, Ms, Ms, Wwf, Wwf, Aa, Gs, Gs, Gd, Gd, Ur, Gd, Hhd, Ur, Qlf, Hhd, Md, Md, Md^Ebn, Md, Md, Ql, Md, Mv, Wwrt, Wwt, Aa, Aa, Aa^Fp
Aa, Aa, Aa, Ww, Aa, Ww, Ww, Aa, Aa, Ha, Ha, Ms, Aa, Aa, Wwr, Aa, Aa, Ha, Ha, Gs, Gs, Gd, Gs, Gd, Gd, Hhd, Md, Md, Md, Md, Hhd, Md, Ql, Md, Md, Md, Wwrt, Wot, Wwt, Aa
Aa^Fp, Aa^Fp, Aa^Fp, Aa, Ha, Aa^Es, Aa^Es, Aa, Ha^Fp, Aa, Ha, Ha^Fp, Ha^Fp, Aa, Ha, Ww, Aa^Fp, Aa^Fp, Aa^Fp, Aa^Fdw, Ms, Ms, Aa^Fdw, Gs, Gs, Gd, Hhd, Md, Md, Md, Hhd, Md, Md, Ql, Hhd, Md, Gs, Wwt, Aa, Wwt
Ha^Fp, Ha^Fp, Aa^Fp, Ha, Aa^Es, Aa^Vc, Aa^Es, Aa^Fp, Aa, Ha, Ms, Ha^Fp, Ha, Ms, Aa, Ww, Aa, Ha, Ha, Ms, Aa^Fp, Aa^Fp, Aa, Aa, Aa^Fdw, Gs, Gs, Md, Gd, Gd, Md, Md, Md, Hhd, Gd, Gd, Aa, Aa, Aa, Aa
Ha^Fp, Aa^Fp, Ha^Fp, Aa^Fp, Ha^Fp, Aa^Es, Aa^Fp, Aa, Ha, Aa, Aa, Ms, Ms, Ha, Ww, Ww, Ww, Aa, Aa, Aa, Aa^Vc, Aa^Fp, Aa^Fp, Aa, Aa^Fp, Ha, Aa^Fdw, Gs, Gs, Md, Md, Hhd, Gd, Hhd, Gs, Aa, Aa^Fdw, Aa^Fdw, Aa, Aa
Aa^Fp, Ha^Fp, Ha, Ha, Ha^Fp, Aa, Aa, Aa, Aa^Fp, Ms, Ms^Fp, Ms^Fp, Ms, Ha, Ww, Wo, Ww, Ha, Ha, Ms, Aa, Aa^Fp, Ai^Fp, Aa, Aa, Ha, Ds, Aa, Aa, Gs, Gs, Gd, Gd, Gs, Aa, Aa, Aa, Aa^Fdw, Ai, Ai
Aa^Fp, Aa, Aa, Ha, Aa, Aa^Fp, Aa^Fp, Aa^Fp, Aa^Fp, Ms, Ms, Aa^Efm, Aa^Fp, Ha, Ww, Wo, Wo, Ww, Aa^Fp, Aa, Aa, Aa^Fp, Ds, Ai, Ai, Ds, Ai, Ds, Ha, Ha, Ha^Fp, Gs, Aa, Gs, Aa^Fdw, Aa^Fdw, Aa, Aa, Ai, Aa
Aa^Fp, Aa^Fp, Aa, Aa, Ha, Aa^Fp, Aa^Fp, Ai, Ai, Aa^Fp, Ha, Ms^Fp, Ha, Ww, Ww, Ww, Ww, Ww, Ai^Fp, Aa^Efm, Aa, Ds, Ai, Ai, Ds, Ai, Ds, Aa, Aa, Ha^Fp, Ha^Fp, Ha, Aa, Aa^Fdw, Aa^Fdw, Aa, Ai^Fp, Ai, Ds^Fp, Ds^Fp
Aa^Fp, Aa^Fp, Ha^Fp, Ha^Fp, Aa^Fp, Aa^Fp, Aa^Fp, Ai, Ha, Ha, Ha^Fp, Ha, Ww, Ww, Ha, Ms, Ww, Ai^Fp, Ai^Fp, Ai, Ai, Ai, Ds, Ai, Ai, Ai, Ds, Ds, Aa, Ms, Aa, Ha, Ha, Aa, Aa, Aa, Ai, Aa^Fp, Aa, Aa
Aa, Aa, Ha^Fp, Ai, Ss^Vhs, Ss, Ss, Ss, Ww, Ww, Ww, Ww, Ww, Ha^Fp, Ms, Ms^Fp, Ha^Fp, Ww, Aa, Aa, Ai, Ds, Ai, Ai, Ds, Ds, Ds^Vdt, Aa, Ai, Aa, Ai^Fp, Aa, Aa, Ha, Aa^Fp, Aa, Aa, Ai^Fp, Ai, Aa
Aa^Fp, Aa^Fp, Aa, Ai^Fp, Ww, Ww, Ww, Ww, Aa^Fp, Ww, Ss, Ww, Ds^Fp, Ha^Fp, Aa^Fp, Ha^Fp, Ss, Ww, Aa, Ai, Ai, Ai, Ds, Ai, Ds, Ds, Ha, Ds, Ai, Ai, Ai, Aa, Aa, Ha, Aa^Fp, Ai, Ds^Fp, Aa, Ai, Aa^Fp
Aa^Fp, Aa^Fp, Aa^Fp, Aa, Ww, Aa^Fp, Aa, Ai, Ai, Ss, Ss, Ww, Ds, Ds^Fp, Aa^Vc, Aa^Fp, Ss, Ww, Ww, Aa^Fp, Ds^Fp, Ds, Dd^Fp, Ds, Aa^Fp, Ha, Ms, Ha^Fp, Ms^Fp, Ha^Fp, Ha^Fp, Ai^Fp, Ai^Fp, Aa, Ds, Ds^Fp, Ds, Aa, Ai, Aa^Fp
Aa^Fp, Aa^Fp, Ww, Ww, Aa, Aa^Fp, Ai, Aa, Aa^Fp, Ss, Ww, Ww, Aa^Fp, Aa^Fp, Ds^Fp, Ds^Fp, Ai, Ss, Ss, Ww, Ww^Bw/r, Ds, Ds^Fp, Ds^Fp, Aa^Fp, Aa^Fp, Ha^Fp, Aa^Fp, Qxu, Ms, Ai, Aa, Aa, Aa, Aa, Aa, Aa, Sm^Gvs, Ds^Fp, Ds^Fp
Ww, Ww, Aa, Aa^Fp, Ha^Fp, Aa^Fp, Aa^Fp, Ai^Fp, Ww, Ww, Aa^Fp, Aa^Fp, Aa, Aa^Fp, Ds, Ai, Ai, Ai, Aa, Ds, Ww, Ai, Ha^Fp, Ha^Fp, Aa^Fp, Ha^Fp, Qxu, Qxu, Ms^Fp, Ms, Ai, Ai, Ai, Ds, Ds, Aa^Fp, Aa, Sm^Gvs, Ww^Gvs, Wwr
Aa^Fp, Aa^Fp, Ha^Fp, Aa^Fp, Ha^Fp, Ha^Fp, Aa^Fp, Ww, Ss, Ss, Ai, Ai, Ds, Ds^Fp, Ai, Ai, Ai, Aa, Ds, Ds, Ww, Ai, Ha^Fp, Ms^Fp, Ha^Fp, Qxu, Aa^Fp, Aa^Fp, Aa^Fp, Ha^Fp, Aa, Ds, Ds, Ai, Ai, Ai, Ww, Ww^Bw\r, Ww^Bw\r, Ww
Ha, Aa^Fp, Ha^Fp, Ha^Fp, Ha, Ha, Aa^Fp, Ww, Ss, Ai, Ds^Fp, Ds, Ai, Ai, Ai, Ai, Aa^Fp, Ds^Fp, Ww, Ww, Ai, Ai^Fp, Aa^Fp, Aa^Fp, Qxu, Qxu, Aa^Fp, Ms^Fp, Ms, Ms, Ms^Fp, Ha^Fp, Ds^Fp, Ai, Ai, Ai, Aa, Ww, Ww, Ww^Vht
Ha, Ha^Fp, Aa, Aa, Aa, Aa^Fp, Aa^Fp, Ss, Ai, Ds^Fp, Ai, Ds, Ai^Fp, Ai, Ai, Aa^Fp, Ds, Ds, Ww, Ai^Fp, Aa^Fp, Ha^Fp, Aa^Fp, Aa^Fp, Qxu, Ms^Fp, Ms^Fp, Ms, Ms^Fp, Ms, Ai^Vhs, Ha^Fp, Ai^Eff, Ai, Aa^Fp, Aa, Ds, Ww, Ww, Ww
Ha, Aa^Fp, Aa, Aa^Fp, Aa^Fp, Ss, Ww^Vhs, Ss, Sm^Gvs, Ai, Ai, Ds^Fp, Ai, Ai, Ai, Ai^Fp, Ds, Ss^Vhs, Ww, Ai, Aa^Fp, Aa^Fp, Ha^Fp, Ha^Fp, Qxu, Ha^Fp, Ha^Fp, Ms^Fp, Ha^Fp, Ha^Fp, Sm^Gvs, Sm^Gvs, Ai^Eff, Aa^Eff, Aa^Fp, Aa^Fp, Ds, Ww, Ww, Ww
Ha, Ms, Ha, Aa, Aa, Ww^Ewl, Ww, Sm^Gvs, Ss, Sm^Gvs, Ai, Ai, Ai, Ai, Ai, Ai, Ai, Ss, Ww, Ai, Ai, Ha^Fp, Ms, Aa^Fp, Ha^Fp, Ms, Ai^Fp, Ha^Fp, Ai^Fp, Sm^Gvs, Ai^Eff, Ai^Eff, Aa, Ai, Ai, Aa^Fp, Aa, Ds, Ww, Ww
Ha, Ha, Ms, Ms, Ms, Aa^Fdw, Wwt^Ewl, Ww, Ww, Ss, Aa^Fp, Ai, Ai, Aa^Fp, Ds, Ds, Ai, Ss, Ai^Fp, Ww, Ww, Ai, Ai^Fp, Ms^Fp, Ai, Ai, Ai, Ai, Ai, Ai, Ai, Ai, Ai, Aa, Aa^Fp, Aa, Ww, Ww, Ds, Ww
Ms, Ms, Ms, Ms, Gd, Gs, Wwt, Wwt^Vhs, Wwt^Ewf, Ss, Aa^Fp, Ai, Aa, Aa, Ds, Ai, Ai^Fp, Ai, Ai, Ss, Ww, Ai, Ww, Ai, Ww, Ai, Ai, Ai, Ww, Aa^Fp, Ai, Aa, Ai, Ai^Fp, Ai, Aa, Ww, Ds, Aa^Fp, Ww
Aa^Fdw, Ms, Gd, Gd, Hhd, Gd, Gd, Wwt, Aa^Fdw, Aa, Aa^Fp, Ai, Ai, Aa^Fp, Ds, Ai, Ai, Ai, Ai, Ss, Ss, Ww, Ss, Ww, Ss, Ww, Ww, Ww, Ww, Ai, Ai^Ewl, Aa, Aa, Aa^Fp, Ai, Ai, Ww, Ai, Ai, Aa^Fp
Gs, Gs, Gd, Hhd, Mv, Hhd, Hhd, Gs, Aa^Fp, Aa^Fp, Ha^Fp, Ha^Fp, Ha^Fp, Aa, Ai, Aa, Aa^Fp, Ai, Ai, Ai^Fp, Ha^Fp, Ss, Ds, Ss, Ss, Ss, Ss, Ww, Ww, Ww^Ewf, Ww^Ewl, Ai, Ww, Ww, Ww, Ww, Ai, Ai, Ai^Vhs, Ai
Gs, Gd, Hhd, Md, Md, Md, Gd, Gs, Ha^Fp, Aa^Fp, Aa, Ha^Fp, Aa, Aa, Ds, Ai, Ai, Ai, Ha^Fp, Ha^Fp, Aa^Fp, Aa^Fdw, Aa, Ds, Ss^Fdw, Ss^Fdw, Wwrt, Wwt, Wwt, Ww, Ww, Ww, Ww, Ss, Ds^Fp, Ds, Ds, Ai, Ds, Ai
Aa^Fdw, Gs, Gs, Gd, Gd, Hhd, Gd, Ha, Ds^Fp, Aa^Fp, Aa, Aa^Efm, Ds, Ds, Aa^Efm, Ai^Vhs, Ai, Ai, Aa, Ha, Aa, Aa, Md, Gs, Gs, Gs, Md, Md, Md, Wwrt, Wwrt, Wwt, Wwt^Ewl, Ss, Ai, Aa^Fp, Ai, Ai, Ai, Ds
Ha, Aa^Fdw, Aa^Fdw, Gs, Gs, Gd, Gs, Gs, Ds, Ds, Ds, Ds, Aa, Ai, Ai, Ai, Aa, Aa, Aa^Fp, Aa, Aa^Fdw, Gs, Md, Md, Md, Md, Md, Md, Md, Md, Hhd, Hhd, Gs, Gs, Gs, Ai, Aa^Fdw, Ai, Aa^Fdw, Ai
Ha, Ha, Aa, Aa, Aa^Fdw, Gs, Ds, Ds, Ai, Ai, Ai^Fp, Ai^Fp, Ai, Ai, Ds, Ai, Ha^Fp, Ha^Fp, Aa^Fdw, Aa^Fdw, Ha, Md, Md, Md, Md, Mv, Md, Md, Md, Md, Qlf, Hhd, Hhd, Hhd, Hhd, Gs, Gs, Aa^Fdw, Aa^Fdw, Ai
Ha, Ha, Aa, Ce, Ce, Ce, Ds, Aa, Aa, Ai, Ai, Ai, Ds, Ai, Ds, Ds, Ha^Fp, Aa^Fp, Aa^Fp, Aa^Fdw, Aa^Fdw, Md, Md, Md, Md, Md, Ur, Qlf, Qlf, Qlf, Hhd, Qlf, Qlf, Qlf, Qlf, Hhd, Hhd, Gs, Aa, Aa
Aa, Aa, Aa, Ce, 1 Ke, Ce, Ce, Ai, Ai, Ai, Ai^Vhs, Ds^Fp, Ds^Fp, Ds^Fp, Ai, Ai, Aa^Fp, Ai, Ai, Aa^Fdw, Aa^Fdw, Gs, Md, Md, Md, Md, Md, Ur, Md, Md, Hhd, Hhd, Hhd, Hhd, Hhd, Rb, Hhd, Gs, Aa^Fdw, Aa^Fdw
Ha, Ha, Aa, Ce, Ce, Ce, Ai, Ai, Ai, Ai, Aa, Aa^Fp, Ha^Fp, Aa^Fp, Aa^Fp, Ai, Ai^Fp, Ai, Aa^Fp, Aa^Fp, Ms, Gs, Gs, Md, Md, Md, Md, Md, Md, Md, Gs, Hhd, Gs, Gs, Gd, Gd, Gd, Gs, Aa^Fdw, Aa^Fdw
Aa, Ha^Fp, Aa, Aa, Aa, Ai, Aa, Ai, Ai, Ai, Aa^Fp, Ha, Ha^Fp, Aa, Aa, Aa, Aa^Fp, Aa^Fp, Aa^Fp, Ms, Ms, Ha, Ha, Md, Hhd, Md, Md, Md, Aa, Aa, Aa^Fp, Gs, Aa, Gs, Aa, Gd, Aa, Aa^Fdw, Aa, Aa^Fp
Aa, Aa, Aa, Ha^Fp, Aa, Aa, Aa, Ai, Aa^Fp, Ai^Fp, Ha^Fp, Ha, Gs, Aa^Fp, Aa, Aa^Fp, Aa, Aa^Fp, Aa, Aa^Fp, Rd, Ha, Gs, Ha, Gs, Md, Aa, Aa, Aa, Aa^Fp, Aa, Aa, Aa, Aa, Aa, Aa, Aa, Aa, Aa, Ds^Fp
