Wo, Wo, Wo, Wo, Wo, Wo, Wo, Wo, Wo, Wo, Wo, Wo, Wo, Wo, Wo, Wo, Wo, Wo, Wo, Wo, Wo, Wo, Wo, Wo, Wo, Wo, Ww, Ww, Ww, Ww, Gg, Gg, Gg, Gs^Fds, Gs^Fds, Gs^Fds, Gs^Fds
Wo, Wo, Wo, Wo, Wo, Wo, Wo, Wo, Wo, Wo, Wo, Wo, Wo, Wo, Wo, Wo, Wo, Wo, Wo, Wo, Wo, Wo, Wo, Wo, Wo, Wo, Ww, Ww, Ww, Ww, Gg, Gg, Gg, Gs^Fds, Gs^Fds, Gs^Fds, Gs^Fds
Wo, Wo, Wo, Wo, Wo, Wo, Wo, Wo, Wo, Wo, Wo, Wo, Ww, Ww, Wo, Wo, Wo, Wo, Wo, Wo, Wo, Wo, Wo, Wo, Wo, Ww, Ww, Gs^Fds, Gs^Fds, Ww, Ss, Gg, Gg, Gg, Gs^Fds, Gs^Fds, Gs^Fds
Wo, Wo, Wo, Wo, Wo, Wo, Wo, Wo, Wo, Wo, Ww, Ww, Ww, Ww, Ww, Wo, Wo, Wo, Wo, Wo, Wo, Wo, Wo, Wo, Ww, Ww, Ww^Bw\, Ds, Gg, Gg, Gg, Gg, Re^Gvs, Re^Gvs, Re^Gvs, Gg, Gg
Wo, Wo, Wo, Wo, Wo, Wo, Wo, Wo, Ww, Ww, Gs^Fp, Gs^Fp, Ds, Ww, Ww, Wo, Wo, Wo, Wo, Wo, Wo, Wo, Wo, Ww, Ww, Ww, Ds, Ds, Gg^Vh, Gg, Gg, Re^Gvs, Gg, Re^Gvs, Gg, Gg, Gg
Wo, Wo, Wo, Wo, Wo, Wo, Wo, Wo, Wo, Ww, Ww, Gs^Fp, Gs^Vl, Ww^Bw/, Ww, Ww, Wo, Wo, Wo, Wo, Wo, Wo, Ww, Ww, Ww, Ww^Bw\, Ds, Gg, Gg, Gg, Gg, Gg, Ce, Gg, Gg, Gg, Gg
Wo, Wo, Wo, Wo, Wo, Wo, Wo, Ww, Wo, Wo, Ww, Gs, Gs, Ww, Ww, Wo, Wo, Wo, Wo, Wo, Wo, Wo, Ww, Ww^Bw\, Ds, Ds, Gg, Ch, Gg, Ww, Gg^Vh, Gg, Rr, Re, Re, Re, Re
Wo, Wo, Wo, Wo, Wo, Wo, Ww, Ww, Ww, Ww, Ww, Ww, Gs, Ww, Wo, Wo, Wo, Wo, Wo, Wo, Ww, Ww, Ww^Bw\, Ww, Ds, Gg, Ch, 2 Kh, Ch, Gg, Rr, Rr, Ce, Re, Gg, Gg, Gg
Wo, Wo, Wo, Wo, Wo, Wo, Ww, Gs^Fp, Ww, Wo, Wo, Ww, Ww, Ww, Wo, Wo, Wo, Wo, Wo, Wo, Ww, Ww, Ds, Ds, Gg, Gg, Gg, Gg, Rr, Rr, Gg, Gg, Gg, Gg, Gg, Gg, Gg
Wo, Wo, Wo, Wo, Wo, Wo, Ww, Gs, Ww, Wo, Wo, Ww, Ww, Ww, Ww, Wo, Wo, Wo, Ww, Ww, Ww, Gg, Gg, Gg, Gg, Gg^Vh, Rr, Gg, Rr, Gg^Vh, Gg, Gg, Re^Gvs, Re^Gvs, Re^Gvs, Gg, Gg
Wo, Wo, Wo, Wo, Wo, Wo, Ww, Ww, Ww, Wo, Wo, Wo, Wo, Ww, Wo, Wo, Wo, Ww, Ww, Ww, Ds, Gg, Gg, Ce, Rr, Rr, Gg, Rr, Gg, Gg, Gg, Re^Gvs, Re^Gvs, Re^Gvs, Gg, Gg, Gg
Ww, Ww, Wo, Wo, Wo, Wo, Wo, Ww, Wo, Wo, Wo, Wo, Wo, Ww, Wo, Wo, Wo, Ww, Ww, Ww, Ds, Gg, Gg, Re, Re, Ce, Gg, Gg, Gg, Gg, Re^Gvs, Gg, Gg, Gg, Gs^Fms, Gg, Gs^Fp
Ww, Ww, Ww, Ww, Wo, Wo, Wo, Ww, Ww, Wo, Wo, Wo, Wo, Ww, Ww, Wo, Ww, Ww, Ww, Ds, Gg, Gg, Gg, Re, Gg, Gg, Gg, Gg, Re^Gvs, Re^Gvs, Re^Gvs, Re^Gvs, Gg, Gs^Fms, Gs^Fms, Gs^Fms, Gs^Fms
Ds, Ds, Ww, Ww, Ww, Wo, Ww, Ww, Ww, Wo, Wo, Wo, Ww, Ww, Ww, Ww, Ww, Ww, Ds, Ds, Gg, Gg, Re, Re, Re^Gvs, Re^Gvs, Re^Gvs, Gg, Gg, Gs^Fds, Gs^Fds, Gg, Gg, Gs^Fms, Gs^Fms, Gs^Fp, Gs^Fp
Ds, Ds, Ds, Ds, Ww, Ww, Ww, Ww, Ww, Wo, Wo, Wo, Ww, Ww, Ww, Ww, Ww, Ww, Gs^Vl, Ds, Gg, Gg, Re, Gg, Gg, Re^Gvs, Re^Gvs, Re^Gvs, Gg, Gs^Fds, Gg, Gs^Fds, Gg, Gg, Gg, Gs^Fp, Gs^Fp
Gs, Gs^Vh, Gs, Gs, Ww, Ww, Ww, Ww, Ww, Wo, Wo, Ww, Gg, Ww, Ww, Gg, Gg, Gg, Gg, Gg, Gg, Re, Gg, Gg, Gg, Gg, Gg, Gg, Gg, Gg, Gg^Efm, Gg, Gg, Gg, Gs^Fp, Gs^Fp, Hh
Gs, Gs, Gs, Ss, Ss, Gs, Ds, Ww, Ww, Ww, Ww, Ww, Gs, Gs, Ss, Gs, Gs, Gg, Gg, Gg, Re, Re, Gg, Gg, Gg, Gg, Gg, Gg^Vh, Gg, Gg, Gg, Gg, Gg, Gs^Fp, Gs^Fp, Hh^Fp, Hh^Fp
Gs, Gs, Gs, Gs, Ss, Gs, Ds, Gs, Ww, Ww, Ds, Gs^Fds, Gs, Ss, Ss, Gs, Rb, Rb, Re, Re, Gg, Gg, Gg, Gg, Gg, Gg, Gg^Efm, Gg, Gg^Efm, Gg, Gg, Gg, Gg, Gs^Fp, Hh^Fp, Hh^Fp, Hh^Fp
Gs, Gs, Ch, Chr, Ch, Gs^Vh, Gs, Ds, Ds, Ds, Ds, Ds, Gg, Gs, Gs, Gs, Rb, Ss, Ss, Gs, Gs, Gg, Gg, Gg, Gg, Gg^Efm, Gg, Gg, Gg, Gg, Gg, Gg, Hh, Gg, Hh^Vhh, Hh, Hh
Gs, Gs, Chr, 3 Kh, Ch, Gs, Gs, Gs, Ds, Hh, Gg, Gg, Gg, Gg, Gg, Gg, Rb, Ss, Gs, Gs, Ss, Gs, Gs, Gg, Gg, Gs^Fms, Gs^Fms, Gg, Gs^Fms, Gg, Hh, Hh, Hh, Hh, Hh, Hh, Hh
Gs, Gs, Gs, Ch, Gs, Gs, Gs, Gs, Gg, Hh, Hh^Fms, Gs^Fms, Gg, Gg, Re, Re, Gg, Gs, Gg, Gs, Gs, Gs, Gg, Gg, Gg, Gs^Fms, Gs^Fms, Gs^Fms, Gs^Fms, Gg, Gg, Hh, Hh, Hh, Mm, Mm, Mm
Gs, Gs, Gs, Gs, Gs, Gs, Gs, Gg, Gg^Vh, Hh, Gs^Fms, Gg, Gg, Gg, Re, Gg, Gg, Gg, Gg, Hh, Gg, Gs, Gg, Gg, Gg^Vh, Gs^Fms, Gg, Gg, Gg^Efm, Gg, Gg, Hh, Hh, Hh, Hh, Mm, Mm
Ss, Ss, Gs, Gs, Gs^Fp, Gs, Gg, Gg, Gs^Fms, Gs^Fms, Gs^Fms, Gs^Fms, Gg, Gg, Re, Gg, Gg, Gg, Hh, Hh^Fms, Hh^Fms, Gs^Fms, Gg, Gg, Gg, Gs^Fms, Gg, Gg, Gg, Gg^Efm, Gg, Gg, Gg, Hh, Hh, Hh, Hh
Gs, Gs, Gg, Gg, Gs^Fp, Gs^Fp, Gg, Gg, Gg, Gs^Fms, Gs^Fms, Hh, Gs^Fms, Gs^Fms, Re, Gs^Fms, Gs^Fms, Gs^Fms, Hh, Hh, Gs^Fds, Gs^Fds, Gg, Gg, Gg, Gg, Gg, Gg, Ce, Gg, Gg, Gg, Gg, Hh, Hh, Mm, Mm
Gg, Gg, Gg, Gg, Gg, Gs^Fp, Gg, Gg, Gg, Gg, Hh^Fms, Hh, Hh, Gs^Fms, Re, Gs^Fms, Gs^Fds, Gs^Fds, Gs^Fds, Gs^Fms, Gg, Gs^Fms, Gg, Gg, Gg, Gg^Efm, Gg, Ce, 1 Ke, Ce, Hh, Hh, Gg, Hh, Hh, Mm, Mm
Gll^Fp, Gll^Fp, Gll^Fp, Gg, Gg, Gg, Gg, Gg, Gg, Gg, Gg, Hh, Hh, Gs^Fds, Gs^Fds, Re, Gg, Gs^Fds, Gg, Gs^Fms, Gg, Gg, Gg, Gg^Efm, Gg, Gg, Gg, Ce, Ce, Ce, Hh, Hh, Hh, Hh, Hh, Hh, Hh
Gll^Fp, Gll^Fp, Gll^Fp, Gg, Gg, Gg, Gll^Fds, Gg, Gg, Gg, Gg, Gg, Gg, Gg, Gs^Fds, Re, Re, Gg, Gg, Gg, Gg, Gg^Efm, Gg^Efm, Gg^Efm, Gg, Gg, Gg, Gg, Gg, Gg, Hh, Hh, Mm, Mm, Mm, Hh, Hh
Gll^Fp, Gll^Fms, Gll^Fms, Gg, Gll^Fds, Gg, Gll^Fds, Gg, Gg, Gg, Gg, Gg, Gg, Gg, Gs^Fds, Gg^Vh, Re, Gg, Gs^Fms, Gg, Gs^Fds, Gg, Gg, Gg, Gs^Fds, Gs^Fds, Gg, Gg, Gg^Efm, Gg, Gg, Hh, Hh, Mm, Mm, Hh, Hh
Gll^Fp, Gll^Fp, Gll^Fms, Gg^Vh, Gll^Fms, Gll^Fds, Gll^Fds, Gll^Fds, Gll^Fds, Gll^Fds, Gg, Gg, Gg, Gg, Gg, Gg, Re, Gg, Hh, Gs^Fp, Gs^Fms, Gg, Gg, Gg, Gs^Fms, Gs^Fds, Gs^Fds, Gg, Gg, Gg, Gg, Gg, Hh, Hh, Mm, Mm, Mm
Gll^Fp, Gll^Fms, Gll^Fp, Gll^Fms, Gll^Fds, Gll^Fds, Gll^Fds, Gll^Fds, Gll^Fds, Gg, Gg, Gs^Vl, Gg, Gg, Re, Re, Gg, Gg, Hh^Fp, Gs^Fp, Gg, Gg, Gg, Gg, Gg, Gs^Fms, Gs^Fds, Gg, Gg, Gg, Gs^Vl, Gg, Gg, Hh, Mm, Mm, Mm
Gll^Fms, Gll^Fp, Gll^Fp, Gll^Fms, Gll^Fds, Gll^Fds, Gll^Fds, Gll^Fds, Gll^Fms, Gll^Fds, Gll^Fds, Gll^Fds, Re, Re, Gg, Gg, Hh, Gg, Hh, Hh, Gg, Gs^Vl, Gg, Gg, Gs^Fms, Gs^Fds, Gs^Fms, Gs^Fds, Gg, Gg, Gg, Gg, Gg, Gg, Hh, Hh, Hh
Gll^Fms, Gll^Fms, Gll^Fp, Gll^Fms, Gll^Fms, Gll^Fds, Gll^Fms, Gll^Fms, Gll^Fms, Gll^Fds, Gs^Fms, Gll^Fds, Re, Re, Gg, Gg, Hh^Fp, Hh^Fp, Hh^Fp, Hh, Gg, Gg, Gg, Gg, Gs^Fds, Gs^Fds, Gs^Fms, Gs^Fds, Gg, Gg, Gg, Gg, Gg, Gg, Hh, Hh, Hh
