border_size=1
usage=map

Wo          , Wo          , Wo          , Wo          , Wo          , Wo          , Wo          , Wo          , Wo          , Wo          , Wo          , Wo          , Wo          , Wo          , Wo          , Wo          , Wo          , Wo          , Wo          , Wo          , Wo          , Wt          , Dd          , Gg          , Gg          , Gg          , Gg          , Gs^Fms      , Gs^Fms      , Gs^Fp       , Gs^Fp       , Gs^Fp       , Gs^Fp       , Gs^Fp       
Wo          , Wo          , Wo          , Wo          , Wo          , Wo          , Wo          , Wo          , Wo          , Wo          , Wo          , Wo          , Wo          , Wo          , Wo          , Wo          , Wo          , Wo          , Wo          , Wo          , Wo          , Wt          , Dd          , Gg          , Gg          , Gg          , Gg          , Gs^Fds      , Gs^Fms      , Gs^Fms      , Gs^Fms      , Gs^Fp       , Gs^Fms      , Gs^Fp       
Wo          , Wo          , Wo          , Wo          , Wo          , Wo          , Wo          , Wo          , Wo          , Wo          , Wo          , Wo          , Wo          , Wo          , Wo          , Wo          , Wo          , Wo          , Wo          , Wo          , Wo          , Wt          , Dd          , Gg          , Gg          , Gg          , Gg          , Gs^Fds      , Gg          , Gs^Fds      , Gs^Fms      , Gs^Fms      , Gs^Fms      , Gs^Fp       
Wo          , Wo          , Wo          , Wo          , Wo          , Wo          , Wo          , Wo          , Wo          , Wo          , Wo          , Wo          , Wo          , Wo          , Wo          , Wo          , Wo          , Wo          , Wo          , Wo          , Wo          , Wt          , Dd          , Gg          , Gg          , Gg^Vh       , Gg          , Gg          , Gg          , Gs^Fms      , Gs^Fms      , Gs^Fds      , Gs^Fms      , Gs^Fms      
Wo          , Wo          , Wo          , Wo          , Wo          , Wo          , Wo          , Wo          , Wo          , Wo          , Wo          , Wo          , Wo          , Wo          , Wo          , Wo          , Wo          , Wo          , Wo          , Wo          , Wo          , Wt          , Dd          , Gg          , Gg          , Gg          , Gg          , Gs          , Gs          , Gs          , Gs^Fds      , Gs^Fms      , Gs^Fds      , Gs^Fms      
Wo          , Wo          , Wo          , Wo          , Wo          , Wo          , Wo          , Wo          , Wo          , Wo          , Wo          , Wo          , Wo          , Wo          , Wo          , Wo          , Wo          , Wo          , Wo          , Wo          , Wo          , Wt          , Wt          , Dd          , Gg          , Gg          , Gg          , Gs          , Gs          , Gs          , Gs^Fds      , Gs^Fms      , Gs^Fds      , Gs^Fds      
Wo          , Wo          , Wo          , Wo          , Wo          , Wo          , Wo          , Wo          , Wo          , Wo          , Wo          , Wo          , Wo          , Wo          , Wo          , Wo          , Wo          , Wo          , Wo          , Wo          , Wo          , Wt          , Wt          , Dd          , Dd          , Gg          , Gs          , Gs          , Gs          , Gg          , Gg^Vh       , Gs^Fds      , Gs^Fds      , Gs^Fms      
Wo          , Wo          , Wo          , Wo          , Wo          , Wo          , Wo          , Wo          , Wo          , Wo          , Wo          , Wo          , Wo          , Wo          , Wo          , Wo          , Wo          , Wo          , Wo          , Wo          , Wo          , Wo          , Wt          , Dd          , Dd          , Gg          , Gs          , Gs          , Gs          , Gg          , Gg          , Gs^Fds      , Gs^Fds      , Gs^Fds      
Wo          , Wo          , Wo          , Wo          , Wo          , Wo          , Wo          , Wo          , Wo          , Wo          , Wo          , Wo          , Wo          , Wo          , Wo          , Wo          , Wo          , Wo          , Wo          , Wo          , Wo          , Wo          , Wo          , Wt          , Dd          , Gs          , Gg          , Gs          , Gs          , Gs          , Gs          , Gs^Fds      , Gs^Fds      , Gs^Fds      
Wo          , Wo          , Wo          , Wo          , Wo          , Wo          , Wo          , Wo          , Wo          , Wo          , Wo          , Wo          , Wo          , Wo          , Wo          , Wo          , Wo          , Wo          , Wo          , Wo          , Wo          , Wo          , Wo          , Wt          , Wt          , Dd          , Gg          , Gg          , Gs          , Gs          , Gs          , Gs^Fds      , Gs^Fds      , Gs^Fds      
Wo          , Wo          , Wo          , Wo          , Wo          , Wo          , Wo          , Wo          , Wo          , Wo          , Wo          , Wo          , Wo          , Wo          , Wo          , Wo          , Wo          , Wo          , Wo          , Wo          , Wo          , Wo          , Wo          , Wt          , Wt          , Dd          , Dd          , Gg          , Gg          , Gs          , Gs          , Gs          , Gs          , Gs          
Wo          , Wo          , Wo          , Wo          , Wo          , Wo          , Wo          , Wo          , Wo          , Wo          , Wo          , Wo          , Wo          , Wo          , Wo          , Wo          , Wo          , Wo          , Wo          , Wo          , Wo          , Wo          , Wo          , Wo          , Wt          , Dd          , Dd          , Gg          , Gg          , Gg          , Gs          , Gs          , Gs          , Gs          
Wo          , Wo          , Wo          , Wo          , Wo          , Wo          , Wo          , Wo          , Wo          , Wo          , Wo          , Wo          , Wo          , Wo          , Ww          , Wo          , Ww          , Wo          , Wo          , Wo          , Wo          , Wo          , Wo          , Wo          , Wo          , Wt          , Dd          , Gg          , Gg^Vh       , Gs          , Rb          , Gs          , Rb          , Gs          
Wo          , Wo          , Wo          , Wo          , Wo          , Wo          , Wo          , Wo          , Wo          , Wo          , Wo          , Wo          , Ww          , Ww          , Ww^Bw\      , Ww          , Gg^Vh       , Wo          , Wo          , Wo          , Wo          , Wo          , Wo          , Wo          , Wo          , Wt          , Dd          , Gg          , Gs          , Gs          , Co          , Rb          , Rb          , Rb          
Wo          , Wo          , Wo          , Wo          , Wo          , Wo          , Wo          , Wo          , Wo          , Wo          , Wo          , Wo          , Ww          , Ww          , Gg^Vh       , Gg          , Gs          , Ww          , Ww          , Wo          , Wo          , Wo          , Wo          , Wo          , Wo          , Wt          , Wt          , Dd          , Gs          , Co          , 3 Ko        , Co          , Rb          , Rb          
Wo          , Wo          , Wo          , Wo          , Wo          , Wo          , Wo          , Wo          , Wo          , Wo          , Wo          , Wo          , Ww          , Ww^Bw\      , Gg          , Gs          , Co          , Ww          , Dd          , Wo          , Wo          , Wo          , Wo          , Wo          , Wo          , Wt          , Wt          , Dd          , Dd          , Co          , Co          , Co          , Rb          , Gs          
Wo          , Wo          , Wo          , Wo          , Wo          , Wo          , Wo          , Wo          , Wo          , Wo          , Wo          , Wo          , Ww          , Gg          , Gs          , Gs          , Co          , Dd          , Gs          , Ww          , Ww          , Wo          , Wo          , Wo          , Wo          , Wo          , Wt          , Dd          , Dd          , Co          , Gs          , Gs          , Gs          , Gs          
Wo          , Wo          , Wo          , Wo          , Wo          , Wo          , Wo          , Wo          , Wo          , Wo          , Wo          , Ww          , Ww          , Gg^Vh       , Ww          , Co          , 2 Ko        , Co          , Gs          , Dd          , Ww          , Wo          , Wo          , Wo          , Wo          , Wo          , Wo          , Wt          , Wwf         , Gs          , Gg^Vh       , Gg          , Gs          , Gs          
Wo          , Wo          , Wo          , Wo          , Wo          , Wo          , Wo          , Wo          , Wo          , Wo          , Wo          , Ww          , Ww          , Ww          , Gs          , Co          , Co          , Co          , Dd          , Dd          , Wo          , Wo          , Wo          , Wo          , Wo          , Wo          , Wo          , Wt          , Wt          , Wwf         , Ww          , Gg          , Gg          , Gg          
Wo          , Wo          , Wo          , Wo          , Wo          , Wo          , Wo          , Wo          , Wo          , Wo          , Wo          , Wo          , Wo          , Ww          , Ww^Bw/      , Gs          , Dd          , Gs          , Wwr         , Wwr         , Ww          , Wo          , Wo          , Wo          , Wo          , Wo          , Wo          , Wt          , Wwf         , Ww          , Ww          , Ww          , Ww          , Ww          
Wo          , Wo          , Wo          , Wo          , Wo          , Wo          , Wo          , Wo          , Wo          , Wo          , Wo          , Wo          , Wo          , Ww          , Ww          , Dd          , Ww          , Dd          , Wwr         , Wwr         , Wwr         , Wo          , Wo          , Wo          , Wo          , Wo          , Wt          , Wt          , Ds          , Gg          , Gg          , Ww          , Ww          , Ww          
Wo          , Wo          , Wo          , Wo          , Wo          , Wo          , Wo          , Wo          , Wo          , Wo          , Wo          , Wo          , Wo          , Ww          , Ww          , Ww          , Ww          , Ww          , Ww          , Ww          , Wwr         , Wo          , Wo          , Wo          , Wo          , Wo          , Wt          , Wwf         , Gg          , Gg          , Gg          , Gg          , Gg          , Gg          
Wo          , Wo          , Wo          , Wo          , Wo          , Wo          , Wo          , Wo          , Wo          , Wo          , Wo          , Wo          , Wo          , Wo          , Wt          , Ww          , Wt          , Wwr         , Wt          , Wt          , Wt          , Wwr         , Ww          , Wo          , Wo          , Wo          , Wt          , Ds          , Gg          , Gg^Vh       , Gs          , Gs          , Gg          , Gg          
Wo          , Wo          , Wo          , Wo          , Wo          , Wo          , Wo          , Wo          , Wo          , Wo          , Wo          , Wo          , Wo          , Wo          , Wo          , Wt          , Wt          , Wt          , Wt          , Ww^Vm       , Wt          , Wwr         , Wwr         , Wo          , Wo          , Wo          , Wt          , Ds          , Gs          , Gs          , Gs          , Gs          , Gs          , Gs          
Wo          , Wo          , Wo          , Wo          , Wo          , Wo          , Wo          , Wo          , Wo          , Wo          , Wo          , Wo          , Wo          , Wo          , Wo          , Wt          , Wt          , Wwr         , Wt          , Wt          , Wt          , Wwr         , Wt          , Wt          , Wo          , Wt          , Ds          , Ds          , Gs          , Gs          , Gs          , Gs          , Gs          , Gs          
Wo          , Wo          , Wo          , Wo          , Wo          , Wo          , Wo          , Wo          , Wo          , Wo          , Wo          , Wo          , Wo          , Wo          , Wo          , Wo          , Wt          , Wt          , Wt          , Wwr         , Wwr         , Wt          , Ww^Vm       , Wt          , Wt          , Wt          , Ds          , Ds          , Gs          , Gs          , Gs          , Gs          , Gs          , Gs          
Wo          , Wo          , Wo          , Wo          , Wo          , Wo          , Wo          , Wo          , Wo          , Wo          , Wo          , Wo          , Wo          , Wo          , Wo          , Wo          , Wt          , Wt          , Wt          , Wwr         , Wwr         , Ds          , Wt          , Wt          , Wt          , Wt          , Ds          , Gg          , Gs          , Gg          , Gs          , Gs          , Gs          , Gs          
Wo          , Wo          , Wo          , Wo          , Wo          , Wo          , Wo          , Wo          , Wo          , Wo          , Wo          , Wo          , Wo          , Wo          , Wo          , Wo          , Wt          , Wt          , Wt          , Wt          , Wt          , Wwr         , Wt          , Wt          , Wt          , Ds          , Gg          , Gg^Vh       , Gg          , Gs          , Gs          , Gs          , Gs          , Gs          
Wo          , Wo          , Wo          , Wo          , Wo          , Wo          , Wo          , Wo          , Wo          , Wo          , Wo          , Wo          , Wo          , Wo          , Wo          , Wo          , Wo          , Wt          , Ww^Vm       , Wt          , Wt          , Wwr         , Wwr         , Wt          , Ds          , Ds          , Gs          , Gs          , Gs          , Gs          , Gg          , Gs          , Gg          , Gs          
Wo          , Wo          , Wo          , Wo          , Wo          , Wo          , Wo          , Wo          , Wo          , Wo          , Wo          , Wo          , Wo          , Wo          , Wo          , Wo          , Wt          , Wt          , Wt          , Wt          , Wwr         , Wwr         , Wt          , Wt          , Ds          , Ds          , Gs          , Gs          , Gs          , Gg          , Gs          , Gs          , Gs          , Gs          
Wo          , Wo          , Wo          , Wo          , Wo          , Wo          , Wo          , Wo          , Wo          , Wo          , Wo          , Wo          , Wo          , Wo          , Wo          , Wo          , Wo          , Wt          , Wt          , Wt          , Wt          , Wwr         , Ds          , Ds          , Gs          , Gs          , Gg          , Gs          , Gg          , Gg          , Gg^Vh       , Gs          , Gg          , Gg          
Wo          , Wo          , Wo          , Wo          , Wo          , Wo          , Wo          , Wo          , Wo          , Wo          , Wo          , Wo          , Wo          , Wo          , Wo          , Wo          , Wo          , Wt          , Wt          , Wt          , Ds          , Ds          , Gs          , Ds          , Gs          , Gg^Vh       , Gg          , Gs          , Gs          , Gs          , Gg          , Gg          , Gg          , Gg          
Wo          , Wo          , Wo          , Wo          , Wo          , Wo          , Wo          , Wo          , Wo          , Wo          , Wt          , Wo          , Wt          , Wo          , Wt          , Wo          , Wt          , Wt          , Ds          , Ds          , Gg          , Ds          , Gg          , Gs          , Gg          , Gg          , Gs          , Gg          , Gs          , Gs          , Gs          , Gs          , Gg          , Gg          
Wt          , Wt          , Wt          , Wo          , Wo          , Wo          , Wt          , Wo          , Wt          , Wo          , Wt          , Ww^Vm       , Wt          , Wo          , Wt          , Wt          , Ds          , Ds          , Gg          , Ds          , Gg          , Gg          , Gg          , Gg          , Rd          , Gs          , Gg          , Gs          , Gg          , Gs          , Gs          , Gs          , Gg          , Gg          
Wt          , Wt          , Wt          , Wo          , Wo          , Wo          , Wt          , Wt          , Wt          , Wo          , Wt          , Wt          , Ds          , Wt          , Ds          , Ds          , Gg          , Ds          , Gg          , Gg          , Gg^Vh       , Gg          , Rd          , Gg          , Gg          , Gs          , Gg          , Gg          , Gg          , Gs          , Gs          , Hh          , Hh          , Hh          
Ds          , Ds          , Ds          , Wt          , Wt          , Wo          , Wt          , Ww^Vm       , Wt          , Wt          , Ds          , Wt          , Ds          , Ds          , Gg          , Ds          , Gg          , Gg          , Gg          , Gg          , Gg          , Rd          , Gg          , Gg          , Gg          , Gg          , Gg          , Gs          , Gg          , Gs          , Hh          , Hh          , Hh          , Hh          
Gg          , Gg          , Ce          , Ds          , Wt          , Wt          , Wt          , Wt          , Ds          , Ds          , Gg          , Ds          , Gg          , Gg          , Gg          , Gg          , Rd          , Rd          , Rd          , Rd          , Gg          , Gg          , Gg          , Gg          , Gg          , Gg          , Gg          , Gg          , Gs          , Gs          , Hh          , Hh          , Hh          , Hh          
Gg          , Gg          , 1 Ke        , Ds          , Wt          , Wt          , Wt          , Ds          , Gg          , Ds          , Gg^Vh       , Gg          , Gg          , Gg          , Rd          , Rd          , Gg^Vh       , Gg          , Gg          , Gg          , Gg          , Gg          , Gg          , Gg          , Gg          , Gg          , Gg          , Gg          , Gs          , Gs          , Hh          , Hh          , Hh^Fms      , Hh^Fms      
Gg          , Gg          , Ce          , Ds          , Wt          , Gs^Vht      , Wt          , Ds          , Gg          , Gg          , Rr          , Gg          , Rr          , Rd          , Gg          , Gg          , Gg          , Gg          , Gg          , Gg          , Gg          , Gg          , Gg          , Gg          , Gg          , Gg^Vh       , Gg          , Gg          , Hh          , Hh          , Hh          , Hh          , Hh          , Hh^Fms      
Gg          , Gg          , Ce          , Ds          , Wt          , Wt          , Wt          , Ds          , Rr          , Rr          , Gg          , Rd          , Gg          , Gg          , Gg          , Gg          , Gg          , Gg          , Gg          , Gg          , Gg^Vh       , Gg          , Gg          , Gg          , Hh          , Gg          , Hh          , Hh          , Hh          , Hh^Fds      , Hh^Fds      , Hh^Fms      , Hh^Fms      , Hh^Fms      
Gg          , Gg          , Gg          , Ds          , Wwf         , Wwf         , Wwf         , Ds          , Gg          , Gg          , Gg          , Gg          , Gg          , Gg          , Gg          , Gg          , Gg          , Gg          , Gg          , Gg          , Gs          , Gs          , Gs          , Gs          , Hh^Fds      , Hh          , Hh          , Hh          , Hh^Fms      , Hh          , Hh^Fds      , Hh^Fds      , Hh^Fds      , Hh^Fds      
Gg          , Gg          , Gg          , Ds          , Wwf         , Wwf         , Wwf         , Ds          , Gg          , Gg          , Gg          , Gg          , Gg          , Gg          , Gg          , Gg          , Gg          , Gg          , Gg          , Gg          , Gs          , Gs          , Gs          , Hh^Fds      , Hh^Fms      , Hh^Fms      , Hh          , Hh          , Hh^Fms      , Hh^Fms      , Hh^Fms      , Hh^Fds      , Hh^Fds      , Hh^Fds      
