border_size=1
usage=map

Wo          , Wo          , Wo          , Wo          , Wo          , Wo          , Wo          , Wo          , Wo          , Wo          , Wo          , Wo          , Wo          , Wo          , Wo          , Wo          , Wo          , Wo          , Wo          , Wo          , Wo          , Wwt         , Dd          , Gg          , Gg          , Gg          , Gg          , Gll^Fms     , Gll^Fms     , Gll^Fp      , Gll^Fp      , Gll^Fp      , Gll^Fp      , Gll^Fp      
Wo          , Wo          , Wo          , Wo          , Wo          , Wo          , Wo          , Wo          , Wo          , Wo          , Wo          , Wo          , Wo          , Wo          , Wo          , Wo          , Wo          , Wo          , Wo          , Wo          , Wo          , Wwt         , Dd          , Gg          , Gg          , Gg          , Gg          , Gll^Fds     , Gll^Fms     , Gll^Fms     , Gll^Fms     , Gll^Fp      , Gll^Fms     , Gll^Fp      
Wo          , Wo          , Wo          , Wo          , Wo          , Wo          , Wo          , Wo          , Wo          , Wo          , Wo          , Wo          , Wo          , Wo          , Wo          , Wo          , Wo          , Wo          , Wo          , Wo          , Wo          , Wwt         , Dd          , Gg          , Gg          , Gg          , Gg          , Gll^Fds     , Gg          , Gs^Fds      , Gll^Fms     , Gll^Fms     , Gll^Fms     , Gll^Fp      
Wo          , Wo          , Wo          , Wo          , Wo          , Wo          , Wo          , Wo          , Wo          , Wo          , Wo          , Wo          , Wo          , Wo          , Wo          , Wo          , Wo          , Wo          , Wo          , Wo          , Wo          , Wwt         , Dd          , Gg          , Gg          , Gg^Vh       , Gg          , Gg          , Gg          , Gll^Fms     , Gll^Fms     , Gs^Fds      , Gll^Fms     , Gll^Fms     
Wo          , Wo          , Wo          , Wo          , Wo          , Wo          , Wo          , Wo          , Wo          , Wo          , Wo          , Wo          , Wo          , Wo          , Wo          , Wo          , Wo          , Wo          , Wo          , Wo          , Wo          , Wwt         , Dd          , Gg          , Gg          , Gg          , Gg          , Gs          , Gs          , Gs          , Gll^Fds     , Gll^Fms     , Gll^Fds     , Gll^Fms     
Wo          , Wo          , Wo          , Wo          , Wo          , Wo          , Wo          , Wo          , Wo          , Wo          , Wo          , Wo          , Wo          , Wo          , Wo          , Wo          , Wo          , Wo          , Wo          , Wo          , Wo          , Wwt         , Wwt         , Dd          , Gg          , Gg          , Gg          , Gs          , Gs          , Gs          , Gll^Fds     , Gll^Fms     , Gll^Fds     , Gll^Fds     
Wo          , Wo          , Wo          , Wo          , Wo          , Wo          , Wo          , Wo          , Wo          , Wo          , Wo          , Wo          , Wo          , Wo          , Wo          , Wo          , Wo          , Wo          , Wo          , Wo          , Wo          , Wwt         , Wwt         , Dd          , Dd          , Gg          , Gs          , Gs          , Gs          , Gs          , Gs^Vh       , Gll^Fds     , Gll^Fds     , Gs^Fms      
Wo          , Wo          , Wo          , Wo          , Wo          , Wo          , Wo          , Wo          , Wo          , Wo          , Wo          , Wo          , Wo          , Wo          , Wo          , Wo          , Wo          , Wo          , Wo          , Wo          , Wo          , Wo          , Wwt         , Dd          , Dd          , Gg          , Gs          , Gs          , Gs          , Gs          , Gs          , Gll^Fds     , Gll^Fds     , Gll^Fds     
Wo          , Wo          , Wo          , Wo          , Wo          , Wo          , Wo          , Wo          , Wo          , Wo          , Wo          , Wo          , Wo          , Wo          , Wo          , Wo          , Wo          , Wo          , Wo          , Wo          , Wo          , Wo          , Wo          , Wwt         , Dd          , Gs          , Gg          , Gs          , Gs          , Gs          , Gs          , Gll^Fds     , Gll^Fds     , Gll^Fds     
Wo          , Wo          , Wo          , Wo          , Wo          , Wo          , Wo          , Wo          , Wo          , Wo          , Wo          , Wo          , Wo          , Wo          , Wo          , Wo          , Wo          , Wo          , Wo          , Wo          , Wo          , Wo          , Wo          , Wwt         , Wwt         , Dd          , Gg          , Gg          , Gs          , Gs          , Gs          , Gll^Fds     , Gll^Fds     , Gll^Fds     
Wo          , Wo          , Wo          , Wo          , Wo          , Wo          , Wo          , Wo          , Wo          , Wo          , Wo          , Wo          , Wo          , Wo          , Wo          , Wo          , Wo          , Wo          , Wo          , Wo          , Wo          , Wo          , Wo          , Wwt         , Wwt         , Dd          , Dd          , Gg          , Gg          , Gs          , Gs          , Gs          , Gs          , Gs          
Wo          , Wo          , Wo          , Wo          , Wo          , Wo          , Wo          , Wo          , Wo          , Wo          , Wo          , Wo          , Wo          , Wo          , Wo          , Wo          , Wo          , Wo          , Wo          , Wo          , Wo          , Wo          , Wo          , Wo          , Wwt         , Dd          , Dd          , Gg          , Gg          , Gg          , Gs          , Gs          , Gs          , Gs          
Wo          , Wo          , Wo          , Wo          , Wo          , Wo          , Wo          , Wo          , Wo          , Wo          , Wo          , Wo          , Wo          , Wo          , Ww          , Wo          , Ww          , Wo          , Wo          , Wo          , Wo          , Wo          , Wo          , Wo          , Wo          , Wwt         , Dd          , Gg          , Gs^Vh       , Gs          , Rb          , Gs          , Rb          , Gs          
Wo          , Wo          , Wo          , Wo          , Wo          , Wo          , Wo          , Wo          , Wo          , Wo          , Wo          , Wo          , Ww          , Ww          , Ww^Bw\      , Ww          , Gs^Vh       , Wo          , Wo          , Wo          , Wo          , Wo          , Wo          , Wo          , Wo          , Wwt         , Dd          , Gg          , Gs          , Gs          , Co          , Rb          , Rb          , Rb          
Wo          , Wo          , Wo          , Wo          , Wo          , Wo          , Wo          , Wo          , Wo          , Wo          , Wo          , Wo          , Ww          , Ww          , Gs^Vh       , Rb          , Gs          , Ww          , Ww          , Wo          , Wo          , Wo          , Wo          , Wo          , Wo          , Wwt         , Wwt         , Dd          , Gs          , Co          , 3 Ko        , Co          , Rb          , Rb          
Wo          , Wo          , Wo          , Wo          , Wo          , Wo          , Wo          , Wo          , Wo          , Wo          , Wo          , Wo          , Ww          , Ww^Bw\      , Gs          , Rb          , Co          , Ww          , Dd          , Wo          , Wo          , Wo          , Wo          , Wo          , Wo          , Wwt         , Wwt         , Dd          , Dd          , Co          , Co          , Co          , Rb          , Gs          
Wo          , Wo          , Wo          , Wo          , Wo          , Wo          , Wo          , Wo          , Wo          , Wo          , Wo          , Wo          , Ww          , Gs          , Rb          , Gs          , Co          , Dd          , Gs          , Ww          , Ww          , Wo          , Wo          , Wo          , Wo          , Wo          , Wwt         , Dd          , Dd          , Co          , Gs          , Gs          , Gs          , Gs          
Wo          , Wo          , Wo          , Wo          , Wo          , Wo          , Wo          , Wo          , Wo          , Wo          , Wo          , Ww          , Ww          , Gs^Vh       , Ww          , Co          , 2 Ko        , Co          , Gs          , Dd          , Ww          , Wo          , Wo          , Wo          , Wo          , Wo          , Wo          , Wwt         , Wwf         , Gs          , Gs^Vh       , Gs          , Gs          , Gs          
Wo          , Wo          , Wo          , Wo          , Wo          , Wo          , Wo          , Wo          , Wo          , Wo          , Wo          , Ww          , Ww          , Ww          , Gs          , Co          , Co          , Co          , Dd          , Dd          , Wo          , Wo          , Wo          , Wo          , Wo          , Wo          , Wo          , Wwt         , Wwt         , Wwf         , Ww          , Gs          , Gs          , Gs          
Wo          , Wo          , Wo          , Wo          , Wo          , Wo          , Wo          , Wo          , Wo          , Wo          , Wo          , Wo          , Wo          , Ww          , Ww^Bw/      , Rb          , Dd          , Gs          , Wwr         , Wwr         , Ww          , Wo          , Wo          , Wo          , Wo          , Wo          , Wo          , Wwt         , Wwf         , Ww          , Ww          , Ww          , Ww          , Ww          
Wo          , Wo          , Wo          , Wo          , Wo          , Wo          , Wo          , Wo          , Wo          , Wo          , Wo          , Wo          , Wo          , Ww          , Ww          , Dd          , Ww          , Dd          , Wwr         , Wwr         , Wwr         , Wo          , Wo          , Wo          , Wo          , Wo          , Wwt         , Wwt         , Ds          , Gg          , Gg          , Ww          , Ww          , Ww          
Wo          , Wo          , Wo          , Wo          , Wo          , Wo          , Wo          , Wo          , Wo          , Wo          , Wo          , Wo          , Wo          , Ww          , Ww          , Ww          , Ww          , Ww          , Ww          , Ww          , Wwr         , Wo          , Wo          , Wo          , Wo          , Wo          , Wwt         , Wwf         , Gg          , Gg          , Gg          , Gg          , Gg          , Gg          
Wo          , Wo          , Wo          , Wo          , Wo          , Wo          , Wo          , Wo          , Wo          , Wo          , Wo          , Wo          , Wo          , Wo          , Wwt         , Ww          , Wwt         , Wwr         , Wwt         , Wwt         , Wwt         , Wwr         , Ww          , Wo          , Wo          , Wo          , Wwt         , Ds          , Gg          , Gg^Vh       , Gs          , Gs          , Gg          , Gg          
Wo          , Wo          , Wo          , Wo          , Wo          , Wo          , Wo          , Wo          , Wo          , Wo          , Wo          , Wo          , Wo          , Wo          , Wo          , Wwt         , Wwt         , Wwt         , Wwt         , Ww^Vm       , Wwt         , Wwr         , Wwr         , Wo          , Wo          , Wo          , Wwt         , Ds          , Gs          , Gs          , Gs          , Gs          , Gs          , Gs          
Wo          , Wo          , Wo          , Wo          , Wo          , Wo          , Wo          , Wo          , Wo          , Wo          , Wo          , Wo          , Wo          , Wo          , Wo          , Wwt         , Wwt         , Wwr         , Wwt         , Wwt         , Wwt         , Wwr         , Wwt         , Wwt         , Wo          , Wwt         , Ds          , Ds          , Gs          , Gs          , Gs          , Gs          , Gs          , Gs          
Wo          , Wo          , Wo          , Wo          , Wo          , Wo          , Wo          , Wo          , Wo          , Wo          , Wo          , Wo          , Wo          , Wo          , Wo          , Wo          , Wwt         , Wwt         , Wwt         , Wwr         , Wwr         , Wwt         , Ww^Vm       , Wwt         , Wwt         , Wwt         , Ds          , Ds          , Gs          , Gs          , Gs          , Gs          , Gs          , Gs          
Wo          , Wo          , Wo          , Wo          , Wo          , Wo          , Wo          , Wo          , Wo          , Wo          , Wo          , Wo          , Wo          , Wo          , Wo          , Wo          , Wwt         , Wwt         , Wwt         , Wwr         , Wwr         , Ds          , Wwt         , Wwt         , Wwt         , Wwt         , Ds          , Gg          , Gs          , Gg          , Gs          , Gs          , Gs          , Gs          
Wo          , Wo          , Wo          , Wo          , Wo          , Wo          , Wo          , Wo          , Wo          , Wo          , Wo          , Wo          , Wo          , Wo          , Wo          , Wo          , Wwt         , Wwt         , Wwt         , Wwt         , Wwt         , Wwr         , Wwt         , Wwt         , Wwt         , Ds          , Gg          , Gg^Vh       , Gg          , Gs          , Gs          , Gs          , Gs          , Gs          
Wo          , Wo          , Wo          , Wo          , Wo          , Wo          , Wo          , Wo          , Wo          , Wo          , Wo          , Wo          , Wo          , Wo          , Wo          , Wo          , Wo          , Wwt         , Ww^Vm       , Wwt         , Wwt         , Wwr         , Wwr         , Wwt         , Ds          , Ds          , Gs          , Gs          , Gs          , Gs          , Gg          , Gs          , Gg          , Gs          
Wo          , Wo          , Wo          , Wo          , Wo          , Wo          , Wo          , Wo          , Wo          , Wo          , Wo          , Wo          , Wo          , Wo          , Wo          , Wo          , Wwt         , Wwt         , Wwt         , Wwt         , Wwr         , Wwr         , Wwt         , Wwt         , Ds          , Ds          , Gs          , Gs          , Gs          , Gg          , Gs          , Gs          , Gs          , Gs          
Wo          , Wo          , Wo          , Wo          , Wo          , Wo          , Wo          , Wo          , Wo          , Wo          , Wo          , Wo          , Wo          , Wo          , Wo          , Wo          , Wo          , Wwt         , Wwt         , Wwt         , Wwt         , Wwr         , Ds          , Ds          , Gs          , Gs          , Gg          , Gs          , Gg          , Gg          , Gs^Vh       , Gs          , Gg          , Gg          
Wo          , Wo          , Wo          , Wo          , Wo          , Wo          , Wo          , Wo          , Wo          , Wo          , Wo          , Wo          , Wo          , Wo          , Wo          , Wo          , Wo          , Wwt         , Wwt         , Wwt         , Ds          , Ds          , Gs          , Ds          , Gs          , Gs^Vh       , Gg          , Gs          , Gs          , Gs          , Gg          , Gg          , Gg          , Gg          
Wo          , Wo          , Wo          , Wo          , Wo          , Wo          , Wo          , Wo          , Wo          , Wo          , Wwt         , Wo          , Wwt         , Wo          , Wwt         , Wo          , Wwt         , Wwt         , Ds          , Ds          , Gg          , Ds          , Gg          , Gs          , Gg          , Gg          , Gs          , Gg          , Gs          , Gs          , Gs          , Gs          , Gg          , Gg          
Wwt         , Wwt         , Wwt         , Wo          , Wo          , Wo          , Wwt         , Wo          , Wwt         , Wo          , Wwt         , Ww^Vm       , Wwt         , Wo          , Wwt         , Wwt         , Ds          , Ds          , Gg          , Ds          , Gg          , Gg          , Gg          , Gg          , Rd          , Gs          , Gg          , Gs          , Gg          , Gs          , Gs          , Gs          , Gg          , Gg          
Wwt         , Wwt         , Wwt         , Wo          , Wo          , Wo          , Wwt         , Wwt         , Wwt         , Wo          , Wwt         , Wwt         , Ds          , Wwt         , Ds          , Ds          , Gg          , Ds          , Gg          , Gg          , Gg^Vh       , Gg          , Rd          , Gg          , Gg          , Gs          , Gg          , Gg          , Gg          , Gs          , Gs          , Hh          , Hh          , Hh          
Ds          , Ds          , Ds          , Wwt         , Wwt         , Wo          , Wwt         , Ww^Vm       , Wwt         , Wwt         , Ds          , Wwt         , Ds          , Ds          , Gg          , Ds          , Gg          , Gg          , Gg          , Gg          , Gg          , Rd          , Gg          , Gg          , Gg          , Gg          , Gg          , Gs          , Gg          , Gs          , Hh          , Hh          , Hh          , Hh          
Gg          , Gg          , Ce          , Ds          , Wwt         , Wwt         , Wwt         , Wwt         , Ds          , Ds          , Gg          , Ds          , Gg          , Gg          , Gg          , Gg          , Rd          , Rd          , Rd          , Rd          , Gg          , Gg          , Gg          , Gg          , Gg          , Gg          , Gg          , Gg          , Gs          , Gs          , Hh          , Hh          , Hh          , Hh          
Gg          , Gg          , 1 Ke        , Ds          , Wwt         , Wwt         , Wwt         , Ds          , Gg          , Ds          , Gg^Vh       , Gg          , Gg          , Gg          , Rd          , Rd          , Gg^Vh       , Gg          , Gg          , Gg          , Gg          , Gg          , Gg          , Gg          , Gg          , Gg          , Gg          , Gg          , Gs          , Gs          , Hh          , Hh          , Hh^Fms      , Hh^Fms      
Gg          , Gg          , Ce          , Ds          , Wwt         , Gs^Vht      , Wwt         , Ds          , Gg          , Gg          , Rr          , Gg          , Rr          , Rd          , Gg          , Gg          , Gg          , Gg          , Gg          , Gg          , Gg          , Gg          , Gg          , Gg          , Gg          , Gg^Vh       , Gg          , Gg          , Hh          , Hh          , Hh          , Hh          , Hh          , Hh^Fms      
Gg          , Gg          , Ce          , Ds          , Wwt         , Wwt         , Wwt         , Ds          , Rr          , Rr          , Gg          , Rd          , Gg          , Gg          , Gg          , Gg          , Gg          , Gg          , Gg          , Gg          , Gg^Vh       , Gg          , Gg          , Gg          , Hh          , Gg          , Hh          , Hh          , Hh          , Hh^Fds      , Hh^Fds      , Hh^Fms      , Hh^Fms      , Hh^Fms      
Gg          , Gg          , Gg          , Ds          , Wwf         , Wwf         , Wwf         , Ds          , Gg          , Gg          , Gg          , Gg          , Gg          , Gg          , Gg          , Gg          , Gg          , Gg          , Gg          , Gg          , Gs          , Gs          , Gs          , Gs          , Hh^Fds      , Hh          , Hh          , Hh          , Hh^Fms      , Hh          , Hh^Fds      , Hh^Fds      , Hh^Fds      , Hh^Fds      
Gg          , Gg          , Gg          , Ds          , Wwf         , Wwf         , Wwf         , Ds          , Gg          , Gg          , Gg          , Gg          , Gg          , Gg          , Gg          , Gg          , Gg          , Gg          , Gg          , Gg          , Gs          , Gs          , Gs          , Hh^Fds      , Hh^Fms      , Hh^Fms      , Hh          , Hh          , Hh^Fms      , Hh^Fms      , Hh^Fms      , Hh^Fds      , Hh^Fds      , Hh^Fds      
