border_size=1
usage=map

Wo          , Wo          , Wo          , Wo          , Wo          , Wo          , Wo          , Wo          , Wo          , Wo          , Wo          , Wo          , Wo          , Wo          , Wo          , Wo          , Wo          , Wo          , Wo          , Wo          , Wo          , Wo          , Wo          , Wo          , Wo          , Wo          , Wo          , Wo          , Wo          , Wo          , Wo          , Wo          , Wo          , Wo          , Wo          
Wo          , Wo          , Wo          , Wo          , Wo          , Wo          , Wo          , Wo          , Wo          , Wo          , Wo          , Wo          , Wo          , Wo          , Wo          , Wo          , Wo          , Wo          , Wo          , Wo          , Wo          , Wo          , Wo          , Wo          , Wo          , Wo          , Wo          , Wo          , Wo          , Wo          , Wo          , Wo          , Wo          , Wo          , Wo          
Wo          , Wo          , Wo          , Wo          , Ww          , Wwr         , Wwr         , Wo          , Wo          , Wo          , Wo          , Wo          , Wo          , Wo          , Wo          , Wwr         , Wwr         , Wwr         , Wwr         , Wo          , Wo          , Wo          , Wo          , Wo          , Wo          , Wo          , Wo          , Wo          , Ww          , Ww          , Ww          , Ww          , Ww          , Wo          , Wo          
Wo          , Wo          , Ww          , Ww          , Ww          , Wwr         , Ww          , Ww          , Ww          , Wo          , Ww          , Ww          , Ww          , Ww          , Ww          , Ww          , Ww          , Ww          , Wwr         , Wwr         , Wo          , Wo          , Wo          , Wo          , Wo          , Wo          , Ww          , Ww          , Ww          , Gs          , Gs^Fdw      , Gs^Fds      , Ww          , Wo          , Wo          
Wo          , Wo          , Ww          , Wwr         , Wwr         , Dd          , Ww          , Ww          , Ww          , Ww          , Ww          , Hd          , Hd          , Hd          , Ww          , Hd          , Ww          , Ww          , Ww          , Wwr         , Wo          , Wo          , Wo          , Wo          , Wo          , Wo          , Wo          , Ww          , Gs^Vc       , Ss          , Ss          , Gs^Fdw      , Ww          , Wo          , Wo          
Wo          , Wo          , Ww          , Wwr         , Dd          , Dd^Vda      , Dd          , Dd          , Dd          , Dd          , Dd          , Hd          , Hd          , Mm          , Mm          , Mm          , Hd          , Ww          , Ww          , Wo          , Wwr         , Wo          , Wo          , Wo          , Wo          , Wo          , Wo          , Ww          , Gs          , Gs          , Ss          , Gs^Fds      , Ww          , Wo          , Wo          
Wo          , Wo          , Ww          , Gd^Ft       , Dd          , Gd^Ft       , Dd          , Chr         , Chr         , Chr         , Dd          , Ww          , Dd^Vda      , Mm          , Qv          , Hd          , Hd          , Gd^Ft       , Ww          , Ww          , Ww          , Ww          , Ww          , Wo          , Wo          , Wo          , Wo          , Ww          , Ww          , Ww          , Gs^Fds      , Ww          , Wo          , Wo          , Wo          
Wo          , Wo          , Wo          , Ww          , Gd^Ft       , Gd^Ft       , Gd^Fdw      , Chr         , 3 Khr       , Chr         , Dd          , Dd          , Hd          , Hd          , Mm          , Mm          , Hd          , Gd^Ft       , Gd^Fmw      , Gd^Fmw      , Gs^Vc       , Ww          , Ww          , Ww          , Wo          , Wo          , Wo          , Wo          , Ww          , Ww          , Ww          , Ww          , Wo          , Wo          , Wo          
Wo          , Wo          , Wo          , Ww          , Ww          , Ww          , Gd^Ft       , Dd          , Dd          , Dd          , Hd          , Gd^Ft       , Mm          , Qv          , Mm          , Hd          , Gd^Ft       , Gd^Ft       , Gd^Fmw      , Gd^Fmw      , Gd^Fmw      , Gd^Fmw      , Ww          , Ww          , Ww          , Wo          , Wo          , Ww          , Ww^Bw\      , Ww          , Ww          , Wo          , Wo          , Wo          , Wo          
Wo          , Wo          , Wo          , Wo          , Ww          , Ww          , Gd^Ft       , Gd^Ft       , Dd^Do       , Dd          , Mm          , Hd          , Mm          , Mm          , Mm          , Hd          , Gd^Ft       , Dd          , Gd^Fmw      , Gs^Fdw      , Gd^Fmw      , Gd^Fmw      , Gs^Fdw      , Gd^Fmw      , Ww          , Wo          , Ww          , Ww          , Gs          , Gs^Vc       , Ww          , Ww          , Wo          , Wo          , Wo          
Wo          , Wo          , Wo          , Wo          , Ww          , Ww          , Ww          , Ww          , Gd^Ft       , Hd          , Gd^Ft       , Hd          , Mm          , Hd          , Hd          , Hd          , Dd          , Dd          , Dd          , Gs^Fdw      , Gd^Ft       , Gd^Fmw      , Gd^Fmw      , Gd^Fmw      , Ww          , Ww          , Ww          , Ww          , Gs          , Gs          , Gs^Fds      , Ww          , Ww          , Wo          , Wo          
Wo          , Wo          , Wo          , Wo          , Ww          , Ww          , Ww          , Ww          , Gd^Ft       , Gd^Ft       , Dd          , Hd          , Hd          , Gd^Vht      , Gd^Ft       , Hd          , Dd          , Dd          , Dd          , Gd^Fmw      , Gd^Ft       , Ss          , Gd^Fmw      , Gs^Ft       , Gs          , Dd          , Ww          , Ww          , Ce          , Ce          , Gs^Fds      , Dd          , Ww          , Wo          , Wo          
Wo          , Wo          , Wo          , Wo          , Wo          , Wo          , Wwr         , Ww          , Dd          , Dd          , Gd^Ft       , Dd          , Gd^Ft       , Gd^Ft       , Gd^Ft       , Dd          , Gd^Ft       , Dd          , Gd^Ft       , Gd^Fmw      , Gd^Fmw      , Gd^Fmw      , Gs^Fdw      , Gd^Fmw      , Gs^Vc       , Ww          , Ww          , Ww          , Ww          , 1 Ke        , Ce          , Dd          , Ww          , Wo          , Wo          
Wo          , Wo          , Wo          , Wo          , Wo          , Wo          , Wwr         , Wwr         , Dd          , Gd^Ft       , Gd^Fdw      , Rd          , Gd^Ft       , Ss          , Ss          , Gd^Fmw      , Gd^Ft       , Gd^Fmw      , Rd          , Rd          , Gd^Fmw      , Gs^Fdw      , Gd^Fmw      , Gd^Fmw      , Gs          , Gs          , Ww          , Ww          , Ww          , Ce          , Ww          , Dd          , Ww          , Wo          , Wo          
Wo          , Wo          , Wo          , Wo          , Ww          , Wwr         , Wwr         , Dd          , Dd          , Gd^Ft       , Gd^Fdw      , Rd          , Rd          , Gd^Fmw      , Rd          , Rd          , Gd^Fmw      , Gd^Ft       , Gd^Fmw      , Rd          , Gs^Ft       , Gd^Fmw      , Gs^Ft       , Gs^Vht      , Gd^Fmw      , Gd^Fmw      , Gs          , Ww          , Ww          , Ww          , Dd          , Ww          , Wo          , Wo          , Wo          
Wo          , Wo          , Wo          , Ww          , Ww          , Gs          , Gs          , Gs^Ft       , Gs^Ft       , Rd          , Rd          , Gd^Fmw      , Gd^Ft       , Gd^Fmw      , Gd^Fmw      , Gd^Fmw      , Gd^Fmw      , Gd^Fdw      , Gd^Fmw      , Rd          , Rd          , Rd          , Gs^Ft       , Gd          , Gd^Fmw      , Gd^Fmw      , Gs          , Gs          , Gs^Vc       , Gs^Ft       , Ww          , Ww          , Wo          , Wo          , Wo          
Wo          , Wo          , Ww          , Ww          , Ww          , Gs          , Gd^Fmw      , Gs^Vht      , Gd^Fmw      , Rd          , Gd^Fdw      , Gd^Ft       , Gd^Ft       , Ss          , Gd^Fmw      , Gd^Fdw      , Gd^Fmw      , Rd          , Rd          , Gd^Fmw      , Gd^Fmw      , Gs^Ft       , Ss          , Ss          , Gd^Fmw      , Rd          , Gd^Fmw      , Gd^Fmw      , Gs^Fdw      , Gd^Fmw      , Gd^Fmw      , Ww          , Wo          , Wo          , Wo          
Wo          , Wo          , Ww          , Gs          , Ww          , Gs          , Gd^Fmw      , Gd^Fmw      , Gd^Fdw      , Gd^Fmw      , Rd          , Rd          , Gd          , Gd^Ft       , Gd^Fdw      , Gd^Fdw      , Gd^Ft       , Rd          , Gd^Vht      , Gs^Fdw      , Gd^Fmw      , Gd^Fmw      , Gd^Fmw      , Gs^Ft       , Rd          , Gd^Fmw      , Rd          , Rd          , Rd          , Gd^Fmw      , Gs^Ft       , Ww          , Wo          , Wo          , Wo          
Wo          , Wo          , Ww          , Gs^Ft       , Ww          , Ww          , Gs          , Gd          , Gs^Ft       , Gs^Ft       , Gs^Ft       , Rd          , Gd          , Gd          , Gd^Ft       , Gd          , Ss          , Rd          , Gd^Fmw      , Gd^Fmw      , Gd^Fmw      , Gd^Fdw      , Gd^Fdw      , Gd^Fmw      , Rd          , Gs^Ft       , Gs^Ft       , Rd          , Gg^Vc       , Gs^Ft       , Ww          , Ww          , Wo          , Wo          , Wo          
Wo          , Wo          , Ww          , Gs^Ft       , Gs^Ft       , Ww          , Ww          , Ww          , Ww          , Ww          , Gs^Ft       , Dd          , Gd^Edp      , Gd          , Gd          , Gd          , Gd          , Rd          , Gd^Fdw      , Gd^Fmw      , Gd^Fmw      , Gd^Fdw      , Gd^Fmw      , Gd^Fmw      , Rd          , Rd          , Rd          , Gs^Ft       , Gs^Ft       , Ww          , Ww          , Wo          , Wo          , Wo          , Wo          
Wo          , Wo          , Ww          , Gs^Ft       , Gs          , Ww          , Wo          , Wo          , Ww          , Ww          , Dd          , Dd          , Dd          , Dd          , Gd          , Dd          , Gd          , Rd          , Gd          , Gd          , Gd          , Gs          , Gd^Fmw      , Gs          , Gs^Ft       , Gs^Ft       , Gs^Ft       , Ww          , Ww          , Ww          , Wo          , Wo          , Wo          , Wo          , Wo          
Wo          , Wo          , Wo          , Ww          , Ww          , Ww          , Wo          , Wo          , Wwr         , Ww          , Ww          , Ww          , Dd          , Dd          , Dd          , Dd          , Dd          , Dd          , Gd          , Dd          , Dd          , Ww          , Gs          , Ww          , Gs          , Ww          , Ww          , Ww          , Wwt         , Wo          , Wo          , Wo          , Wo          , Wo          , Wo          
Wo          , Wo          , Wo          , Wo          , Ww          , Wo          , Ww          , Wwr         , Wwr         , Ww          , Dd          , Dd          , Ss          , Dd          , Ss          , Ss          , Dd          , Dd          , Dd          , Dd          , Dd          , Ww          , Ww          , Ww          , Ww          , Ww          , Wwt         , Wwt         , Wwt         , Wwt         , Wwt         , Wo          , Wwt         , Wo          , Wo          
Wo          , Wo          , Wo          , Ww          , Ww          , Ww          , Ww          , Ww          , Ww          , Ww          , Ww          , Dd          , Dd          , Dd          , Dd          , Ss          , Dd          , Dd          , Dd          , Ww          , Ww          , Ww          , Wo          , Wo          , Wo          , Wwt         , Wwt         , Wwt         , Ww          , Dd          , Wwt         , Wwt         , Wwt         , Wo          , Wo          
Wo          , Wo          , Wo          , Ww          , Gs          , Gs          , Gs^Edp      , Gs          , Dd          , Ww          , Ww          , Ww          , Ss          , Ss          , Dd          , Ss          , Dd          , Ww          , Ww          , Ww          , Wwr         , Wo          , Wo          , Wo          , Wo          , Wwt         , Wwt         , Dd          , Dd          , Dd          , Dd          , Dd          , Wwt         , Wo          , Wo          
Wo          , Wo          , Ww          , Ww          , Gs^Vht      , Gs^Ft       , Gs^Ft       , Gs^Ft       , Dd          , Dd          , Ss          , Ss          , Dd          , Dd          , Dd          , Dd          , Ww          , Ww          , Wwr         , Ww          , Wwr         , Wwr         , Wo          , Wo          , Wwt         , Wwt         , Dd          , Gs          , Gs^Ft       , Gs^Vht      , Gs^Ft       , Dd          , Wwt         , Wo          , Wo          
Wo          , Wo          , Ww          , Ww          , Gs          , Gs^Ft       , Gd^Ft       , Gd^Ft       , Dd          , Ss          , Ww          , Ss          , Ww          , Ww          , Dd          , Dd          , Ww          , Wwr         , Wwr         , Wo          , Wo          , Wo          , Wo          , Wo          , Wwt         , Wwt         , Dd          , Gs          , Gs          , Gs^Ft       , Gs^Ft       , Dd          , Wwt         , Wo          , Wo          
Wo          , Wo          , Ww          , Gs^Ft       , Gd^Ft       , Gs^Ft       , Gd^Ft       , Dd^Vda      , Dd          , Dd          , Ss          , Ss          , Ww          , Ss          , Ww          , Ww          , Wwr         , Ww          , Wo          , Wo          , Wo          , Wo          , Wo          , Wo          , Wo          , Wwt         , Wwr         , Wwr         , Dd          , Dd          , Dd          , Wwt         , Wo          , Wo          , Wo          
Wo          , Wo          , Ww          , Gd^Ft       , Gd^Vht      , Gd^Ft       , Gd^Ft       , Gd^Ft       , Dd          , Dd          , Dd          , Dd          , Dd          , Ss          , Dd          , Ww          , Wo          , Wo          , Wo          , Wo          , Wo          , Wo          , Wo          , Wo          , Wwt         , Wwt         , Wwt         , Wwr         , Wwr         , Wwt         , Wwt         , Wwt         , Wo          , Wo          , Wo          
Wo          , Wo          , Ww          , Ww          , Chr         , Gd^Ft       , Gd          , Ss          , Rd          , Rd          , Dd          , Ss          , Dd          , Dd          , Gs          , Ww          , Wo          , Wo          , Wo          , Wo          , Wo          , Wo          , Wo          , Wo          , Wwt         , Wwt         , Wwt         , Wwr         , Wwt         , Wwt         , Wwt         , Wwt         , Wo          , Wo          , Wo          
Wo          , Wo          , Wo          , Chr         , Chr         , Gd          , Gd^Ft       , Rd          , Ss          , Gd^Ft       , Gd          , Dd          , Dd^Vda      , Gs          , Gs          , Ww          , Ww          , Ww          , Wo          , Wo          , Wo          , Wo          , Wo          , Wwt         , Wwt         , Dd^Vda      , Wwr         , Wwr         , Wwt         , Wwt         , Wo          , Wo          , Wo          , Wo          , Wo          
Wo          , Wo          , Ww          , 2 Khr       , Chr         , Chr         , Gd^Ft       , Gs^Ft       , Ss          , Ss          , Gs^Ft       , Gs          , Gs          , Gs^Edp      , Gd^Fmw      , Gs          , Ww          , Ww          , Wo          , Wo          , Wo          , Wo          , Wwt         , Wwt         , Dd          , Dd          , Dd          , Dd          , Wwt         , Wo          , Wo          , Wo          , Wo          , Wo          , Wo          
Wo          , Wo          , Ww          , Gd^Ft       , Gd          , Gd^Ft       , Gd^Ft       , Gd          , Gs^Ft       , Gs          , Gd          , Gd          , Gd          , Gd^Fdw      , Gd^Fmw      , Ww          , Ww          , Wo          , Wo          , Wo          , Wo          , Wwt         , Wwt         , Ww^Bw\      , Dd          , Hd          , Hd          , Mm          , Wwt         , Wwt         , Wwt         , Wwt         , Wwt         , Wo          , Wo          
Wo          , Wo          , Ww          , Dd^Do       , Dd          , Gd          , Gd          , Gs          , Gs          , Gs          , Gs          , Gs          , Gd^Fmw      , Gd^Fmw      , Ww          , Ww          , Wo          , Wo          , Wo          , Wwt         , Wwt         , Wwt         , Wwt         , Dd          , Mm          , Qv          , Mm          , Mm          , Dd          , Dd          , Wwt         , Wwt         , Wwt         , Wo          , Wo          
Wo          , Wo          , Ww          , Dd          , Gs          , Gd          , Gs          , Gs          , Ss          , Gs          , Gs          , Gs^Vht      , Gs          , Ww          , Ww          , Wo          , Wo          , Wo          , Wo          , Wwt         , Wwt         , Gs          , Gs          , Gd^Ft       , Hd          , Mm          , Hd          , Hd          , Gd^Ft       , Dd          , Dd^Vda      , Wwt         , Wwt         , Wo          , Wo          
Wo          , Wo          , Ww          , Dd          , Gs          , Gs          , Gs          , Ss          , Gs          , Gs          , Gs^Edp      , Gs          , Gs          , Ww          , Ww          , Wo          , Wo          , Wo          , Wo          , Wo          , Wwt         , Wwt         , Gs          , Hd          , Mm          , Mm          , Hd          , Gd^Ft       , Dd          , Wwr         , Wwt         , Wwt         , Wo          , Wo          , Wo          
Wo          , Wo          , Ww          , Ww          , Wwr         , Wwr         , Gs          , Gs          , Gs          , Gs          , Gs          , Gs          , Wwr         , Ww          , Wo          , Wo          , Wo          , Wo          , Wwr         , Wo          , Wo          , Wwt         , Wwt         , Gs          , Gs          , Gs^Vht      , Gs          , Dd          , Wwr         , Wwr         , Wo          , Wo          , Wo          , Wo          , Wo          
Wo          , Wo          , Wo          , Ww          , Ww          , Wwr         , Gs          , Gs^Vht      , Gs          , Gs          , Gs          , Gs          , Wwr         , Ww          , Wo          , Wwr         , Wwr         , Wwr         , Wwr         , Wwr         , Wwr         , Wo          , Wwt         , Wwt         , Gs          , Ss          , Gs          , Wwr         , Wwr         , Wwr         , Wwr         , Wo          , Wo          , Wo          , Wo          
Wo          , Wo          , Wo          , Wo          , Ww          , Wwr         , Wwr         , Gs          , Ww          , Gs          , Wwr         , Wwr         , Wwr         , Ww          , Wwr         , Wwr         , Wo          , Wo          , Wo          , Wo          , Wo          , Wo          , Wwt         , Wwt         , Gs          , Wwt         , Wwt         , Wwt         , Wo          , Wo          , Wo          , Wo          , Wo          , Wo          , Wo          
Wo          , Wo          , Wo          , Wo          , Wo          , Ww          , Ww          , Ww          , Ww          , Ww          , Ww          , Wwr         , Ww          , Wwr         , Wwr         , Wwr         , Wo          , Wo          , Wo          , Wo          , Wo          , Wo          , Wwt         , Wwt         , Wwt         , Wwt         , Wwt         , Wo          , Wo          , Wo          , Wo          , Wo          , Wo          , Wo          , Wo          
Wo          , Wo          , Wo          , Wo          , Wo          , Wo          , Wo          , Ww          , Wo          , Ww          , Wo          , Wo          , Wo          , Wwr         , Wo          , Wo          , Wo          , Wo          , Wo          , Wo          , Wo          , Wo          , Wo          , Wwt         , Wo          , Wwt         , Wo          , Wo          , Wo          , Wo          , Wo          , Wo          , Wo          , Wo          , Wo          
Wo          , Wo          , Wo          , Wo          , Wo          , Wo          , Wo          , Wo          , Wo          , Wo          , Wo          , Wo          , Wo          , Wo          , Wo          , Wo          , Wo          , Wo          , Wo          , Wo          , Wo          , Wo          , Wo          , Wo          , Wo          , Wo          , Wo          , Wo          , Wo          , Wo          , Wo          , Wo          , Wo          , Wo          , Wo          
