border_size=1
usage=map

Gs          , Gs          , Gs          , Hh          , Hh          , Mm          , Mm          , Mm          , Hh          , Ww          , Hh          , Mm          , Mm          , Mm          , Mm          , Mm          , Mm          , Hh          , Hh          , Hh          , Hh          , Gs          , Gs          , Gs          , Gs          , Gs          , Gs          , Gs          , Gs          , Gs          , Gs          
Gs          , Gs          , Gs          , Hh          , Hh          , Mm          , Mm          , Mm          , Hh          , Ww          , Hh          , Mm          , Mm          , Mm          , Mm          , Mm          , Mm          , Hh          , Hh          , Hh          , Hh          , Gs          , Gs          , Gs          , Gs          , Gs          , Gs          , Gs          , Gs          , Gs          , Gs          
Gs          , Gs          , Hh          , Hh          , Hh          , Hh          , Hh          , Mm          , Hh          , Ww          , Hh          , Mm          , Mm          , Mm          , Mm          , Mm          , Mm          , Hh          , Hh          , Gs          , Gs          , Gs          , Gs          , Gs          , Gs          , Gs          , Gs          , Gs          , Gs          , Gs          , Gs          
Gs          , Gs          , Hh          , Hh          , Gs          , Gs          , Hh          , Hh          , Hh          , Ww          , Gs          , Hh          , Hh          , Hh          , Mm          , Hh          , Mm          , Mm          , Hh^Vhh      , Gs          , Gs          , Gll^Fmf     , Gs          , Gs          , Gll^Fdf     , Gd          , Gs          , Gs          , Gs^Vh       , Gs          , Gs          
Gs          , Gs          , Hh          , Gs          , Gs          , Gs          , Gs          , Hh          , Hh          , Ww          , Gg          , Hh          , Hh          , Hh          , Hh          , Hh          , Mm          , Mm          , Hh          , Hh          , Gs          , Gll^Fdf     , Gll^Fmf     , Gll^Fdf     , Gll^Fdf     , Gs          , Gs          , Gs          , Gs          , Gs          , Gs          
Gs          , Gs          , Gs          , Gs          , Gs          , Gs^Vh       , Gs          , Gs          , Hh          , Ww          , Ww          , Gg          , Gs          , Gs          , Gs          , Hh          , Mm          , Mm          , Hh          , Gs          , Gs          , Gll^Fmf     , Gll^Fmf     , Gll^Fmf     , Gs          , Gs          , Gd          , Gd          , Gs          , Gs          , Gs          
Gs          , Gd          , Gs          , Gs          , Gs          , Gs          , Gs          , Gs          , Gs          , Gg          , Ww          , Gg^Vh       , Gg          , Hh          , Hh          , Hh          , Mm          , Mm          , Gs          , Gs          , Gs          , Gll^Fp      , Gll^Fp      , Gll^Fmf     , Gs          , Gs          , Gs          , Gs          , Re          , Re          , Re          
Gd          , Gd          , Gd          , Gs          , Gd          , Gs          , Gs          , Gs          , Gs          , Gg          , Ww          , Ww          , Gg          , Hh          , Hh          , Hh          , Hh          , Hh          , Gs          , Gs          , Gll^Fp      , Gll^Fmf     , Gll^Fdf     , Gs^Fmf      , Gs^Vh       , Gs          , Gs          , Gs          , Re          , Gs          , Gs          
Gs          , Gd          , Gs          , Gs          , Gs          , Gs          , Gs          , Gs          , Gs          , Gg          , Gg          , Ww          , Gg          , Hh          , Hh          , Hh          , Hh          , Gs          , Gs          , Gs          , Gll^Fp      , Gll^Fp      , Gll^Fp      , Gs^Fmf      , Gll^Fp      , Gs          , Re          , Re          , Gs          , Gs          , Gs          
Gs          , Gs          , Gs          , Gd          , Gs          , Gs          , Gs          , Gs          , Gs          , Gs          , Gg          , Ww          , Gg          , Hh          , Hh          , Hh          , Hh          , Gs          , Gs          , Gs          , Gs          , Gll^Fp      , Gll^Fp      , Gll^Fp      , Gll^Fp      , Gs          , Re          , Gs          , Gs          , Gd          , Gs          
Gs          , Gs          , Gs          , Gs          , Gd          , Gs          , Gs          , Gs          , Gs^Fmf      , Gs          , Gg          , Ww          , Gg          , Gs          , Gs          , Gg^Vh       , Hh          , Hh          , Gs          , Gs          , Gs          , Gs          , Gs          , Gs          , Re          , Re          , Gs          , Gs          , Gs          , Gs          , Gs          
Gs          , Gs          , Gs          , Gd          , Gs          , Gs          , Gs          , Gs          , Gs^Fmf      , Gs          , Gg          , Ww          , Gg          , Gg          , Gs          , Gs          , Hh          , Hh          , Gs          , Gs          , Gs          , Gs          , Gs          , Gs          , Re          , Gs          , Ce          , Ce          , Ce          , Gs          , Gs          
Gs          , Gd          , Gs          , Gs          , Gs          , Gs          , Gs^Vh       , Gs^Fmf      , Gs^Fmf      , Gs          , Gg          , Ww          , Gg          , Gs          , Gs          , Gs          , Hh          , Hh          , Gs^Vh       , Gs          , Gs          , Gs          , Re          , Re          , Gs          , Gs          , Ce          , 2 Ke        , Ce          , Gs          , Gs          
Gs          , Gs          , Gs          , Gd          , Gs          , Gs          , Gs          , Gs^Fmf      , Gs^Fmf      , Gs^Fmf      , Gg          , Ww          , Ww          , Gg          , Gs          , Gs          , Gs          , Gs          , Gs          , Gs          , Gs          , Gs          , Re          , Gs          , Gs          , Re          , Ce          , Ce          , Ce          , Gs          , Gs          
Gs          , Gs          , Gs^Vh       , Gs          , Gs          , Gs          , Gs          , Gs^Fmf      , Gs^Fmf      , Gs^Fmf      , Gs^Fmf      , Gg          , Ww          , Gg          , Gs          , Gs          , Gs          , Gs          , Gs          , Gs          , Re          , Re          , Gs          , Gs          , Gs          , Gs          , Gs          , Re          , Gs          , Gs          , Gs          
Gs          , Gs          , Hh          , Gs          , Gs          , Gs          , Gs          , Gs^Fmf      , Gs^Fmf      , Gs^Fmf      , Gs^Fmf      , Gg          , Ww          , Gs          , Gs          , Gs          , Gs          , Gs          , Gs          , Gs          , Re          , Gs          , Gs          , Gs          , Gs          , Gd          , Gs          , Gd          , Gd          , Gs          , Gs          
Gs          , Gs          , Hh          , Gs          , Gs          , Gs          , Gs          , Gs          , Gs^Fmf      , Gs^Vh       , Gs          , Gs          , Ww^Bw/      , Re          , Re          , Re          , Re          , Re          , Re          , Re          , Gs          , Gs          , Gs          , Gs^Vh       , Gs          , Gs          , Gd          , Gd          , Gd          , Gd          , Gd          
Gs          , Gs          , Hh          , Hh          , Gs          , Gs          , Gs          , Gs          , Gs^Fmf      , Gs          , Re          , Re          , Ww          , Gs^Vh       , Gg          , Gs          , Gs          , Gs          , Gs          , Gs          , Gs          , Gs          , Gs          , Gs          , Gd          , Gs          , Gs          , Gd          , Gs          , Gd          , Gs          
Gs          , Gs          , Gs          , Hh          , Gs          , Gs          , Gs          , Gs          , Gs          , Re          , Gs          , Gs          , Ww          , Ww          , Gg          , Gs          , Gs          , Gs          , Gd          , Gs          , Gs          , Gd          , Gd          , Gs          , Gs          , Gs          , Re^Gvs      , Re^Gvs      , Re          , Gs          , Gs          
Gs          , Gs          , Gs          , Gs          , Gs          , Gs          , Gs          , Gs          , Re          , Re          , Gs^Fmf      , Gg          , Gg          , Ww          , Gg          , Gs          , Gs          , Gs          , Gs          , Gs          , Gs          , Gs          , Gs          , Gs          , Gs          , Re^Gvs      , Re^Gvs      , Re^Gvs      , Gs          , Gs          , Gs          
Gs          , Gs          , Gs          , Gs          , Gs          , Gs          , Gs          , Gs          , Re          , Gs^Fmf      , Gs^Fmf      , Gs          , Gg          , Ww          , Ww          , Gg          , Gg          , Gs          , Gs          , Gs          , Re^Gvs      , Re^Gvs      , Re^Gvs      , Gs          , Gs          , Gs          , Gs          , Gd          , Gs          , Gd          , Gs          
Gs          , Gd          , Gs          , Gll^Fdf     , Gd          , Gs          , Gs          , Gs          , Re          , Gll^Fdf     , Gll^Fdf     , Gll^Fdf     , Gs^Fmf      , Gg          , Ww          , Ww          , Gg^Vh       , Gs          , Gg          , Gs          , Gs          , Re^Gvs      , Gs          , Gs          , Gs          , Gs^Fp       , Gs          , Gs          , Gs          , Gs          , Gs          
Gd          , Gd          , Gs          , Gll^Fdf     , Gll^Fmf     , Gll^Fmf     , Gll^Fmf     , Gs^Fdf      , Re          , Gll^Fdf     , Gll^Fdf     , Gll^Fdf     , Gs^Fmf      , Gs          , Gg          , Ww          , Ww          , Gg          , Ww          , Gg          , Gg          , Gs          , Gs          , Gs          , Gs          , Gs^Fp       , Gs^Fp       , Gs^Vh       , Gs          , Gs          , Gs          
Gd          , Gd          , Gll^Fmf     , Gll^Fmf     , Gll^Fdf     , Gll^Fmf     , Gs^Vh       , Gll^Fmf     , Re          , Gs^Fmf      , Gs          , Gs^Fmf      , Gs          , Gs          , Gs          , Gg          , Ww          , Ww          , Ww          , Ww          , Gg          , Gs^Vh       , Gs          , Gs          , Gs          , Gs^Fp       , Gs^Fp       , Gs          , Gs          , Gs^Fp       , Gs^Fp       
Gll^Fdf     , Gll^Fdf     , Gll^Fdf     , Gll^Fdf     , Gll^Fdf     , Gll^Fmf     , Re          , Re          , Gs^Fmf      , Gs^Fmf      , Gll^Fdf     , Gs          , Gs          , Gs          , Gs          , Gg          , Gg          , Ww          , Gg^Vh       , Ww          , Ww          , Gg          , Gs          , Gs          , Gs          , Gs^Fp       , Gs          , Gs          , Gs          , Gs^Fp       , Gs^Fp       
Gll^Fdf     , Gll^Fdf     , Gll^Fdf     , Gs^Fmf      , Gs^Fmf      , Gll^Fdf     , Re          , Gs^Fdf      , Gs^Fmf      , Gll^Fdf     , Gll^Fdf     , Gs          , Re^Gvs      , Re^Gvs      , Re^Gvs      , Gs          , Gs          , Gg          , Gs          , Gg          , Ww          , Gg          , Gg          , Gs          , Gs          , Gs^Fp       , Gs          , Gs^Fp       , Gs          , Gs^Fp       , Gs^Fp       
Gll^Fdf     , Gll^Fdf     , Gll^Fdf     , Gs^Fmf      , Gs          , Gs^Fmf      , Re          , Gs^Vh       , Gs          , Gs^Fmf      , Gs          , Re          , Re          , Re^Gvs      , Gs          , Gs          , Gs^Fmf      , Gs^Fmf      , Gs          , Gg          , Ww          , Ww          , Gg          , Gs          , Gs          , Gs          , Gs          , Gs^Fp       , Gs^Fp       , Gs^Fp       , Gs^Fp       
Gs          , Gs          , Gd          , Gs          , Gs          , Gs          , Re          , Gs          , Gs          , Gs          , Gs          , Gs          , Gs          , Gs          , Gs          , Gs          , Gs^Fmf      , Gs^Fmf      , Gs^Fmf      , Gg          , Gg          , Ww          , Ww          , Gg          , Gs          , Gs          , Gs^Fp       , Gs^Fp       , Gs^Fp       , Gs^Fp       , Gs^Fp       
Gs          , Gd          , Re          , Gd          , Re          , Re          , Gs          , Gs          , Gd          , Gd          , Gd          , Gs          , Gs          , Gs          , Gd          , Gs          , Gs^Fmf      , Gs^Fp       , Gs^Fp       , Gs          , Gs          , Gg          , Ww          , Gg^Vh       , Gg          , Gs          , Gs^Fp       , Gs^Fp       , Gs^Fp       , Gs          , Gs          
Re          , Re          , Gd          , Re          , Gd          , Gd          , Gd          , Gd          , Gd          , Gd          , Gd          , Gs          , Gd          , Gd          , Gd          , Gs          , Gs^Fmf      , Gs^Fp       , Gs^Fmf      , Gs^Fmf      , Gs          , Gg          , Ww          , Ww          , Gg          , Gs          , Gs^Fp       , Gs^Fp       , Gs^Fp       , Gs          , Gs          
Gs          , Gd          , Gs          , Gd^Vh       , Gd          , Gd          , Gd          , Gd          , Gd          , Gd          , Gs          , Gs          , Gd          , Gd          , Gs          , Gs          , Gs^Fmf      , Gs^Fmf      , Gs^Fmf      , Gs^Fp       , Gs          , Gg          , Gg          , Ww          , Ww          , Gg          , Gs          , Gs          , Gs^Fp       , Gs          , Gs          
Gd          , Gs          , Gd          , Gd          , Gd          , Gd          , Gd          , Gd          , Gd          , Gd          , Gd          , Gs          , Gs^Vh       , Gs          , Gs          , Gs          , Gs          , Gs^Fp       , Gs^Fp       , Gs^Fp       , Gs          , Gg          , Ds          , Ww          , Ww          , Gg          , Gg          , Gs          , Gs^Fp       , Gs          , Gs          
Gs          , Gd          , Gs          , Gd          , Ce          , Gd          , Ce          , Gd          , Gd          , Gs          , Gs          , Gs          , Gs          , Gs          , Gs          , Gd          , Gs          , Gs          , Gs          , Gs          , Gs          , Ds          , Ww          , Ww          , Ds          , Gg          , Gg          , Gs          , Gs          , Gs          , Gs          
Gs          , Gs          , Gd          , Gd          , Ce          , Ce          , Ce          , Gd          , Gd          , Gs          , Gd          , Gd          , Gs          , Gs          , Gd          , Gs          , Gs          , Gs          , Gs          , Gs          , Ds          , Ds          , Ww          , Ww          , Ds          , Gg^Vh       , Gg          , Ww          , Gs          , Gs          , Gs          
Gd          , Gd          , Gd          , Gd          , Ce          , 1 Ke        , Ce          , Gd          , Gs          , Gd          , Gd          , Gs          , Gs          , Gd          , Gs          , Gs          , Gs          , Gs          , Ds          , Ds          , Ds          , Ww          , Ww          , Ww          , Ww          , Ds          , Ww          , Ww          , Gg          , Gs          , Gs          
Gs          , Gd          , Gs          , Gd          , Gs          , Ce          , Gs          , Gs          , Ds          , Gs          , Gs          , Gs          , Gs          , Gs          , Gs          , Gs          , Ds          , Ds          , Ww          , Ww          , Ww          , Ww          , Wo          , Ww          , Ww          , Ww          , Ww          , Ww          , Ww          , Gg          , Gg          
Gs          , Gs          , Gs          , Gs          , Gs          , Gd          , Gs          , Gs          , Ds          , Ds          , Ds          , Ds          , Ds          , Gs          , Gs^Vh       , Ds          , Ww          , Ds          , Ww          , Ww          , Ww          , Ww          , Wo          , Wo          , Ww          , Ww          , Wo          , Ww          , Ww          , Ww          , Ww          
Gs          , Gs          , Gs          , Hh          , Gs          , Gs          , Gs          , Gs          , Ds          , Ww          , Ww          , Ww          , Ww          , Ds          , Ds          , Ds          , Ww          , Ww          , Ww          , Ww          , Wo          , Wo          , Wo          , Wo          , Wo          , Wo          , Wo          , Wo          , Ww          , Ww          , Ww          
Hh          , Hh          , Hh          , Hh          , Hh          , Hh          , Hh          , Gs          , Gs          , Ww          , Ww          , Ww          , Ww          , Ww          , Ww          , Ww          , Ww          , Ww          , Wo          , Wo          , Wo          , Wo          , Wo          , Wo          , Wo          , Wo          , Wo          , Ww          , Ww          , Ww          , Ww          
Mm          , Mm          , Hh          , Hh          , Hh          , Mm          , Gs          , Gs          , Ww          , Ww          , Ww          , Ww          , Ww          , Ww          , Ww          , Ww          , Ww          , Wo          , Wo          , Wo          , Wo          , Wo          , Wo          , Wo          , Wo          , Wo          , Ww          , Ww          , Wo          , Wo          , Wo          
Mm          , Mm          , Hh          , Mm          , Mm          , Hh          , Gg          , Ww          , Ww          , Ww          , Ww          , Ww          , Ww          , Ww          , Ww          , Gg          , Ww          , Ww          , Wo          , Wo          , Wo          , Wo          , Wo          , Wo          , Wo          , Ww          , Ww          , Ww          , Ww          , Wo          , Wo          
Mm          , Mm          , Mm          , Mm          , Mm          , Hh          , Gg          , Ww          , Gg^Vh       , Ww          , Ds          , Ww          , Ds          , Ds          , Ww          , Ds          , Ww          , Wo          , Wo          , Wo          , Wo          , Wo          , Wo          , Wo          , Ww          , Ww          , Ds          , Ww          , Ww          , Wo          , Wo          
Mm          , Mm          , Mm          , Mm          , Gg^Em       , Gg          , Ww          , Ww          , Gg          , Gg          , Gg          , Ds          , Gg          , Gg          , Ds          , Ww          , Ww          , Ww          , Ww          , Wo          , Wo          , Wo          , Ww          , Wo          , Ww          , Gs          , Gs^Vh       , Ww          , Ww          , Wo          , Wo          
Mm          , Mm          , Mm          , Hh          , Ww          , Ww          , Ww          , Gg          , Gs          , Gs          , Gs          , Gs          , Gs          , Gg          , Gg^Vh       , Ds          , Ww          , Ww          , Ww          , Ww          , Ww          , Ww          , Ww          , Ww          , Ww^Bw/      , Gs          , Gs^Fp       , Gs          , Ww          , Wo          , Wo          
Mm          , Mm          , Ww          , Ww          , Hh          , Hh          , Gg^Em       , Gs          , Gs          , Gs          , Gs          , Gs          , Gs          , Gs          , Gg          , Ds          , Ww          , Ww          , Ww          , Ww          , Ww          , Ww          , Wo          , Ww          , Ww          , Ds          , Ww          , Gs^Fp       , Ww          , Wo          , Wo          
Mm          , Mm          , Mm          , Hh^Vhh      , Hh          , Hh          , Mm          , Gs          , Gs          , Gs          , Gs          , Gs          , Gs          , Gs          , Gg          , Ds          , Ww          , Ww          , Wo          , Wo          , Wo          , Wo          , Wo          , Wo          , Wo          , Ww          , Wo          , Ww          , Wo          , Wo          , Wo          
Mm          , Mm          , Mm          , Hh          , Hh          , Hh          , Mm          , Gs          , Gs          , Gs          , Gs          , Gs          , Gs          , Gs          , Gg          , Ds          , Ww          , Ww          , Wo          , Wo          , Wo          , Wo          , Wo          , Wo          , Wo          , Ww          , Wo          , Ww          , Wo          , Wo          , Wo          
