Mm, Mm, Mm, Mm, Mm, Mm, Mm, Mm, Mm, Mm, Mm, Mm, Hh, Hh, Gd, Rd, Rd, Gs, Gd, Gs, Gs, Rr, Gs, Gs, Gs, Gs, Hh, Mm, Mm, Mm, Mm, Mm, Mm, Mm, Mm, Mm, Mm, Mm, Mm, Mm, Mm, Mm, Mm, Mm
Mm, Mm, Mm, Mm, Mm, Mm, Mm, Mm, Mm, Mm, Mm, Mm, Hhd, Hhd, Gd, Rd, Rd, Gd, Gd, Gd, Gd, Rr, Gd, Gs, Gs, Gs, Hhd, Mm, Mm, Mm, Mm, Mm, Mm, Mm, Mm, Mm, Mm, Mm, Mm, Mm, Mm, Mm, Mm, Mm
Hh, Hh, Hh, Mm, Mm, Mm, Mm, Mm, Mm, Mm, Mm, Hhd, Hhd, Rd, Rd, Rd, Rd, Rd, Rd, Rd, Rd, Rr, Rd, Gs, Gs, Gs, Hhd, Hhd, Hh, Hh, Hh, Hh, Hh, Mm, Mm, Mm, Mm, Mm, Mm, Mm, Gs, Mm, Mm, Mm
Mm, Mm, Mm, Mm, Hh, Hh, Hhd, Mm, Hhd, Hhd, Hhd, Hhd, Rd, Gd, Rd, Rd, Gd, Rd, Gd, Rd, Rd, Rr, Rd, Gd, Rd, Rd, Gs, Gs, Gs, Gs, Gs, Rd, Gs, Hh, Mm, Mm, Mm, Mm, Gs, Gs, Gs, Mm, Mm, Mm
Mm, Mm, Mm, Mm, Hhd, Hhd, Gd^Vhh, Hhd, Hhd, Gd, Rd, Gd, Rd, Rd, Rd, Rd, Rd, Gd, Gd^Vc, Gd, Rd, Rr, Rd, Gs, Rd, Rd, Gd, Gd, Gd, Gd, Gd, Gs, Hh, Hh, Hh, Hh, Mm, Mm, Mm, Gs, Mm, Mm, Mm, Mm
Mm, Mm, Mm, Mm, Hhd, Gd, Gd, Gd, Rd, Rd, Rd, Chr, Chr, Rd, Rd, Rd, Rd, Rd, Gd, Gd, Rd, Rd, Rd, Gs, Gs, Gs, Gd^Fdw, Gd, Gd^Fdw, Gd^Fdw, Gll^Fmw, Gs, Gd, Hh, Re, Hh, Hh, Mm, Mm, Mm, Mm, Mm, Mm, Mm
Mm, Mm, Hh, Hh, Hh, Hhd, Hhd, Rd, Rd, Rd, Rd, Chr, Chr, Chr, Rd, Rd, Rd, Gd, Rd, Gd, Rr, Rr, Gs, Gs, Gd, Gs, Gll^Fdw, Gll^Fdw, Gd^Fmw, Gll^Fmw, Gd^Fmw, Gd^Fmw, Gd^Fmw, Gs, Gs, Gs, Gs, Hh, Hh, Mm, Mm, Mm, Mm, Mm
Hh, Hh, Gs, Hh, Gs, Gd, Rd, Gd, Rd, Rd, Chr, Chr, 4 Khr, Chr, Rd, Rd, Rd, Rd, Rd, Gd, Rr, Rr, Gs, Gd, Gd^Fdw, Gd, Gd^Fdw, Gll^Fmw, Gll^Fmw, Gll^Fmw, Gll^Fmw, Gll^Fmw, Gd^Fmw, Gd^Fdw, Gd, Gd, Gs, Hh, Hh, Hh, Hh, Mm, Mm, Mm
Hh, Hh, Hh, Gs, Gd, Rd, Gd, Gd, Gd, Rd, Gd, Chr, Chr, Chr, Rd, Rd, Rd, Gd, Gd, Gd, Rr, Gs, Gs, Gs, Gd^Fdw, Gll^Fdw, Gll^Fmw, Gll^Fmw, Gll^Fdw, Gd^Fmw, Gd^Fmw, Gll^Fmw, Gd, Gd^Fdw, Gd^Fdw, Gd, Gs, Hh, Hh, Hh, Hh, Mm, Mm, Mm
Hh, Hh, Gs, Gs, Gs, Gd, Gs^Vl, Gd, Gd, Rd, Rd, Rd, Gd, Gd, Gd^Vc, Gd, Rd, Rd, Rd, Rd, Rr, Gs, Gs, Gd, Gs, Gll^Fdw, Gd^Fdw, Gd^Fdw, Gd, Gd^Fdw, Gll^Fmw, Gd^Fdw, Gs, Gd, Gs, Gs, Gs, Gs, Gs, Gs, Hh, Hh, Mm, Mm
Gs, Gs, Gs, Gs, Gd, Gd, Gs, Gd, Rd, Rd, Rd, Rd, Rd, Gd, Gs, Gs, Rd, Rd, Gs, Gs, Gs, Rr, Gs, Gs, Gs^Vc, Gs, Gd, Gs, Gs, Gd^Fdw, Gd, Gd^Fdw, Gd^Fdw, Gd, Gs, Gs, Gs, Gs, Gs, Gs, Hh, Hh, Mm, Mm
Gs, Gs, Gs, Gs, Gs, Gs, Rd, Rd, Hhd, Rd, Gs, Gd, Rd, Gd, Gs, Gd, Gs, Rd, Rd, Gs, Gs, Rr, Rr, Gs, Gs, Gs, Gs, Gs, Gs, Gd, Gs, Gs, Gd, Gd^Fdw, Re, Gs, Gs, Gs, Gs, Gs, Hh, Hh, Mm, Mm
Gs, Gs, Gs, Gs, Gs, Gs, Gs, Hhd, Hhd, Hhd, Hhd, Rd, Gs, Rd, Gs, Rd, Gs, Rd, Gs, Rd, Gs, Gs, Gs, Rr, Gs, Gs, Gs, Gs, Gs, Gs, Gs, Gs, Gs, Gs, Gs, Gs, Gs, Gs, Hh, Hh, Hh, Mm, Mm, Mm
Gs, Gs, Gs, Gs, Gs, Hhd, Hh, Hh, Hh, Mm, Hh, Rd, Hh, Gs, Gs, Gs, Rd, Gs, Gs, Gs, Gs, Gs, Gs, Rd, Gs, Gs, Gs, Gs, Gs, Gs^Vl, Gs, Gs, Gs, Gs, Gs, Gs, Gs, Gs, Hh, Hh, Mm, Mm, Mm, Mm
Gs, Gs, Gs, Gs, Gs, Gs, Hh, Mm, Mm, Mm, Mm, Hh, Mm, Hh, Hh, Rd, Gs, Gs, Gs, Gs, Gs, Gs, Gs, Rr, Gs, Gs, Gs, Gs, Gs, Gs, Gs, Gs, Gs, Gs, Gs, Gs, Gs, Gs, Gs, Hh, Mm, Mm, Mm, Mm
Gs, Gs, Gs^Vh, Gs, Hh, Hh, Hh, Mm, Mm, Mm, Mm, Mm, Mm, Mm, Hh, Gs, Gs, Gs, Gs, Gs, Gs, Gs, Gs, Rr, Rd, Gs, Gs, Gs, Gs, Gs, Gs, Gs, Gs, Gs, Gs, Gs, Gs, Gs, Gs, Hh, Mm, Mm, Mm, Mm
Gs, Gs, Gs, Hh, Gs, Hh, Hh, Mm, Hh, Mm, Mm, Hh^Vhh, Mm, Hh, Gs, Gs, Rd, Gs, Gs, Gs, Gs, Gs, Gs, Rr, Rr, Gs, Gs, Gs, Gs, Re, Gs, Gs, Gs, Gs, Gs^Vh, Gs, Gs, Gs, Re, Hh, Mm, Re, Gs, Gs
Gs, Gs, Gs, Gs, Gs, Gs, Rd, Hh, Hh, Mm, Mm, Mm, Mm, Hh, Hh, Gs, Gs, Gs, Gs, Gs, Gs, Gs, Gs, Gs, Rr, Rd, Gs, Gs, Gs, Gs, Gs, Gs, Gs, Gs, Gs, Gs, Gs, Gs, Gs, Hh, Hh, Mm, Mm, Mm
Gs, Gs, Gs^Fmw, Gs^Fdw, Gll^Fdw, Gs^Fdw, Gs, Hh, Hh, Mm, Gs, Mm, Mm, Hh, Hh, Gs, Gs, Gs, Gs, Gs, Gs, Gs, Gs, Rr, Gs, Gs, Gs, Hh, Gs, Gs, Gs, Gs, Hh, Gs, Gs, Gs, Gs, Gs, Gs, Gs, Hh, Mm, Mm, Mm
Gs, Gs, Gs^Fmw, Gll^Fdw, Gll^Fdw, Gll^Fdw, Gs, Hh, Hh, Mm, Mm, Mm, Mm, Mm, Hh, Gs, Gs, Gs, Gs, Gs, Gs, Gs, Gs, Rr, Gs, Gs, Gs, Hh, Hh, Hh, Hh, Hh, Hh, Hh, Gs, Gs, Hh, Hh, Hh, Hh, Mm, Mm, Mm, Mm
Gs, Gll, Gll^Fmw, Gs^Fmw, Gs, Gs, Gs, Gs, Hh, Mm, Mm, Mm, Mm, Mm, Hh, Hh, Gs^Vh, Gs, Gs, Gs, Gs, Gs, Gs, Rr, Gs, Gs, Gs, Gs, Hh, Hh, Hh, Hh, Gs, Rb, Gs, Gs, Hh, Hh, Hh, Mm, Mm, Mm, Mm, Mm
Gll^Fmw, Gll^Fmw, Gll^Vh, Gs, Gs, Gs, Gs, Gs, Hh, Mm, Mm, Hh, Mm, Mm, Hh, Hh, Re, Gs, Gs, Gs, Gs, Gs, Rr, Rr, Gs, Gs, Gs, Gs, Gs, Hh, Hh, Hh, Gs, Gll^Vh, Gs, Gs, Hh, Hh, Hh, Hh, Mm, Mm, Mm, Mm
Gs, Gs, Gs, Gs, Gs, Gs, Gs, Gs, Hh, Mm, Hh, Mm, Mm, Mm, Hh, Hh, Gs, Gs, Gs, Gs, Rr, Rr, Gs, Gs, Gs, Gs, Gs, Gs, Gs, Gs, Gs, Gs, Gs, Gd, Gs, Gs, Gs, Gs, Hh, Hh, Hh, Mm, Mm, Mm
Gs, Gs, Gs, Gs, Gs, Gs, Gs, Gs, Gs, Hh, Hh, Mm, Hh, Hh, Gs, Gs, Gs, Gs, Re, Re, Rr, Gs, Gll^Fdw, Gll^Fdw, Gs, Gs, Gs, Gs, Gd, Gs, Gs, Gs, Gd, Gs, Gs, Gd, Gs, Gs, Gd, Hh, Hhd, Mm, Hh, Hh
Gs, Gs, Gs, Gs, Gs, Gs, Gs, Gs, Gs, Gs, Wwg, Hh, Gs, Gs, Gs, Gs, Re, Re, Gs, Gs, Rr, Gs, Gll^Fdw, Gll^Fdw, Gs, Gs, Gs, Gs, Gd, Gs, Gd, Rb, Gs, Gs, Gd, Gs, Gs, Gd, Gd, Gs, Hhd, Hh, Hhd, Hh
Gs, Gs, Gs, Gs, Gs, Gs, Gs, Gs^Vl, Wwg, Wwg, Wwg, Wwg, Gs, Gs, Re, Gs, Re, Gs, Gs, Gs, Rr, Gs, Gll^Fmw, Gll^Fmw, Gs^Fmw, Gs^Fdw, Gs, Gs, Gd, Gs, Gs, Gd, Gd, Gd, Gs, Gd, Rb, Gd, Gd, Gd, Rb, Hhd, Gd, Gs
Mm, Mm, Mm, Gs, Gs, Gs, Gs, Wwg, Wwg, Wwg, Wwg, Wwg, Gs, Re, Gs, Re, Re, Gs, Gs, Gs, Rr, Gs, Gs, Gll^Fmw, Gll^Fmw, Gs^Fmw, Gs, Gd, Gs, Gd, Gd, Gd, Rb, Gs, Gd, Gd, Gd, Rb, Rb, Rb, Gd, Gd, Gd, Gd
Mm, Mm, Mm, Mm, Mm, Gs, Gs, Wwg, Wwg, Wwg, Gs, Gs^Vc, Re, Re, Gs, Gs, Wwg^Bw|, Gs, Gs, Re, Gs, Rr, Gs, Gll^Fdw, Gs^Fdw, Gll^Fdw, Gd, Gs, Gs^Vl, Gd, Gd, Gd, Gd, Rb, Gd, Gd^Vh, Chr, Chr, Chr, Rb, Rb, Rb, Gd, Gd
Mm, Mm, Mm, Mm, Mm, Gs, Gs, Gs, Gs, Gs, Gs, Re, Gs, Gs, Wwg, Wwg, Ch, Wwg, Wwg, Gs, Gs, Rr, Rr, Gs^Vh, Gs, Gs, Gs, Gd, Gd, Gd, Gd, Gd, Gd, Gd, Gd, Rb, Chr, Chr, 3 Khr, Chr, Rb, Rb, Rb, Rb
Mm, Mm, Mm, Mm, Mm, Gs, Gs, Gs, Gs, Gs, Gs, Re, Re, Wwg, Wwg^Bw/, Ch, Ch, Ch, Ch, Wwg, Gs^Vh, Gs, Rr, Gs, Gd, Gs, Re, Gs, Gd, Gd, Rb, Gd, Gd, Gd, Rb, Rb, Rb, Chr, Chr, Chr, Rb, Rb, Rb, Rb
Mm, Mm, Mm, Mm, Gs, Gs, Gs, Gs, Gs, Gs, Gs, Re, Gs, Re, Wwg, Ch, Ch, 1 Kh, Ch, Ch, Wwg, Gs, Rr, Gs, Gs, Gs, Gd, Gs, Gd, Gd, Gd, Gd, Gd, Gd, Rb, Rb, Gd, Chr, Rb, Chr, Rb, Rb, Rb, Rb
Mm, Mm, Mm, Gs, Gs, Gs, Gs, Re, Gs, Gs, Gs, Re, Gs, Gs, Wwg, Ch, Ch, Ch, Wwg, Wwg, Gs, Gs, Rr, Gs, Gs, Gs, Rb, Gd, Gd, Gd, Gd, Rb, Gd, Rb, Gd, Gd, Gd, Gd, Rb, Rb, Gd, Gd, Gd, Gd
Mm, Mm, Mm, Gs, Gs, Gs, Gs, Gs, Gs, Gs, Gs, Re, Re, Gs, Gs, Wwg, Wwg, Wwg^Bw\, Re, Gs, Re, Rr, Rr, Gs, Gd, Re, Rb, Gs, Gd, Gd, Gd, Gd, Rb, Gd, Rb, Gd, Gd, Rb, Gd, Gd, Rb, Rb, Rb, Rb
Mm, Mm, Mm, Mm, Gs, Gs, Gs, Gs, Gs, Gs, Gs, Gs, Re, Gs, Gs, Gs, Gs, Gs^Vh, Re, Re, Gs, Gs, Rr, Gs, Gs, Rb, Gd, Gd, Rb, Gs, Gd, Gs, Rb, Gd, Gs, Gd, Rb, Gd, Rb, Gd, Gd, Gd, Rb, Rb
Mm, Mm, Mm, Mm, Hh, Gs, Gs, Gs, Gs, Gs, Gs, Gs, Gs, Re, Re, Gs, Re, Gs, Re, Gs, Gs, Rr, Re, Gs, Gd, Gd, Gs, Gd, Gs, Gd, Gd, Gd, Gd, Gs, Gd, Gd, Gd, Gd, Gd, Gd, Gd, Rb, Gd, Gd
Mm, Mm, Mm, Mm, Mm, Mm, Hh, Gs, Gs, Gs, Gs, Gs, Gs^Vl, Gs, Gs, Re, Gs, Re, Re, Gs, Gs, Rr, Re, Gs, Gs, Gs, Gd, Gd, Gd, Gs, Gd, Gd, Gd^Vh, Gd, Gd, Gd, Gd, Gs, Gd, Gd, Gd, Gd, Rb, Rb
Mm, Mm, Mm, Hh, Hh, Hh, Hh, Hh, Hh, Gs, Gs, Gs, Gs, Gs, Re, Gs, Gs, Gs, Gs, Re, Re, Rr, Gs, Gs, Gd, Gs, Gs, Gs, Rb, Gd, Gd, Gd, Hhd, Gd, Gd, Gd, Gs, Rb, Gs, Gd, Gd, Rb, Gd, Gs
Mm, Mm, Mm, Mm, Hh, Hhd, Hh, Hh, Hhd, Hh, Hh, Gs, Gs, Gs, Gs, Gs, Gs, Gs, Gs, Gs, Gs, Re, Gs, Gs, Gs, Gd, Gd, Gd, Hhd, Hhd, Hhd, Hhd, Hhd, Gd, Gd, Gd, Gs, Rb, Gs, Gd, Gs, Gd, Gd, Gs
Mm, Mm, Mm, Mm, Hh, Hhd, Hhd, Hhd, Hhd, Hh, Hh, Hhd, Re, Gs, Gs, Gs, Gs, Gs, Gs, Gs, Gs, Rr, Rr, Gs, Gs, Gs, Gs, Gd, Gd, Hhd, Hhd, Hhd, Hhd, Hhd, Rb, Gd, Gd, Gs, Gd, Gs, Gd, Gs, Gs, Gs
Mm, Mm, Mm, Hh, Hh, Hh, Hhd, Hhd, Hhd, Hhd, Hhd, Hhd, Re, Gs, Gs, Gs, Gs, Gs^Vh, Gs, Gs, Re, Gs, Rr, Gs, Gs, Gd, Gs, Gd, Gd, Re, Gd, Hhd, Hhd, Hhd, Gd, Gd, Gd, Gs, Gs, Gs, Hh, Hh, Hh, Hh
Hh, Hh, Hh, Hh, Hh, Hh, Hh, Hhd, Hhd, Hhd, Hhd, Hhd, Re, Re, Re, Gs, Gs, Gs, Gs, Re, Gs, Gs, Rr, Gs, Gs, Gs, Gs, Gs, Gs, Gs, Gd, Re, Hhd, Hhd, Gd, Gs, Gs, Gd, Gs, Gd, Hh, Mm, Hh, Hh
Hh, Hh, Hhd, Hhd, Hhd, Hhd, Hhd, Hhd, Hhd, Re, Re, Re, Gs, Gs, Re, Gs, Re, Re, Re, Gs, Gs, Gs, Rr, Gs, Gs, Gs, Gs, Gll^Vl, Gs, Gs, Gs, Re, Gd, Gd, Gs, Gs, Rb, Gs, Gs, Hh, Hh, Mm, Mm, Mm
Hh, Hhd, Hhd, Hhd, Hhd, Hhd, Hhd, Hhd, Rr, Rr, Re, Re, Re^Vh, Gs, Gs, Gs, Re, Re, Re, Gs, Gs, Gs, Rr, Gs, Gs, Gs, Gs, Gs, Gs, Gs, Gs, Gs, Gs, Gs, Gs, Gs, Gs, Gs, Gs, Hh, Hh, Mm, Mm, Mm
Hh, Hh, Hh, Hh, Hhd, Hhd, Hhd, Hhd, Hhd, Rr, Rr, Re, Rr, Re, Re, Re, Re, Re, Gs, Gs, Gs, Gs, Rr, Gs, Gs, Gs, Gs, Gs, Gs, Gs, Gs, Gs, Gs, Gs, Gs, Gs, Gs, Gs, Hh, Hh, Mm, Mm, Mm, Mm
Hh, Hh, Hh, Hhd, Hhd, Hhd, Hhd, Hhd, Hhd, Rr, Hhd, Rr, Hhd, Hhd, Hhd, Hhd, Gs, Re, Re, Gs, Re, Gs, Rr, Gs, Gs, Gs, Gs, Gs, Gs, Gs, Gs, Gs, Gs, Gs, Gs, Gs, Gs, Gs, Hh, Hh, Mm, Mm, Mm, Mm
Hh, Hh, Mm, Hh, Hhd, Chr, Chr, Hhd, Chr, Chr, Hhd, Hhd, Hh, Hh, Hh, Hh, Hh, Re, Re, Gs, Gs, Re, Gs, Gs, Gs, Gs, Gs, Gs, Gs, Gs, Gs, Gs, Gs, Gs, Gs, Re, Hh, Hh, Hh, Hh, Mm, Mm, Mm, Mm
Mm, Mm, Mm, Hh, Hhd, Chr, Chr, Chr, 2 Khr, Hhd, Hhd, Hhd, Hhd, Hh, Hh, Hh, Hh, Gs, Gs, Re, Gs, Rr, Gs, Re, Gs, Gs, Gs, Gs, Gs, Re, Gs, Gs, Gs, Gs, Hh, Hh, Hh, Hh, Hh, Mm, Mm, Hh, Mm, Mm
Mm, Mm, Mm, Mm, Mm, Hhd, Hhd, Chr, Hhd, Hhd, Hhd, Hh, Hh, Hh, Hh, Hh, Gs, Re, Gs, Gs, Gs, Rr, Gs, Gs, Gs, Gs, Gs, Gs, Gs, Gs, Gs, Gs, Gs, Hh, Hh, Hh, Hh, Hh, Hh, Mm, Mm, Mm, Mm, Mm
Mm, Mm, Mm, Mm, Mm, Mm, Mm, Hhd, Hh, Hhd, Hh, Hh, Hh, Hh, Hh, Hh, Gs, Gs, Gs, Gs, Rr, Rr, Gs, Gs, Gs, Gs, Gs, Gs, Gs, Gs, Gs, Gs, Hh, Hh, Mm, Mm, Mm, Hh, Hh, Hh, Mm, Mm, Mm, Mm
Mm, Mm, Hh, Mm, Mm, Mm, Mm, Mm, Hh, Hh, Hh, Mm, Mm, Hh, Hh, Gs, Gs, Gs, Gs, Gs, Rr, Gs, Gs, Gs, Gs, Gs, Gs, Gs, Gs, Gs, Gs, Gs, Hh, Hh, Mm, Mm, Mm, Mm, Mm, Mm, Mm, Mm, Mm, Mm
Mm, Mm, Mm, Hh, Mm, Mm, Mm, Mm, Mm, Hh, Mm, Mm, Mm, Mm, Hh, Hh, Gs, Gs, Gs, Gs, Rr, Gs, Gs, Gs, Gs, Gs, Gs, Gs, Gs, Gs, Gs, Gs, Hh, Hh, Mm, Mm, Hh, Mm, Mm, Mm, Mm, Mm, Mm, Mm
Mm, Mm, Mm, Hh, Mm, Mm, Mm, Mm, Mm, Hh, Mm, Mm, Mm, Mm, Hh, Hh, Gs, Gs, Gs, Gs, Rr, Gs, Gs, Gs, Gs, Gs, Gs, Gs, Gs, Gs, Gs, Gs, Hh, Hh, Mm, Mm, Hh, Mm, Mm, Mm, Mm, Mm, Mm, Mm
