Wo, Wo, Wo, Wo, Wo, Wo, Wo, Wo, Wo, Ww, Ww, Ww, Wwr, Wwr, Ds, Gs^Fms, Gs^Fp, Gs^Fms, Ss, Ss, Gs^Fms, Gs, Rb^Gvs, Rb^Gvs, Rb^Gvs, Gs, Re, Gs, Ss, Ss, Gs, Re, Gs, Ss^Vhs, Ss, Ss, Gg, Gg, Gg, Gg, Gg^Efm, Gg, Gg, Gg, Gg, Gll^Fmw, Gll^Fmw, Gs^Ftr, Gs^Ftr, Gs^Ftr, Gg, Gg, Gs^Fmw, Gll^Fp, Gll^Ftr, Gg, Gs^Ftr, Gll^Fp, Gg, Gll^Fp
Wo, Wo, Wo, Ww, Ww, Wwr, Ww, Wo, Wo, Ww, Wo, Ww, Ww, Ds, Ds, Gg, Gg, Gs^Fms, Gs, Sm, Rb^Gvs, Rb^Gvs, Re^Gvs, Rb^Gvs, Re^Vhr, Re, Gs, Gs, Ss, Ss, Ss, Gs, Gs, Gs, Gs, Ss, Gg^Efm, Gg, Gg^Efm, Gg^Efm, Gg, Gg, Re, Re, Gg, Gs, Gg, Gg^Fmw, Gs^Fmw, Gg^Fmw, Gg^Fp, Gg^Fp, Gll^Fmw, Gs^Ftr, Gll^Fmw, Gll^Ftr, Gll^Fmw, Gll^Fp, Gg^Fp, Gg^Fmw
Wo, Wo, Wo, Wo, Wo, Wwr, Wwr, Wo, Wo, Wo, Wo, Ww, Ww, Ds, Ds, Gg, Gs, Gs, Sm, Sm, Ss, Re^Gvs, Gs, Gs, Re, Gs, Gg, Gs, Ss, Ss, Gs, Gs, Gs, Re, Gs, Gs, Gg^Efm, Gg^Efm, Gg, Gg, Gg, Gll, Gll, Gg, Gs, Gs, Gll, Gg^Fmw, Gs, Gll, Gll, Gll^Fp, Gs^Fp, Gll^Fp, Gg, Gll^Fp, Gll^Fp, Gg, Gs, Gg
Wo, Wo, Wo, Wo, Wo, Ww, Ww, Ww, Ww, Wo, Wo, Ww, Wo, Ww, Ww, Gg, Gs, Ss, Ss, Gg, Gg, Ss, Gg, Gg, Gg, Gg, Gg, Gg, Gg, Gs, Gs, Gs, Re, Gs, Gs^Efm, Gs^Efm, Gg^Efm, Gg, Re, Re, Gg, Gg, Gg, Gg, Gg, Gs, Gll^Fmw, Gg, Gs, Gs, Gg, Gs, Gg, Gg, Gs, Gs, Gll, Gs, Gll, Gs
Wo, Wo, Wo, Wo, Wo, Wo, Wo, Ww, Wwr, Ww, Wo, Wo, Wo, Wo, Wo, Ww, Ww^Es, Ss, Gg, Gg, Gg, Gg, Gg, Gg, Ss, Gg, Gg, Gg, Gg, Gg^Fmw, Gg^Fp, Re, Gg, Gg^Efm, Gg^Efm, Gg, Gg, Gg, Rb, Rb, Gg^Fmw, Gs^Vl, Gg^Fmw, Gg, Hh, Gg^Qhh, Gg^Qhh, Gg, Gll^Qhhf, Gs, Gg^Fp, Gg^Fp, Gs, Gs, Gs, Gll, Gs, Gll, Gg^Ve, Gll
Wo, Wo, Wo, Wo, Wo, Wo, Wo, Wo, Wo, Wo, Wo, Ww, Wo, Wo, Wo, Ww, Ww, Gs, Gg, Gg, Gg, Ss, Ss, Cer, 6 Ker, Cer, Sm, Gg, Gg, Gs^Vl, Gg^Fmw, Re, Re, Gg, Gg, Gg, Re, Re, Gg, Gg, Gg^Fmw, Gg^Fmw, Gg^Fp, Gg^Es, Hh, Hh, Hh^Qhh, Gg^Qhh, Ss, Gll^Qhh, Gg^Qhh, Gg, Gll^Fp, Gg, Gll^Fp, Gll^Fp, Gll^Fp, Gll^Fp, Gll^Fmw, Gll^Qhhf
Wo, Wo, Wo, Wo, Wo, Wo, Wo, Wo, Wo, Wo, Wo, Wo, Wo, Wo, Wo, Ww, Ww, Ww, Ww, Sm, Sm, Ss, Ss, Cer, Ss, Ss, Cer, Sm, Ss, Gg, Gg, Gg, Gg, Gg, 5 Ker, Cer, Rb^Gvs, Rb^Gvs, Rb^Gvs, Gg, Gg, Gg^Fp, Gg, Gs, Hh^Es, Hh, Hh^Qhh, Ss, Ss, Ss, Sm, Gs^Qhh, Gs^Qhh, Gll^Qhh, Gll^Qhh, Gll^Fp, Gg^Qhh, Gll^_mh, Gg^Qhh, Gg^Qhh
Wo, Wo, Wo, Wo, Wo, Wo, Wo, Wo, Wo, Wo, Wo, Wo, Wo, Wo, Wo, Wo, Wo, Ww, Ww, Ww, Ss, Ss, Ww, Ss, Sm, Gg, Gg, Gg, Gg, Gg, Gg^Efm, Gg^Efm, Gg, Cer, Re, Cer, Cer, Rb^Gvs, Rb^Gvs, Rb^Gvs, Rb^Gvs, Gs, Hh^Qhh, Hh^Qhh, Hh^Qhh, Hh^Qhh, Sm, Hh^Qhh, Sm, Ss, Sm, Sm, Ss, Ss, Ss, Gs^Qhh, Sm, Gll^Qhh, Ss, Ss
Wo, Wo, Wo, Wo, Wo, Wo, Wo, Wo, Wo, Wo, Wo, Wo, Wo, Wo, Wo, Wo, Wo, Wo, Wo, Ww, Ww, Ss, Ww, Sm, Ww, Sm, Sm, Gg, Gg, Gg^Efm, Gg, Gg^Efm, Re, Rb, Chr, Sm^Vhr, Sm, Sm, Rb^Gvs, Rb^Gvs, Ww, Gg, Sm, Ss, Ww, Sm, Sm, Ww^Es, Ww, Sm, Ww, Sm, Sm, Ss, Sm, Sm, Sm, Sm, Sm, Sm
Ww, Wo, Wo, Wo, Wo, Wo, Wo, Wo, Ww, Wo, Wo, Wo, Wo, Wo, Wo, Wo, Wo, Wo, Wo, Ww, Ww, Ww, Ww, Ww, Ww, Ww, Ww, Ww^Es, Ww, Gg, Ww, Gg, Gs^Vhr, Re, Chw, Chw, Wwr, Ww, Ww, Ww, Ww, Ww, Ww, Ww, Ww, Ww, Ww, Ww, Ww, Ww, Ww, Ww, Ww, Sm, Sm, Ss, Sm, Ss, Ss, Sm
Wo, Ww, Ww, Ww, Ww, Ww, Wo, Wo, Ww, Ww, Ww, Ww, Wo, Wo, Wo, Ww, Ww, Ww, Ww, Ww, Ww, Ww, Ww, Wwr, Ds, Ww, Ww, Ww, Wo, Ww, Wo, Chr^Dr, Rb, Re, Re, Wwr, Wwr, Ww, Ww, Ww, Ww, Ww, Ww, Ww, Ww, Ww, Ww, Ww, Ww, Ww, Ww, Ww, Ww, Sm, Ww, Sm, Sm, Ss, Sm, Sm
Wo, Wo, Ww, Ww, Ww, Ww, Wo, Wo, Ww, Ww, Wwr, Ww, Re^Gvs, Wwr, Re^Eff, Ww, Ww, Ww, Ww^Bw\, Ww, Ch, Ww, Wo, Ww, Ww, Ds^Ewsh, Wo, Ww, Ww, Wo, Wo, Wo, Wo^Bw/, Rb, Wo, Wo, Wo, Ww, Ww, Ww, Wo, Ww, Wo, Wo, Wo, Wo, Wo, Ww, Wo, Wo, Wo, Ww, Ww, Ww, Ww, Ww, Ww, Ww, Ww, Wo
Wo, Wo, Ww, Ww, Wo, Ww, Wo, Ww, Ww, Ww, Re^Gvs, Re^Gvs, Re^Gvs, Re^Gvs, Rb^Gvs, Re^Eff, Rb^Eff, Ww^Bw\, Gs, Re^Vhc, Rr^Edt, Ww, Ww, Ww, Ww, Ww, Ww, Ww, Ds, Ww, Ww^Bw/, Wo^Bw/, Wo, Wo, Wo, Wo, Wo, Wo, Wo, Wo, Wo, Wo, Wo, Wo, Wo, Wo, Wo, Wo, Wo, Wo, Wo, Wo, Wo, Wo, Wo, Ww, Ww, Ww, Ww, Ww
Wo, Wo, Wo, Wo, Wo, Wo, Wo, Wo, Wo, Ds, Re^Gvs, Re^Gvs, Rb^Vh, Rb^Gvs, Rb^Gvs, Rb^Gvs, Gd^Eff, Gd^Eff, Re, Rr^Edt, Ww^Bsb\, Ww, Ww, Ds, Ds, Ww, Re^Ebn, Re^Vhc, Rr^Edt, Rr, Ch^Edt, Wo, Wo, Wo, Wo^Qhu, Wo^Qhu, Wo^Qhu, Wo^Qhu, Wo^Qhu, Wo, Wo, Wo, Wo, Wo, Wo, Wo, Wo, Wo, Wo, Wo, Wo, Wo, Wo, Wo, Wo, Wo, Wo, Ww, Wo, Ww
Wo, Wo, Wo, Wo, Wo, Wo, Wo, Wo, Wo, Ds, Ds, Re^Gvs, Ds, Rb, Rb, Gd^Vh, Gd, Gs, Ds, Ww^Edt, Ww, Ww^Bsb\, Re, Ds^Esd, Rb^VjA, Gs^VjB, Rr^Edt, Rr, Ch, Ch^Dr, Ch, Ww^Qhu, Ww^Qhu, Wo^Qhu, Mm, Hh, Mm^Xm, Wo^Qhu, Wo^Qhu, Wo^Qhu, Wo, Wo, Wo, Wo, Wo, Wo, Wo, Wo, Wo, Wo, Wo, Wo, Wo, Wo, Wo, Wo, Wo, Wo, Wo, Wo
Wo, Wo, Wo, Wo, Wo, Wo, Wo, Wo, Wo, Wo, Ww, Ww, Ds, Ds, Ww^Bw/, Rb, Wo, Ds, Wo, Wo, Ww, Ww, Gg^Fds, Rr, Rr, Rr, Gs^Vhc, Re^VjE, Hh, Mm, Hh, Mm, Mm, Mm, Mm, Mm, Mm, Mm, Wo^Qhu, Wo^Qhu, Wo^_ml, Wo, Wo, Wo, Wo, Wo, Wo, Wo, Wo, Wo, Wo, Wo, Ww, Wo, Wo, Wo, Wo, Wo, Wo, Wo
Wo, Wo, Wo, Wo, Wo, Wo, Wo, Wo, Ww, Ww, Ds^Esd, Ww^Ewf, Ww, Ww, Wo, Wo, Wo, Wo, Ww, Ww, Hh^Fds, Hh^Fds, Gg^Fds, Gg, Rr, Rr, Rr, Rr, Rr, Hh, Rr, Hh, Hh, Hh, Hh, Hh, Ww^Qhu, Wwr^Qhu, Wo, Wo, Wo^Qhu, Wo, Wo, Wo, Wo, Wo, Wo, Wo, Wo, Wo, Wo, Wo, Wo, Ww, Ww, Ww, Ww, Wo, Wo, Wo
Wo, Wo, Wo, Wo, Wo, Wo, Wo, Ww, Ww, Ds, Ww, Ds^Esd, Wo, Wo, Wo, Wo, Wo, Ww^Bw\, Ch^Edt, Rr^Vhc, Ch, Hh^Fds, Rr, Rr, Rb^VjA, Rb^VjA, Re^VjB, Re^VjC, Rr, Rr, Gs^Xo, Rr^Vhc, Mm, Mm, Hh, Wwr^Qhu, Wo, Wo, Wo^Qhu, Wo^Qhu, Wo, Wo, Ww, Wo, Ww, Wo, Wo, Ww, Ww, Wo, Wo, Wo, Wo, Wo, Wo, Ww, Ww, Ww, Wo, Wo
Wo, Wo, Wo, Wo, Wo, Wo, Wo, Wo, Ww, Ww, Wo, Ww, Wo, Wo, Wo, Wo, Wo, Wo^Bw\, Ch, Kh, Rr, Rr, Rr^Edt, Re^Vhc, Hh, Gs^VjA, Hh^Edt, Gs^VjA, Ch^Edt, Gs, Hh, Hh^Fds, Hh^Fds, Hh^Fds, Wwr^Qhu, Wwr^Qhu, Wo, Wo^Qhu, Wo, Wo, Ww, Ww, Ww^Qhu, Ww^Qhu, Ww^Qhu, Ww, Ww^Qhu, Ww, Ww, Ww, Wo, Wo, Wo, Wo, Wo, Wo, Wo, Wo, Wo, Wo
Wo, Wo, Wo, Wo, Wo, Wo, Wo, Wo, Wo, Wo, Wo, Wo, Wo, Wo, Wo, Wo^Bw\, Ch^Edt, Kh, Ch, Ch, Rr, Gs^Ebn, Ch^Edt, Rr^Edt, Rr, Hh, Ww, Ch, Ww, Gg, Gg, Gg, Wo^Qhu, Ww^Qhu, Wo, Wo, Wo, Wo, Ww, Ww, Ww^Qhu, Ww^Qhu, Hh, Hh, Gg, Ww^Qhu, Gg^Es, Ww^Qhu, Ww^Qhu, Ww, Ww, Wo, Wo, Wo, Wo, Wo, Wo, Wo, Wo, Wo
Wo, Wo, Wo, Wo, Wo, Wo, Wo, Wo, Wo, Wo, Wo, Wo, Wo, Wo, Ww, Ww^Edt, Wwr, Rr^VjB, Wo, Rr^Vhc, Wo, Rr, Ww^Bsb\, Ww, Ww, Ww^Bsb\, Rr, Wo, Wo, Ww, Wo, Wo^Qhu, Wo, Wo, Wo, Wo, Wo, Ww, Ww^Qhu, Ww^Qhu, Hh^Es, Hh, Hh, Hh^Es, Gg, Hh, Hh, Hh, Gg, Ww^Qhu, Ww^Qhu, Wo, Wo, Wo, Wo, Wo, Wo, Wo, Wo, Wo
Wo, Wo, Wo, Wo, Wo, Wo, Wo, Wo, Wo, Wo, Wo, Wo, Wo, Wo, Wo, Wo, Wo, Wo, Wo, Wo, Wo, Ww, Rr^Vhc, Rr, Rr, Re^Ebn, Re^Vhc, Rr^Edt, Rr^Edt, Ch^Edt, Ww, Wo^Qhu, Wo, Wo, Wo, Wo, Ww^Qhu, Ww^Qhu, Hh^Fds, Hh, Hh^Edt, Hh^Es, Hh, Hh^Fds, Gg^Fds, Gg, Hh, Hh^Fds, Hh^Fds, Gg^Fds, Gg^Fds, Ww^Qhu, Ww^Es, Wo, Wo, Wo, Wo, Wo, Wo, Wo
Wo, Wo, Ww, Ww, Wo, Wo, Wo, Wo, Wo, Wo, Wo, Wo, Wo, Wo, Ww, Wo, Wo, Wo, Ww, Wo, Ds, Rr^VjD, Rr^VjE, Re^Edt, Rr^Vhc, Rr, Rr, Gs^VjE, Ww^Edt, Ww^Bsb\, 4 Ww^Bsb\, Wo, Wo, Wo, Wo, Ww, Ww^Qhu, Gg^Fms, Gg^Fms, Gg^Fds, Gg, Ce^Edt, Ce, Gg^Fms, Gg^Fds, Gg^Fms, Gg^Fms, Hh, Hh, Hh^Fds, Hh^Fds, Ww^Qhu, Ww^Qhu, Ww, Ww^Qhu, Wo, Wo, Wo, Wo, Wo
Wo, Wo, Wo, Ds, Ww, Ww, Wo, Wo, Ww, Wo, Ww, Wo, Ww, Wo, Wo, Wo, Ww, Wo, Ww, Wwr, Wwr, Ds^Esd, Wwr^Edt, Ds, Wwr, Ch, Ww, Ww^Bsb\, Ww^Dr, Ww^Edt, Ww, Wo^Bsb\, Wo^Bsb\, Wo, Ww^Qhu, Ww, Ww^Qhu, Hh, Gg^Fds, Gg^Fds, Ce, Ke, Gg^Fms, Gg^Fms, Hh, Hh^Fds, Hh^Fds, Hh^Es, Hh, Hh, Gg, Hh^Es, Hh, Ww^Qhu, Ww^Qhu, Ww^Qhu, Ww^Qhu, Ww^Qhu, Ww^Qhu, Ww^Qhu
Wo, Wo, Wo, Wo, Wo, Wo, Ww, Ww, Ds, Ww, Wwr, Ww, Ww, Ww, Ww, Ww, Wwr, Ww, Ww, Wwr, Ww, Ww^Edt, Ww, Wwr, Wwr, Wwr, Wo, Wo, Wo, Wo^Bsb\, Wo^Bsb\, Wo, Ww^Edt, Ww^Dr, Re, Ww^Qhu, Re, Hh, Hh, Gg, Gg, Ce^Edt, Gg, Chr^Edt, Rb^Gvs, Rb^Gvs, Re^Gvs, Gg, Re, Hh, Gg, Hh^Es, Hh, Hh, Hh, Ww^Qhu, Ww^Qhu, Ww^Qhu, Ds^Qhu, Ww^Qhu
Wo, Wo, Wo, Wo, Wo, Wo, Wo, Wo, Ww, Ds^Ewsh, Ww, Gs, Gs, Ww, Ww, Ww, Ww, Wwr, Ww, Ww, Ww, Ww, Ww, Ww, Ww, Wo, Ww, Wo^Edt, Ww, Ww, Ww, Ww^Bsb\, Re, Gg, Re, Re, Re^Edt, Re, Gg^Fds, Gg^Fms, Gg, Gg^Edt, Gg^Edt, Rb^Gvs, Rb^Gvs, Rb^Gvs, Rb^Gvs, Re^Gvs, Re^Gvs, Re^Eff, Gg^Eff, Gg, Gg^Eff, Gg^Vh, Rb^Gvs, Hh, Gg, Ds^Qhu, Gg, Ds^Qhu
Wo, Wo, Wo, Wo, Wo, Wo, Wo, Wo, Wo, Ww, Ww, Wwr, Ds^Vht, Ds, Ds, Ww, Ww, Ww, Ww, Wo, Wo, Ww, Ww, Ww, Ww, Wwr, Ww, Ww, Ww, Ww, Ww, Gg, Gs^Edt, Re, Chr, Chr^Dr, Re, Re^Edt, Rb, Gg^Fms, Re, Gg, Gg, Rb^Gvs, Rb^Gvs, Rb^Gvs, Re^Gvs, Re^Gvs, Re^Gvs, Re^Gvs, Gg^Eff, Gg^Eff, Rb^Gvs, Rb^Gvs, Rb^Gvs, Rb^Gvs, Rb^Gvs, Gg, Gg, Gg
Wo, Wo, Wo, Wo, Wo, Wo, Wo, Wo, Ww, Wo, Wo, Ww, Ww, Ds^Esd, Ds^Esd, Gs, Gd^Vc, Gs, Gd, Ww, Ww, Ww, Gs, Wwr, Wwr, Ww^Edt, Ww, Ww, Re^Vhr, Ww, Re, Re^Dr, Re^Edt, Re, Re^Edt, Ch, Gg, Rb, Rb, Re, Re, Re, Re, Re, Re, Rb^Gvs, Rb^Gvs, Re^Gvs, Gg^Eff, Gg^Eff, Re, Re^Gvs, Re^Gvs, Rb^Gvs, Rb^Gvs, Rb^Gvs, Rb^Gvs, Rb^Gvs, Rb^Gvs, Gg
Wo, Wo, Wo, Wo, Wo, Wo, Wo, Wo, Ww, Ww, Ww, Wo, Wo, Ww, Ds, Gd, Gs^Es, Gd, Gs, Gs, Wwr, Re^Dr, Re, Ch^Edt, Ch, 3 Ch^Kov, Chr^Edt, Gs, Re^Edt, Re, Gs^Ecf, Re^Edt, Gg^Fms, Gs, Re, Re, Gg, Gg, 2 Ch^Kov, Re, Gg, Re, Re, Re, Rb, Re, Re, Gg^Fds, Gg^Fds, Re, Re^Gvs, Re^Gvs, Re^Gvs, Re^Gvs, Re^Gvs, Rb^Gvs, Re^Gvs, Re^Gvs, Rb^Gvs, Rb^Gvs
Wo, Wo, Wo, Wo, Wo, Wo, Wo, Wo, Wo, Wo, Wo, Wo, Ww, Ww, Ww, Ds, Ww, Wwr, Ww, Wwr, Re^Vhr, Re, Re, Gg, Gg^Edt, Chr, Re, Re, Gg, Gs^Edt, Re, Re, Gg^Fds, Gg^Fds, Gs^Edt, Re, Re, Re^Vhr, Ch, Ch^Edt, Gs, Gs, Gs, Gs, Gg^Vhr, Re, Re, Re^Edt, Re, Gg^Fds, Gg^Fds, Re^Gvs, Re^Gvs, Re^Gvs, Re^Gvs, Re^Gvs, Re^Gvs, Re^Gvs, Re^Gvs, Rb^Gvs
Wo, Wo, Wo, Wo, Wo, Wo, Wo, Wo, Ww, Wo, Wwr, Wo, Ww, Wo, Ww, Ww, Wwr, Ww^Edt, Chr, Ww, Gg, Gg^Edt, Re, Gs^Ecf, Gg^Edt, Gg^Edt, Rb^Gvs, Gg, Rb^Gvs, Re^Vh, Gg, Gg^Fms, Chr, Re^Edt, Re, Re^Ecf, Gg, Gg, Gs, Gs^Edt, Gg^Edt, Gg^Edt, Gs, Gs^Edt, Rb^Gvs, Gg^Fds, Gg^Fms, Re, Re, Re, Re, Gg^Fms, Gg^Fms, Re^Gvs, Gg^Eff, Re^Gvs, Re^Gvs, Re^Gvs, Re^Gvs, Rb^Gvs
Wo, Wo, Wo, Wo, Wo, Wo, Wo, Ch, Rr, Ww, Gg, Re^Vhc, Gg^Fms, Gg, Ww, Wwr, Dd^Esd, Ds^Edt, Ds^Es, Ds, Re, Re, Re^Gvs, Re^Gvs, Rb^Gvs, Re^Gvs, Re^Gvs, Rb^Gvs, Re^Gvs, Rb^Gvs, Rb^Gvs, Gg, Gs, Gs^Vh, Gs, Gs, Gs, Gg, Gg, Gs, Re^Gvs, Re^Gvs, Re^Gvs, Rb^Gvs, Rb^Gvs, Rb^Gvs, Rb^Gvs, Gg^Fms, Gg, Rb, Rb, Re, Re, Gg^Fds, Gg^Fds, Gg^Eff, Gg^Vwm, Re^Gvs, Re^Gvs, Rb^Gvs
Wo, Wo, Ww, Wo, Wo, Wo, Ww^Bw/, Re^Vhc, Rr, Gg, Gs, Gs, Gs, Gg^Fms, Gg^Fds, Wwr, Dd, Ds^Es, Gg^Fds, Re, Re^Gvs, Re^Gvs, Rb^Gvs, Rb^Gvs, Rb^Gvs, Rb^Gvs, Re^Gvs, Re^Gvs, Re^Gvs, Re^Gvs, Re^Gvs, Rb^Gvs, Gs^Eff, Gs, Gs, Gs, Gg, Gg, Re^Gvs, Re^Gvs, Re^Gvs, Re^Gvs, Rb^Gvs, Rb^Gvs, Re^Gvs, Re^Gvs, Rb^Gvs, Rb^Gvs, Rb^Gvs, Gg, Gg, Rb, Re^Edt, Re, Re, Re, Re, Gg^Eff, Gg^Eff, Re^Eff
Wo, Ww, Ww, Ww, Wo, Wo, Ww, Ww^Bw/, Gs, Rr, Gd, Gd, Ds, Gg^Fms, Gg^Fds, Gg, Gg^Fms, Gs, Gg^Fds, Gg, Gg, Rb^Gvs, Rb^Gvs, Rb^Gvs, Gg, Re^Gvs, Re^Gvs, Re^Gvs, Re^Gvs, Re^Gvs, Gg^Eff, Gs^Eff, Gg^Edt, Gs, Rb^Gvs, Gg, Gg, Gg, Re^Gvs, Re^Gvs, Re^Gvs, Re^Gvs, Re, Re^Gvs, Re^Gvs, Re^Gvs, Rb^Gvs, Rb^Gvs, Gg^Vh, Gg, Gg, Gg, Gg, Re, Re, Re, Re, Re, Re, Gg^Eff
Ww, Ww, Ww, Ww, Wo, Wo, Ww, Ww, Re, Gs, Gs, Dd^Esd, Ds, Ds, Gg, Gg^Fds, Gg, Gg^Fms, Gg, Gg^Fds, Gs^Fds, Gg, Gs^Fms, Gg, Gg, Gg, Gg, Rb^Gvs, Gg^Eff, Gg^Vwm, Gg^Eff, Gg, Rb^Gvs, Rb^Gvs, Rb^Gvs, Rb^Gvs, Rb^Gvs, Rb^Gvs, Re^Gvs, Re^Gvs, Re^Gvs, Re, Re, Re^Gvs, Re^Gvs, Re^Gvs, Rb^Eff, Rb^Eff, Re^Gvs, Rb^Gvs, Re^Gvs, Gg^Fms, Gg^Fds, Gg^Fms, Gg^Fms, Gg, Gg^Fms, Re, Re, Re
Ww, Ww, Wo, Wo, Wo, Ww, Ww, Ww, Re, Re, Gs, Gd, Gd, Gs, Gs, Gs^Efm, Gs^Efm, Gg, Gg, Gg^Fms, Gg^Fms, Gs^Fds, Gg^Fms, Gs^Fds, Gg, Gg, Gg, Gg^Eff, Re, Re, Re^Gvs, Gg^Eff, Gg^Eff, Rb^Gvs, Rb^Gvs, Rb^Gvs, Rb^Gvs, Rb^Gvs, Rb^Gvs, Re^Gvs, Re^Gvs, Re, Rb^Gvs, Re^Gvs, Rb^Eff, Rb^Eff, Rb^Gvs, Rb^Gvs, Re^Gvs, Re^Gvs, Re^Vh, Re^Gvs, Rb^Gvs, Gg^Fds, Gg, Gg^Fds, Gg^Fms, Gg, Gg, Re
Wo, Wo, Wo, Wo, Ww, Ww^Bw\, Re^Vh, Re, Gd, Gs, Ds, Gd, Dd^Esd, Gs, Gd, Gs^Efm, Gs, Gs^Efm, Gg^Efm, Gg^Fms, Gs^Vl, Gg^Fds, Gg, Gg, Rb^Gvs, Gg, Re, Re, Re^Gvs, Re^Gvs, Re^Gvs, Re^Gvs, Rb^Gvs, Gg^Eff, Gg^Eff, Rb^Gvs, Rb^Gvs, Rb^Gvs, Rb^Gvs, Rb^Gvs, Rb^Gvs, Rb^Gvs, Rb^Eff, Rb^Eff, Rb^Gvs, Rb^Gvs, Rb^Gvs, Re^Gvs, Re^Gvs, Re^Gvs, Re^Gvs, Re^Gvs, Rb^Gvs, Rb^Gvs, Rb^Gvs, Gg, Gg, Gg, Gg^Fds, Gg
Wo, Ww, Wwr, Ww, Ds^Ewsh, Ww, Gg, Gs, Ds, Ds, Ds^Es, Ds, Dd^Esd, Dd^Esd, Gd, Gs, Gg^Fms, Gg, Gg, Gg^Efm, Gg^Es, Gg, Rb^Gvs, Rb^Gvs, Rb^Gvs, Rb^Gvs, Rb^Gvs, Re^Gvs, Rb^Gvs, Re^Gvs, Re^Gvs, Re^Gvs, Re^Gvs, Re^Gvs, Re, Gg, Gg, Rb^Gvs, Rb^Gvs, Rb^Gvs, Rb^Gvs, Rb^Eff, Rb^Eff, Rb^Gvs, Rb^Gvs, Rb^Gvs, Re^Vh, Re^Gvs, Re^Gvs, Re^Gvs, Re^Gvs, Re^Gvs, Re^Gvs, Rb^Gvs, Rb^Gvs, Rb^Gvs, Rb^Gvs, Gg, Gg, Gg^Fds
Wo, Wwr, Ds, Ds, Gs, Gs, Ds, Ds, Ds^Esd, Dd^Esd, Dd, Dd, Dd, Dd^Esd, Ds, Gs, Gg^Fds, Gg^Fms, Gg, Gg^Efm, Re, Re, Re, Rb^Gvs, Rb^Gvs, Rb^Gvs, Rb^Gvs, Rb^Gvs, Rb^Gvs, Rb^Gvs, Rb^Gvs, Rb^Gvs, Re^Gvs, Re, Rb^Gvs, Re, Re^Gvs, Gg, Gg, Rb^Gvs, Rb^Gvs, Rb^Gvs, Rb^Gvs, Rb^Eff, Rb^Eff, Rb^Gvs, Rb^Gvs, Re^Gvs, Rb^Gvs, Re^Gvs, Rb^Gvs, Re^Gvs, Rb^Gvs, Re^Gvs, Rb^Gvs, Rb^Gvs, Rb^Gvs, Rb^Gvs, Rb^Gvs, Gg^Fds
