border_size=1
usage=map

Aa          , Aa          , Aa          , Aa          , Aa          , Gd          , Gd          , Gd          , Gd          , Gd          , Gd          , Gd          , Gd          , Gd          , Gd          , Aa          , Aa          , Aa          , Ai          , Ai          , Ai          , Ai          , Ai          , Ww          , Ww          , Ww          , Gd          , Gd          , Gd          , Gd          , Gd          , Gd          , Ha          , Mm          , Ha          , Ha          , Aa          , Gd          , Aa          , Aa          , Gd          , Gd          
Aa          , Aa          , Aa          , Aa          , Aa^Voa      , Gd          , Gd          , Gd          , Gd          , Gd          , Gd          , Gd          , Gd          , Aa          , Gd          , Aa          , Aa          , Aa          , Ai          , Ai          , Ai          , Ai          , Ai          , Ww          , Ww          , Ww          , Gd          , Gd          , Gd          , Gd          , Gd          , Gd          , Ha          , Mm          , Ha          , Ha          , Aa          , Gd          , Aa^Voa      , Gd          , Gd          , Gd          
Aa          , Aa          , Gd          , Gd          , Gd          , Gd          , Aa          , Aa          , Aa          , Gd          , Aa          , Gd          , Gd          , Gd          , Gd          , Aa          , Aa          , Aa          , Aa          , Ai          , Ai          , Ai          , Ww          , Ww          , Ww          , Ai          , Gd          , Gd          , Gd          , Aa          , Aa          , Gd          , Aa          , Ha^Fpa      , Aa^Fpa      , Aa^Fpa      , Ha^Fpa      , Aa          , Ha          , Ha          , Ha          , Ha          
Aa          , Aa          , Gd          , Gd          , Gd          , Gd          , Rb          , Aa          , Aa          , Aa          , Gd          , Gd          , Gd          , Gd          , Gd          , Aa          , Gd          , Aa          , Aa          , Ha          , Hhd         , Ww          , Ww          , Ai          , Ai          , Ww          , Gd          , Gd          , Gd          , Gd          , Gd          , Aa          , Aa          , Aa^Fpa      , Aa^Fpa      , Ha          , Ha          , Ha          , Mm          , Mm          , Mm          , Mm          
Gd          , Gd          , Gd          , Gd          , Gd          , Rb          , Co          , Co          , Co          , Gd          , Gd          , Gd^Vo       , Gd          , Gd          , Gd          , Gd          , Gd          , Gd          , Ha          , Hhd         , Hhd         , Ha          , Aa^Voa      , Ww          , Ai          , Ww          , Ww          , Gd          , Gll^Fp      , Gd          , Aa          , Aa          , Aa^Fpa      , Aa^Fpa      , Co          , Co          , Co          , Ha          , Ha          , Mm          , Mm          , Mm          
Gd          , Gd          , Gd          , Gd          , Gd          , Aa          , Co          , 2 Ko        , Co          , Rb          , Gd          , Gd          , Gll^Fp      , Aa^Fpa      , Aa^Voa      , Aa^Fpa      , Aa          , Aa          , Ha          , Hhd         , Hhd         , Ha          , Ww          , Aa^Fpa      , Ww          , Ww          , Gd^Vo       , Gll^Fp      , Gll         , Aa^Fpa      , Aa          , Aa          , Aa^Fpa      , Aa^Fpa      , Co          , 3 Ko        , Co          , Ha          , Mm          , Mm          , Mm          , Mm          
Gd          , Gd          , Gd          , Aa          , Aa          , Aa          , Co          , Co          , Co          , Aa          , Gd          , Gll^Fp      , Gll^Fp      , Aa^Fpa      , Aa^Fpa      , Aa^Fpa      , Ha^Fpa      , Aa          , Ha          , Ha          , Ha          , Ww          , Aa^Fpa      , Ww          , Aa^Fpa      , Ww          , Aa^Fpa      , Aa^Fpa      , Aa^Fpa      , Aa^Fpa      , Aa^Fpa      , Aa^Fpa      , Aa^Fpa      , Aa^Fpa      , Co          , Co          , Co          , Ha          , Mm          , Hhd         , Mm          , Mm          
Gd          , Gd          , Gd          , Gd          , Aa^Voa      , Aa          , Rb^Fp       , Rb^Fp       , Gll^Fp      , Aa          , Aa          , Gll^Fp      , Aa^Fpa      , Aa^Fpa      , Ha^Fpa      , Ha^Fpa      , Ha          , Ha          , Hhd         , Hhd         , Ha          , Ww          , Ww          , Aa^Fpa      , Gll^Fp      , Gll^Fp      , Gll^Fp      , Gll^Fp      , Aa^Fpa      , Gll^Fp      , Ai          , Aa^Fpa      , Aa^Fpa      , Aa^Fpa      , Aa^Fpa      , Ha          , Ha          , Hhd         , Mm          , Mm          , Mm          , Mm          
Gd          , Gd          , Gll^Fp      , Aa^Fpa      , Aa          , Aa          , Gd          , Gd          , Aa^Fpa      , Aa^Fpa      , Aa^Fpa      , Ai          , Aa^Fpa      , Aa^Fpa      , Ha          , Ha          , Ha          , Hhd         , Hhd         , Hhd         , Hhd         , Ww          , Ww          , Aa^Fpa      , Aa^Fpa      , Aa^Fpa      , Gll^Fp      , Gll^Fp      , Gll^Fp      , Gll^Fp      , Gll^Fp      , Aa^Fpa      , Aa^Fpa      , Aa^Fpa      , Aa^Fpa      , Aa          , Aa          , Hhd         , Ha          , Hhd         , Hhd         , Hhd         
Gd          , Gd          , Gd          , Gll^Fp      , Aa^Fpa      , Gd          , Gd          , Gd^Vo       , Gd          , Aa^Fpa      , Aa          , Aa^Fpa      , Aa^Fpa      , Aa^Fpa      , Aa^Fpa      , Ha^Fpa      , Ha          , Hhd         , Hhd         , Hhd         , Gs          , Ww          , Aa^Voa      , Aa^Fpa      , Gd          , Aa          , Gll^Fp      , Gll^Fp      , Gll^Fp      , Gll^Fp      , Aa^Fpa      , Gll^Fp      , Aa^Fpa      , Aa^Fpa      , Aa^Fpa      , Aa^Fpa      , Gd          , Ha          , Aa          , Aa          , Hhd         , Hhd         
Gd          , Gd          , Gll^Fp      , Gll^Fp      , Aa^Fpa      , Aa^Fpa      , Aa^Fpa      , Aa^Fpa      , Aa^Fpa      , Aa          , Aa^Fpa      , Aa^Fpa      , Aa^Fpa      , Aa^Fpa      , Ha          , Ha          , Gd          , Gd          , Gd          , Gd          , Gd          , Gd          , Gd          , Gd          , Gd          , Gd          , Gd          , Gll^Fp      , Gll^Fp      , Gll^Fp      , Gd          , Gll^Fp      , Aa          , Aa          , Aa          , Gd          , Gd          , Gd          , Gd          , Aa          , Gd          , Gd          
Gll^Fp      , Gll^Fp      , Gll^Fp      , Gll^Fp      , Ha^Fpa      , Ha^Fpa      , Aa^Fpa      , Aa^Fpa      , Aa^Fpa      , Aa^Fpa      , Aa^Fpa      , Aa^Fpa      , Aa^Voa      , Aa^Fpa      , Rb          , Rb          , Rb          , Gd          , Rb          , Gd          , Gd          , Gd          , Gd          , Gd          , Gd          , Gd          , Gd          , Gd          , Gd          , Gd          , Gd          , Gd          , Gd          , Aa          , Gd          , Gd          , Gd^Vo       , Gd          , Aa          , Gd          , Gd          , Gd          
Aa^Fpa      , Gll^Fp      , Aa^Fpa      , Gll^Fp      , Aa^Fpa      , Ha          , Aa^Fpa      , Aa^Fpa      , Gll^Fp      , Aa^Fpa      , Ha^Fpa      , Ha          , Ha          , Rb          , Gd          , Hhd         , Hhd^Vo      , Rb          , Gd          , Rb          , Rb          , Rb          , Gd          , Gd          , Gd          , Gd          , Gd          , Gd          , Gd          , Gd          , Gd          , Gd          , Gd          , Aa^Voa      , Gd          , Gd          , Gd          , Gd          , Gd          , Gd          , Aa          , Aa          
Aa^Fpa      , Aa^Fpa      , Aa^Voa      , Aa^Fpa      , Ha          , Ha          , Aa^Fpa      , Gll^Fp      , Gll^Fp      , Aa^Fpa      , Gd          , Ha          , Ha          , Gd          , Hhd         , Hhd         , Gd          , Gd          , Gd          , Gd          , Gd          , Gd          , Gd          , Gd          , Gd^Vo       , Gd          , Gd          , Mm          , Gd          , Gd^Vo       , Gd          , Gd          , Gd          , Gd          , Gd          , Gd          , Gd          , Gd          , Gd          , Gd          , Ha          , Ha          
Ha          , Ha          , Aa^Fpa      , Aa^Fpa      , Aa^Fpa      , Aa^Fpa      , Gll^Fp      , Gll^Fp      , Gll^Fp      , Gll^Fp      , Rb          , Gd          , Gd          , Ha          , Ha          , Ha          , Aa          , Gd          , Gd          , Gd          , Gd          , Hhd         , Hhd         , Gd          , Gd          , Gd          , Gd          , Mm          , Mm          , Gd          , Gd          , Gd          , Gd          , Gd          , Gd          , Gd          , Gd          , Gd          , Gd          , Ha          , Mm          , Mm          
Ha          , Ha          , Ha          , Ha^Fpa      , Ha^Fpa      , Aa^Fpa      , Aa^Fpa      , Gll^Fp      , Gd          , Gd          , Gd          , Gd          , Ha          , Ha^Fpa      , Ha^Fpa      , Ha          , Ha          , Aa          , Aa          , Aa          , Ha          , Hhd         , Hhd         , Hhd         , Gd          , Gd          , Gd          , Mm          , Mm          , Gd          , Gd          , Gd          , Gd          , Gd          , Gd          , Gd          , Gd          , Hhd         , Hhd         , Ha          , Mm          , Mm          
Aa          , Aa          , Ha          , Ha^Fpa      , Ha          , Aa^Fpa      , Ha^Voha     , Aa^Fpa      , Re          , Re          , Hhd         , Ha          , Ha          , Ha^Fpa      , Ha          , Ha          , Ha          , Aa          , Ha          , Ha          , Ha          , Hhd         , Hhd         , Hhd         , Gd^Vo       , Gd          , Gd          , Gd          , Mm          , Gd          , Gd          , Gd          , Gd          , Gd          , Gd          , Gd          , Hhd         , Hhd         , Hhd         , Mm          , Mm          , Mm          
Aa          , Aa          , Aa          , Ha          , Ha          , Ha          , Gd          , Gd          , Gd          , Hhd         , Hhd         , Ha          , Ha          , Ha          , Mm          , Aa          , Aa          , Ha          , Ha          , Mm          , Mm          , Mm          , Hhd         , Mm          , Gd          , Gd          , Gd          , Gd          , Mm          , Mm          , Gd          , Gd          , Gd          , Gd          , Gd          , Gd          , Hhd         , Hhd         , Hhd         , Mm          , Mm          , Mm          
Aa          , Aa          , Ha          , Ha          , Ha          , Gd          , Hhd         , Re          , Gd          , Ha          , Aa          , Aa          , Gd          , Mm          , Mm          , Mm          , Aa          , Ha          , Hhd         , Mm          , Mm          , Mm          , Mm          , Mm          , Gd          , Gd          , Gd          , Gd          , Mm          , Gd          , Gd          , Gd          , Gd          , Gd^Vo       , Gd          , Hhd         , Mm          , Mm          , Mm          , Mm          , Aa^Voa      , Aa          
Aa          , Aa          , Aa          , Aa          , Ha          , Ha          , Gd          , Re          , Re          , Ha          , Aa^Voa      , Gd          , Gd          , Gd          , Gd          , Mm          , Ha          , Hhd         , Hhd         , Mm          , Mm          , Mm          , Gd          , Gd          , Gll^Fp      , Gd          , Gd          , Gd          , Gd          , Mm          , Gd          , Gd          , Gd          , Gd          , Gd          , Hhd         , Ha          , Ha          , Mm          , Mm          , Aa          , Aa          
Gd          , Gd          , Gd          , Gd          , Hhd         , Hhd         , Gd          , Gd          , Hhd         , Re          , Re          , Gd          , Gd          , Gd          , Gd          , Ha          , Ha^Vcha     , Hhd         , Mm          , Mm          , Mm          , Gll^Fp      , Aa          , Aa^Fpa      , Gll^Fp      , Aa^Fpa      , Aa^Voa      , Gd          , Gd          , Mm          , Mm          , Gd          , Gd          , Gd          , Gd          , Gd          , Ha          , Mm          , Mm          , Mm          , Mm          , Mm          
Gd          , Gd          , Gd          , Gd          , Hhd         , Gd          , Gd          , Gd^Vc       , Gd          , Hhd         , Hhd         , Re          , Re          , Gd          , Gd          , Gd          , Ha          , Aa^Fpa      , Gll^Fp      , Gll^Fp      , Gll^Fp      , Gll^Fp      , Aa^Fpa      , Aa          , Gll^Fp      , Gll^Fp      , Gll^Fp      , Mm          , Aa          , Mm          , Gd          , Gd          , Gd          , Gd          , Gd          , Gd          , Mm          , Mm          , Mm          , Mm          , Mm          , Mm          
Gd          , Gd          , Gd          , Gd          , Gd          , Gd          , Gd          , Gd          , Hhd         , Hhd         , Hhd         , Hhd^Vo      , Re          , Gd          , Gd          , Gd          , Aa^Fpa      , Aa^Fpa      , Aa^Fpa      , Aa^Fpa      , Gd          , Aa^Fpa      , Aa^Voa      , Aa          , Gll^Fp      , Gll^Fp      , Aa^Fpa      , Mm          , Mm          , Mm          , Mm          , Gd          , Gd          , Gd          , Gd          , Gs          , Gs          , Ww          , Aa^Voa      , Mm          , Mm          , Mm          
Gd          , Gd          , Gd          , Gd          , Gd          , Aa          , Ha          , Ha          , Hhd         , Hhd         , Hhd         , Hhd         , Re          , Gd          , Gd          , Aa^Fpa      , Gd          , Aa^Fpa      , Aa^Fma      , Gd          , Gd          , Aa^Fpa      , Aa^Fpa      , Gll^Fp      , Aa^Fma      , Gll^Fp      , Aa^Fpa      , Mm          , Mm          , Mm          , Mm          , Gd^Vo       , Gd          , Gd          , Gd          , Gs          , Ww          , Ww          , Ww          , Mm          , Mm          , Mm          
Gd          , Gd          , Gd          , Gd          , Gd          , Aa          , Hhd         , Ha          , Aa          , Gd          , Gd          , Gd          , Re          , Gd          , Gll^Fp      , Aa^Fpa      , Aa^Fpa      , Gd          , Aa^Fpa      , Ha^Fpa      , Ha          , Aa^Fpa      , Aa^Fpa      , Ha^Fpa      , Gd          , Gd          , Gd          , Gd^Vo       , Mm          , Mm          , Mm          , Gd          , Gd          , Gd          , Gd          , Gs          , Gs          , Ww          , Ww          , Mm          , Mm          , Mm          
Gd          , Gd          , Gd          , Gd          , Gd          , Hhd         , Hhd         , Ha          , Gd          , Gd          , Gd          , Gd^Vc       , Re          , Gll^Fp      , Gll^Fp      , Aa^Fma      , Gll^Fmw     , Aa^Fpa      , Ha^Fpa      , Ha          , Ha          , Ha          , Ha^Fpa      , Ha          , Gd          , Gd          , Aa          , Aa          , Mm          , Mm          , Mm          , Mm          , Gd          , Gd          , Aa          , Aa          , Ww          , Ww          , Ww          , Ww          , Mm          , Mm          
Gd          , Gd          , Gd          , Gd          , Gd          , Gd^Vc       , Gd          , Gd          , Gd          , Gd          , Gd          , Gd          , Re          , Gd          , Gll^Fp      , Gll^Fp      , Gd          , Gll^Fp      , Hhd         , Ha          , Ha          , Ha^Fpa      , Ha^Fpa      , Ha          , Ha          , Ha          , Aa          , Mm          , Mm          , Mm          , Mm          , Mm          , Gd          , Gd          , Aa          , Mm          , Mm          , Ww          , Ww          , Ww          , Mm          , Mm          
Gd          , Gd          , Gd^Vc       , Gd          , Gd          , Gd          , Gd          , Gd          , Gd          , Gd          , Gd          , Gd          , Re          , Gd          , Gd          , Gd          , Gd          , Hhd         , Ha          , Ha^Vcha     , Ha          , Ha          , Hhd         , Hhd         , Hhd         , Hhd         , Hhd         , Mm          , Mm          , Mm          , Mm          , Gd          , Gd          , Mm          , Aa          , Mm          , Mm          , Mm          , Ww          , Mm          , Mm          , Mm          
Gd          , Gd          , Gd          , Aa^Fpa      , Gd          , Gd          , Gd          , Gd          , Gd          , Gd          , Gd          , Gd          , Gd          , Re          , Gd          , Gd          , Gd          , Gd          , Gd          , Hhd         , Hhd         , Hhd         , Hhd         , Mm          , Mm          , Mm          , Mm          , Mm          , Mm          , Mm          , Mm          , Aa^Voa      , Mm          , Mm          , Mm          , Mm          , Mm          , Mm          , Ww          , Mm          , Mm          , Mm          
Aa          , Aa          , Gd          , Aa^Fma      , Aa^Fpa      , Gd          , Gd          , Gd          , Gd          , Gd          , Gd          , Gd          , Gd          , Re          , Gd          , Aa          , Gd          , Gd          , Gd          , Hhd         , Mm          , Mm          , Mm          , Mm          , Mm          , Mm          , Mm          , Mm          , Hhd         , Mm          , Mm          , Mm          , Ha          , Mm          , Ai          , Ai          , Ai          , Mm          , Mm          , Ww          , Ww          , Ww          
Aa^Fpa      , Aa^Fpa      , Aa^Fma      , Aa^Fpa      , Aa          , Gd          , Gd          , Gd          , Gd          , Gd          , Aa          , Aa^Fma      , Gd          , Gd          , Gd          , Gd          , Gd          , Gd          , Gs          , Gs          , Gs^Vc       , Mm          , Mm          , Mm          , Mm          , Mm          , Mm          , Mm          , Hhd         , Hhd         , Hhd         , Ha          , Aa          , Mm          , Mm          , Ai          , Mm          , Mm          , Mm          , Gd^Vo       , Gs          , Gs          
Aa^Fpa      , Aa^Fma      , Aa          , Gd          , Aa^Fma      , Aa^Fma      , Aa          , Aa          , Gd          , Gd          , Aa          , Aa^Fma      , Aa^Fda      , Gll^Vc      , Gd          , Aa          , Aa          , Gd          , Gs          , Ww          , Ww          , Mm          , Mm          , Mm          , Aa          , Mm          , Mm          , Mm          , Mm          , Hhd         , Mm          , Mm          , Aa          , Mm          , Mm          , Mm          , Mm          , Mm          , Mm          , Gd          , Gd          , Gd          
Aa^Fpa      , Aa^Fpa      , Gd          , Gd          , Gd          , Aa^Fma      , Aa^Fma      , Gd          , Gd          , Aa          , Re          , Gll^Fmw     , Aa^Fda      , Gll^Fdw     , Gll         , Aa          , Aa          , Aa          , Ww          , Ww          , Ww          , Ww          , Mm          , Mm          , Mm          , Mm          , Mm          , Mm          , Mm          , Mm          , Mm          , Aa          , Gd          , Mm          , Mm          , Mm          , Mm          , Mm          , Mm          , Gd          , Gd          , Gd          
Aa^Fpa      , Aa^Fda      , Gd          , Aa^Fda      , Aa^Fpa      , Aa^Fpa      , Aa^Fma      , Aa^Fda      , Aa^Fma      , Aa          , Gll^Fdw     , Re^Fp       , Re^Fdw      , Aa^Fma      , Gll^Fp      , Aa^Fma      , Aa          , Ai          , Ww          , Ww          , Ww          , Gs          , Mm          , Mm          , Ha          , Mm          , Mm          , Mm          , Mm          , Mm          , Mm          , Gd          , Gd          , Gs          , Mm          , Mm          , Gs          , Mm          , Gd          , Gd          , Aa          , Aa          
Aa^Fpa      , Gll^Fdw     , Aa^Fpa      , Gll^Fmw     , Gll^Fp      , Gd^Vca      , Gll^Fp      , Gll^Fdw     , Gll^Fmw     , Gll^Fmw     , Gll^Fmw     , Ce          , Ce          , Ce          , Gll^Fdw     , Aa^Fpa      , Gll^Fmw     , Ai          , Ww          , Ww          , Gs          , Gs          , Gd          , Ha          , Gd          , Hhd         , Hhd         , Mm          , Mm          , Gs          , Gd          , Gd          , Gd          , Gd          , Gd          , Gd          , Mm          , Gd          , Gd          , Gd          , Gd          , Aa          
Aa^Fpa      , Aa^Fpa      , Gll^Fp      , Gll^Fdw     , Gll^Fp      , Aa^Fpa      , Gll^Fp      , Gll^Fmw     , Gd          , Gd          , Aa^Fma      , Ce          , 1 Ke        , Ce          , Aa^Fda      , Gll^Fp      , Ai          , Ai          , Ai          , Aa          , Gd          , Gll^Vc      , Gd          , Gd          , Aa^Vca      , Ha          , Mm          , Mm          , Mm          , Mm          , Gd          , Gd          , Gd          , Gd          , Gs          , Mm          , Aa          , Aa          , Aa^Voa      , Gd          , Gd          , Gd          
Aa          , Aa          , Aa^Fpa      , Aa^Fma      , Aa^Fda      , Gll^Fmw     , Aa^Fma      , Gd          , Gd          , Aa          , Re          , Ce          , Ce          , Ce          , Aa          , Aa^Vca      , Aa          , Aa          , Aa          , Aa          , Aa          , Aa          , Gd          , Gd          , Gd          , Ha          , Mm          , Mm          , Mm          , Mm          , Mm          , Gd          , Gd          , Gd          , Gd          , Mm          , Mm          , Mm          , Gd          , Gd          , Gd          , Gd          
Aa          , Aa          , Aa          , Aa^Vca      , Aa^Fpa      , Gd          , Aa          , Gd          , Gd          , Gd          , Gd          , Aa          , Gll         , Aa          , Aa          , Aa          , Gd          , Aa          , Aa          , Aa          , Aa          , Aa          , Aa          , Gd          , Gd          , Gd          , Hhd         , Hhd         , Mm          , Mm          , Gd          , Gd          , Gd          , Gd          , Gd^Vo       , Gd          , Gd          , Mm          , Gd          , Gd          , Aa          , Aa          
Aa          , Aa          , Gd          , Aa          , Aa^Fma      , Aa^Fma      , Aa          , Aa          , Aa          , Aa          , Gd          , Gd          , Gd          , Aa          , Aa          , Gd          , Gd          , Gd          , Aa          , Aa          , Gd          , Aa          , Ha          , Ha          , Ha          , Gd          , Hhd         , Hhd         , Mm          , Mm          , Gd          , Gd          , Gd          , Gd          , Gd          , Gd          , Gd          , Aa^Voa      , Gd          , Gd          , Aa          , Aa          
Gd          , Gd          , Gd          , Aa          , Aa^Fpa      , Aa^Fma      , Aa          , Aa          , Aa          , Gd          , Gd          , Gd          , Gd          , Gd          , Aa          , Gd          , Aa          , Gd          , Aa          , Gd          , Hhd         , Gd          , Hhd         , Aa          , Gd          , Ha          , Hhd         , Hhd         , Hhd         , Gd          , Gd          , Gd          , Gd          , Gd          , Gd          , Gd          , Gd          , Gd          , Ha          , Aa          , Ha          , Ha          
Aa          , Gd          , Aa          , Aa          , Aa          , Aa          , Aa          , Aa          , Aa          , Gd          , Aa          , Aa          , Aa          , Aa          , Aa          , Aa          , Gd          , Gd          , Gd          , Ha          , Ha          , Hhd         , Gd          , Gd          , Gd          , Gd          , Ha          , Ha          , Gd          , Gd          , Gd          , Gd          , Aa          , Gd          , Aa          , Gd          , Gd          , Aa          , Ha          , Ha          , Ha          , Ha          
Gd          , Gd          , Gd          , Aa          , Aa          , Aa          , Aa          , Aa          , Aa          , Aa          , Aa          , Aa          , Aa          , Aa          , Aa          , Aa          , Gd          , Gd          , Gd          , Ha          , Ha          , Ha          , Aa          , Aa          , Aa          , Aa          , Ha          , Hhd         , Gd          , Gd          , Aa          , Gd          , Aa          , Aa          , Gd          , Gd          , Aa          , Aa          , Ha          , Ha          , Ha          , Ha          
