Rb^Gvs, Gs^Fms, Rb^Gvs, Rb^Gvs, Re, Hh^Qhh, Hh^Qhh, Hh^Qhh, Hh^Qhh, Mm^Qhh, Hh^Qhh, Mm^Qhh, Mm, Mm^Qhh, Mm^Qhh, Hh^Qhh, Hh^Qhh, Mm^Qhh, Mm^Qhh, Mm^Qhh, Mm^Qhh, Mm^Qhh, Mm^Qhh, Mm^Qhh, Mm^Qhh, Mm^Qhh, Hh^Qhh, Mm^Qhh, Mm^Qhh, Mm^Qhh, Mm^Qhh, Hh^Fdf, Hh^Fdf, Hh^Fdf, Gg, Gll, Gll^Fdf, Gll^Fdf, Gg, Gll^Fdf, Gll^Fdf, Gll^Fmf
Rb^Gvs, Rb^Gvs, Rb^Gvs, Rb^Gvs, Gg, Hh, Hh, Hh^Qhh, Hh, Mm, Hh, Mm, Mm, Mm, Mm, Hh, Hh, Mm, Mm, Mm, Mm, Mm, Mm, Mm, Mm, Mm, Hh^Qhh, Mm^Qhh, Mm^Qhh, Mm^Qhh, Mm^Qhh, Hh^Fdf, Hh, Hh^Fdf, Gll, Gll, Gll^Fdf, Gll^Fdf, Gll, Gll^Fdf, Gll^Fmf, Gll^Fmf
Rb^Gvs, Rb^Gvs, Rb^Gvs, Re, Gg, Hh, Hh, Hh^Qhh, Hh^Qhh, Mm, Mm, Mm, Mm, Hh, Mm, Mm, Mm, Mm, Hh, Mm, Mm, Mm, Hh, Mm, Hh, Hh^Qhh, Hh, Hh^Qhh, Mm^Qhh, Mm^Qhh, Mm^Qhh, Mm^Qhh, Hh, Hh, Hh, Gg, Gg, Gll^Fmf, Gll^Fdf, Gll^Fmf, Gll^Fdf, Gll^Fmf
Rb^Gvs, Rb^Gvs, Rb^Wm, Rb^Gvs, Gg, Hh, Hh, Hh, Hh, Hh^Qhh, Hh^Qhh, Hh, Mm, Mm, Mm, Mm, Hh^_mh, Mm, Mm, Mm, Mm, Hh, Mm, Mm, Hh^Qhh, Hh^Qhh, Gs, Hh, Hh, Mm^Qhh, Hh, Mm^Qhh, Mm, Hh, Gg, Gg, Gll, Gll^Fmf, Gs, Gs, Gll^Fmf, Gll^Fmf
Rb^Gvs, Rb^Gvs, Rb^Gvs, Rb^Gvs, Rb^Gvs, Gg, Hh, Hh, Gg, Hh, Hh^Qhh, Hh, Mm, Hh, Mm, Hh, Mm, Hh, Mm, Mm, Mm, Hh, Hh, Hh, Hh^Qhh, Hh, Hh, Hh, Hh^Fdf, Hh^Fdf, Hh, Hh, Hh, Hh, Hh, Hh, Gg, Gll, Gg, Gs, Gs, Gll
Rb^Gvs, Rb^Gvs, Re^Gvs, Re^Vh, Re^Gvs, Re, Gg^Efm, Gg, Gg, Hh, Hh^Qhh, Hh, Mm, Mm, Mm, Hh, Hh, Mm, Mm, Mm, Mm, Mm, Hh^Qhh, Hh^Qhh, Hh, Hh, Gs, Hh, Gll^Fdf, Gll^Fdf, Gll, Hh, Hh, Hh, Hh, Gg, Gs^Edt, Gg, Gs, Gs, Gs, Gs
Gg, Rb^Gvs, Re^Gvs, Re^Gvs, Re^Gvs, Rb^Gvs, Rb^Gvs, Rb^Gvs, Gg, Hh, Hh, Hh^Qhh, Mm^Qhh, Mm, Mm, Mm, Mm, Mm, Mm, Mm, Mm, Hh, Hh^Qhh, Hh, Gg^Vhh, Gs, Gg, Gll, Gll, Gll^Fdf, Gs, Gg, Gs, Hh, Gs, Gs, Gs, Ce^Edt, Rr, Gg, Rr, Re
Rr, Rr, Rr, Re^Gvs, Re^Gvs, Rb^Gvs, Rb^Gvs, Rb^Gvs, Rb^Gvs, Gg, Hh^Fmf, Hh, Hh, Mm^Qhh, Mm^Qhh, Hh, Hh, Hh, Mm, Mm, Hh, Hh, Hh^Qhh, Hh, Hh, Gg, Gs, Gg, Gs, Gll, Gg^Edt, Gs, Gs, Gs, Gs^Ecf, Ss, Re^Edt, Re, Rb^Edt, Rr^Edt, Gs, Gs
Rb^Gvs, Rb^Gvs, Rb^Gvs, Rr, Rr, Rb^Gvs, Rb^Gvs, Rb^Gvs, Gll, Hh, Hh^Fmf, Hh, Hh, Hh, Hh^Qhh, Hh, Hh, Hh, Hh^Qhh, Hh^Qhh, Hh^Qhh, Hh^Qhh, Hh, Hh, Hh, Gs, Gg, Gs, Gg, Gs, Gs, Gs^Edt, Ce^Edt, Ce, Re, Rb, Rb, Rb^Vct, Rb^Ecf, Rb^Vct, Rb, Rb
Re^Gvs, Rb^Gvs, Rb^Gvs, Rb^Gvs, Ce, Rr, Re, Gg, Gll, Hh^Fmf, Hh, Hh, Hh, Hh, Hh^Qhh, Hh, Hh^Qhh, Hh^Qhh, Gs, Hh, Hh, Hh, Gs, Hh, Gg, Gs, Hh, Hh, Hh, Gs, Gs, Gs, Gs, Ce, Rb^Edt, Ce, Ce, Gs, Rb^Vct, Rb, Gg^Edt, Gg
Rb^Gvs, Rb^Gvs, Re^Eff, Gg^Eff, Ce, Ke, Ce, Re, Gg, Gll, Gg, Hh, Gs, Hh, Hh, Hh^Qhh, Hh, Hh, Hh, Gs, Gs, Gs, Gg, Gg, Gs, Gg, Hh, Hh, Gs^Vh, Hh, Gs^Edt, Gs, Rb^Es, Rb, Ce, 2 Ket, Rb, Gs, Ce^Edt, Rb^Vct, Gs^Edt, Gs^Edt
Re^Eff, Re^Eff, Re^Eff, Gg, Gg, Ce, Gg, Re, Re, Gg, Gg, Gg, Gg, Hh, Hh, Hh, Hh^Qhh, Hh^Qhh, Hh^Qhh, Hh, Hh, Gs, Gs, Gg, Gg, Hh, Hh, Hh, Hh, Gs, Gs, Gs, Rr, Re, Re, Ce, Gs^Edt, Gs^Es, Gg, Gg^Edt, Gg, Gg
Re^Gvs, Re^Gvs, Re^Gvs, Gg^Eff, Gg^Eff, Gg, Gg^Efm, Gg, Gg^Vh, Rr, Re, Gg^Vh, Gs, Hh, Hh^Qhh, Hh^Qhh, Mm^Qhh, Mm^Qhh, Hh^Qhh, Hh, Hh, Gs, Gg, Gg, Gs, Gs, Hh, Hh, Gs, Gs, Re, Rr, Gs, Gs, Hh, Gs, Gs^Edt, Gs, Gg, Gll^Fdf, Gg, Gg
Re^Gvs, Re^Gvs, Re^Gvs, Rb^Gvs, Rb^Gvs, Gg^Eff, Gs^Eff, Gg^Efm, Gg^Efm, Gg, Re, Gg, Gll^Fmf, Hh, Hh, Hh^Qhh, Mm^Qhh, Mm^Qhh, Hh^Qhh, Hh^Qhh, Hh, Hh, Gg, Gg, Gg, Gg, Re, Re, Re, 3 Re, Gg, Gs, Gs, Gs, Hh, Hh, Gs, Gll, Gll^Fdf, Gll^Fdf, Gll^Fmf, Gll^Fmf
Re^Gvs, Re^Gvs, Rb^Gvs, Rb^Gvs, Rb, Rb^Eff, Gs, Gg^Efm, Gs, Gg, Gg, Re, Gll^Fmf, Hh, Hh, Hh^Qhh, Hh^Qhh, Hh^Qhh, Hh, Hh, Gg, Gg, Re, Re, Re, Re, Gg, Gg, Hh, Hh, Gs, Gg, Gs, Ss^Qhh, Ss, Gs, Gs, Gll, Gll^Fmf, Gll^Fmf, Gll^Fmf, Gll^Fmf
Rb^Gvs, Rb^Gvs, Rb^Gvs, Rb, Gll^Fdf, Gs, Gs, Gg^Efm, Gs, Gs, Hh, Rr, Rr, Gll^Fmf, Gg, Hh, Hh, Gg^Vh, Gs, Gg, Re, Re, Gll^Fdf, Gll^Fdf, Hh, Gg^Vh, Hh, Hh, Hh, Hh, Gs, Gs, Gs, Ss^Qhh, Gs, Gs, Gs, Gg, Gll, Gll^Fmf, Gll^Fmf, Gll^Fmf
Rb^Gvs, Rb^Gvs, Gll^Fmf, Gll^Fmf, Gll^Fdf, Gll^Fmf, Gll, Gs, Gd, Gs, Gll^Fmf, Hh, Gg, Re, Rr, Gs, Gs, Gs, Rr, Rr, Hh, Hh, Hh, Hh, Hh, Hh, Hh^Fdf, Hh, Hh, Gg^Vh, Hh, Gs^Qhh, Hh, Gs^Qhh, Hh^Qhh, Gs, Hh, Gll, Gll, Gll, Gll, Gg
Hh^Qhuf, Hh^Qhuf, Hh^Qhuf, Gll, Hh^Qhu, Gll^Fdf, Gll^Fmf, Gd, Gd, Gs, Ss^Qhu, Gg, Gg, Gs, Rp, Re, Re, Re, Gs, Gs, Hh, Hh, Gg, Hh, Hh, Hh^Fdf, Hh, Hh, Hh, Hh, Hh, Gs^Qhh, Hh^Qhh, Hh, Hh^Qhh, Hh, Hh, Hh, Hh, Hh, Hh, Hh
Hh, Hh, Hh, Hh^Qhu, Hh, Hh^Qhuf, Gs^Qhuf, Gs^Qhuf, Gs^Qhuf, Ss^Qhu, Ss, Ss^Qhu, Gs^Qhuf, Hh^Qhuf, Rp, Rp, Re, Gg, Hh, Hh^Vhh, Hh, Hh, Hh^Qhh, Hh, Gg, Hh, Gg, Hh^Qhh, Hh^Qhh, Hh, Hh, Hh^Qhh, Hh, Hh, Hh^Qhh, Hh, Hh, Hh, Hh, Hh^Fdf, Hh^Fdf, Hh
Hh, Hh, Hh, Hh, Hh, Hh^Fmf, Hh, Gll^Fmf, Gll^Fp, Gg, Gll^Fp, Ss, Gll^Fmf, Hh^Qhuf, Hh^Qhu, Rp, Re, Gg, Hh, Hh, Hh^Qhh, Hh^Qhh, Hh, Hh, Gg, Gg, Gs, Hh, Hh, Hh^Qhh, Hh, Hh^Qhh, Hh, Hh^Qhh, Hh^Qhh, Hh, Hh^Qhh, Hh^Qhh, Hh, Hh^Fdf, Hh, Hh
Hh, Hh, Hh, Hh, Hh, Hh, Hh, Hh, Hh, Gll^Fp, Hh, Gs^Fp, Hh, Hh, Gg^Vh, Hh^Qhu, Re, Gs, Gd, Hh, Hh^Qhh, Hh, Hh^Fdf, Hh, Hh, Gs, Gs, Hh, Hh, Hh^Qhh, Hh^Qhh, Hh^Qhh, Hh^Qhh, Hh^_mhh, Hh^Qhh, Hh^Qhh, Gg, Hh, Hh, Hh, Hh, Hh
Hh, Hh, Hh, Hh, Hh, Gg, Gs, Gs, Gs, Hh, Hh, Hh, Gg, Hh, Hh^Qhuf, Hh^Qhu, Rb, Gd, Gd, Hh, Hh^Qhh, Hh, Hh, Hh, Hh, Hh, Hh, Hh, Hh, Hh, Hh, Hh^Qhh, Gs, Hh^Qhh, Hh, Hh, Hh, Hh, Hh, Gs, Gs, Gg
Hh, Hh, Hh, Hh, Hh, Hh, Gd, Gd, Hh, Hh, Hh, Hh, Gg, Hh, Hh^Qhu, Gs, Rb, Gs, Gg, Hh, Hh, Hh^Qhh, Hh, Hh, Gs, Hh, Hh, Hh, Hh, Hh, Hh, Gs, Hh, Gs, Gll^Fdf, Gll^Fdf, Hh, Hh, Gg, Gs, Hh, Hh
Hh^Fmf, Hh^Fmf, Gll^Fmf, Hh, Hh, Hh, Hh, Hh, Hh, Hh, Hh^Fdf, Hh, Hh, Hh, Hh^Qhu, Gs^Fmf, Gs, Rb, Rb, Gs, Gs, Hh^Qhh, Hh, Gs, Gs, Hh, Hh, Hh, Hh, Hh, Hh^Qhh, Hh, Hh, Hh, Hh, Hh, Hh, Hh, Hh, Gg, Hh, Hh
Rb^Gvs, Gll, Gll^Fmf, Gll^Fmf, Hh, Hh, Hh, Hh, Hh^Qhuf, Hh, Hh, Hh, Hh, Hh, Hh^_ml, Gs^Qhuf, Hh^Qhu, Gs, Gg, Re, Gg, Hh^Qhh, Hh^Qhh, Hh, Hh^Qhh, Hh^Qhh, Hh^Qhh, Hh, Hh^Qhh, Hh^Qhh, Hh, Hh^Qhh, Hh^Qhh, Hh^Qhh, Hh^Qhh, Hh, Gs^_mh, Hh, Hh, Hh, Hh^Qhh, Hh
Rb^Gvs, Rb^Gvs, Re^Gvs, Re, Re, Hh, Gg, Hh^Qhu, Gll^Fdf, Gs^Qhuf, Gs^Qhuf, Hh, Hh, Hh, Hh, Hh, Hh^Qhu, Hh^Qhu, Gg, Re, Gs, Hh, Hh, Hh^Qhh, Hh, Hh, Hh, Hh^Qhh, Hh, Gs, Gs, Hh, Hh, Hh, Hh, Hh^Qhh, Hh^Qhh, Hh, Hh, Hh^Qhh, Hh^Qhh, Hh^Qhh
Rb^Gvs, Rb^Gvs, Rb^Gvs, Re^Gvs, Rb^Eff, Gs, Gs, Gg, Gll, Gll^Fdf, Hh^Qhuf, Gg, Hh^Qhu, Hh^Qhu, Hh^Qhu, Hh^Qhu, Gd^Vh, Hh^Qhu, Gs, Rb, Re, Rb, Hh, Hh^Vhh, Hh, Hh, Hh, Gg, Gg, Gs, Gs, Hh, Hh^Vhh, Hh, Hh, Gs, Gs, Hh^Qhh, Hh^Qhh, Hh^Qhh, Hh^Qhh, Hh^Qhh
Rb^Gvs, Rb^Gvs, Rb^Wm, Re^Gvs, Rb^Gvs, Rb^Eff, Gs^Eff, Gg, Gg, Gg, Gg, Hh^Qhu, Gg, Gg, Gg, Hh^Qhu, Gd, Gd, Gs, Rb, Ce, Rb, Ss, Hh, Hh^Fmf, Hh, Gll^Fmf, Gll, Gg^Eff, Gg^Eff, Gs^Eff, Gs, Gg, Hh, Hh, Hh, Hh, Hh, Hh, Gg, Hh, Hh^Qhh
Rb^Gvs, Rb^Gvs, Re^Gvs, Re^Gvs, Rb^Eff, Gs^Eff, Gg, Gg, Hh, Hh, Gs, Gg, Gg, Rb^Gvs, Rb^Gvs, Rb, Rb^Gvs, Gs, Gs, Ce, Ke, Rb, Rb, Hh, Gll^Vh, Hh^Fmf, Gll^Fmf, Gg, Rb^Gvs, Rb^Gvs, Ss, Gs^Eff, Gs^Eff, Hh, Hh, Hh, Gg, Hh, Gg, Gg, Hh^Fmf, Hh^Fmf
Re^Gvs, Re^Gvs, Re^Eff, Rb^Eff, Rb^Gvs, Re^Eff, Rb^Gvs, Rb^Gvs, Rb^Gvs, Gs^Vh, Gs, Gg, Rb^Gvs, Rb^Gvs, Rb^Gvs, Re, Rb^Gvs, Rb, Gg, Ce, Gg, Ce, Rb, Rb, Rb, Gll^Fmf, Gs, Gg, Rb^Gvs, Rb^Gvs, Rb^Gvs, Rb^Gvs, Gg, Gg, Gg, Hh, Gg, Gg, Rb^Gvs, Hh^Fmf, Hh^Fmf, Hh^Fmf
Re^Eff, Re^Eff, Re^Gvs, Rb^Gvs, Rb^Gvs, Rb^Gvs, Rb^Gvs, Rb^Gvs, Rb^Gvs, Rb^Gvs, Re, Re, Rb^Gvs, Rb^Gvs, Re^Gvs, Re^Gvs, Rb^Gvs, Rb, Gg, Gs, Rb, Gs, Gs, Gs, Gs, Rb, Rb, Gs, Re^Gvs, Rb^Gvs, Rb^Gvs, Re^Gvs, Re^Gvs, Gs, Rb^Gvs, Rb^Gvs, Rb^Gvs, Rb^Gvs, Rb^Gvs, Rb^Gvs, Rb^Gvs, Gs^Fmf
Gs^Fms, Re^Gvs, Re^Gvs, Rb^Gvs, Rb^Gvs, Rb^Gvs, Rb^Gvs, Rb^Gvs, Hh, Hh, Gg, Re^Gvs, Rb^Gvs, Re^Gvs, Re^Gvs, Re^Gvs, Rb, Rb^Gvs, Rb^Gvs, Re^Gvs, Re^Gvs, Re^Gvs, Gs, Gg, Gg, Rb, Re^Gvs, Re^Gvs, Re^Gvs, Re^Gvs, Rb^Gvs, Rb^Gvs, Gs, Re^Gvs, Re^Gvs, Re^Gvs, Re^Gvs, Re^Gvs, Re^Gvs, Rb^Gvs, Gs^Fmf, Rb^Gvs
