border_size=1
usage=map

Ms, Ms, Ms, Aa, Aa, Aa, Aa, Ms, Ms, Ms, Ms, Ms, Ms, Ms, Ms, Ms, Md, Md, Hhd, Hhd, Re, Re, Hhd, Md, Hhd, Re, Re, Md, Md, Md, Md, Md, Md, Rb, Md, Md, Md, Ms, Ms, Ms, Ms, Ms, Md, Md, Hhd, Hhd, Hhd, Aa, Aa, Aa, Hhd, Hhd, Aa, Aa, Ms, Ms, Ms, Aa, Aa, Aa, Aa, Aa, Ha, Ha, Aa, Aa, Gg^Fp, Gg, Gg^Fp, Gg, Gg, Gg^Fp, Gg^Fp, Gg^Fp, Gg^Fp, Gg^Fp, Gg^Fp, Gg^Fp, Gg^Fp, Gg^Fp, Gg^Fp, Gg^Fp
Ms, Ms, Ms, Aa, Aa, Aa, Aa, Ms, Ms, Ms, Ms, Ms, Ms, Ms, Ms, Ms, Md, Md, Hhd, Hhd, Re, Re, Hhd, Md, Hhd, Re, Re, Md, Md, Md, Md, Md, Md, Rb, Md, Md, Md, Ms, Ms, Ms, Ms, Ms, Md, Md, Hhd, Hhd, Hhd, Aa, Aa, Aa, Hhd, Hhd, Aa, Aa, Ms, Ms, Ms, Aa, Aa, Aa, Aa, Aa, Ha, Ha, Aa, Aa, Gg^Fp, Gg, Gg^Fp, Gg, Gg, Gg^Fp, Gg^Fp, Gg^Fp, Gg^Fp, Gg^Fp, Gg^Fp, Gg^Fp, Gg^Fp, Gg^Fp, Gg^Fp, Gg^Fp
Ms, Ms, Aa, Aa, Aa, Aa, Ms, Ms, Aa, Ms, Ms, Ms, Ms, Ms, Ms, Ms, Ms, Md, Md, Hhd, Re, Hhd, Hhd, Md, Md, Md, Md, Rb, Md, Md, Md, Md, Rb, Rb, Hhd^Vo, Md, Md, Md, Md, Md, Md, Md, Md, Hhd, Hhd, Aa, Aa, Aa, Aa, Aa, Aa, Aa, Aa, Ms, Aa, Aa, Ms, Aa, Aa, Ha, Ha, Ha, Ha, Aa, Aa, Gs, Gg^Fp, Gg^Fp, Gg^Fp, Gg^Fp, Gg, Gg^Fp, Gg^Fp, Gg^Fp, Gg^Fp, Gg^Fp, Gg^Fet, Gg^Fp, Gg^Fp, Gg^Fp, Gg^Fp, Gg^Fp
Ms, Ms, Aa, Aa, Aa, Ha, Ha, Ms, Ms, Ms, Md, Ms, Ms, Ms, Ms, Ms, Md, Md, Md, Hhd, Gd, Re, Re, Md, Re, Re, Re, Rb, Hhd, Md, Md, Hhd, Rb, Md, Md, Md, Md, Md, Md, Md, Md, Md, Hhd, Hhd, Aa, Aa, Aa, Gd, Hhd, Hhd, Hhd, Hhd, Hhd, Ms, Aa, Ms, Aa, Aa, Aa, Aa, Aa, Aa, Aa, Hh, Gs, Gs, Gs^Fp, Gg, Gs, Gg^Fp, Gg, Gg, Gg^Fp, Gg^Fp, Gg^Fp, Gg^Fp, Gg^Fp, Gg^Fp, Gg^Fp, Gg^Fp, Gg^Fp, Gg^Fp
Aa, Aa, Ha, Ha, Ha, Ha, Aa, Ha, Md, Md, Md, Ms, Md, Md, Md, Md, Md, Md, Md, Hhd, Md, Gd, Hhd, Re, Md, Md, Hhd, Rb, Hhd, Rb, Hhd, Co, Hhd, Rb, Hhd, Rb, Rb, Md, Md, Md, Hhd, Hhd, Hhd, Gd, Aa, Aa, Aa, Aa, Aa, Md, Md, Md, Hhd, Ms, Aa, Gs, Aa, Aa, Aa, Gs, Aa^Vea, Aa, Aa, Gs, Gs, Gs, Gg^Fp, Gg^Fp, Gs, Gs, Gg^Em, Gg^Fp, Gg^Fp, Gg^Fp, Gg^Fp, Gg^Fet, Gg^Fp, Gg^Fp, Gg^Fp, Gg^Fp, Gg^Fp, Gg^Fp
Ha, Ha, Ha, Ha, Ha, Gd, Gd, Gd, Hhd, Gd, Hhd, Md, Md, Md, Hhd, Hhd, Md, Md, Md, Md, Hhd, Md, Md, Md, Md, Hhd, Hhd, Hhd^Vo, Co, Co, Co, 2 Ko, Co, Co, Co, Hhd, Rb, Hhd, Md, Hhd, Hhd, Gd, Md, Md, Aa, Aa, Aa, Aa, Aa, Aa, Md, Md, Md, Hhd, Aa, Aa, Aa, Aa, Aa, Aa, Aa, Aa, Gs, Gs, Gs, Gs, Gs^Fp, Gs^Fp, Gg, Gg^Fp, Gg^Fp, Gg^Fp, Gg^Fp, Gg^Fp, Gg^Fp, Gg^Fp, Gg^Fp, Gg^Fp, Gg^Fp, Gg^Fp, Gg^Fp, Gg^Fp
Gd, Gd, Gd, Gd, Gd, Gd, Gd, Hhd, Hhd, Hhd, Hhd, Hhd, Gd, Hhd, Gd, Hhd, Hhd, Md, Md, Hhd, Hhd, Md, Hhd, Md, Hhd, Hhd, Rb, Hhd, Hhd, Hhd, Co, Hhd, Co, Hhd, Hhd, Hhd, Rb, Hhd, Md, Md, Hhd, Gd, Md, Md, Gd, Aa, Aa, Aa, Aa, Aa, Aa, Aa, Hhd, Hhd, Aa, Aa, Aa, Aa, Gs, Aa, Aa, Gs, Gs, Gs, Gs, Gs, Gg^Fp, Gg^Fp, Gg^Fp, Gg^Fp, Gg^Fet, Gg^Fp, Gg^Fp, Gg^Fp, Gg^Fp, Gg^Fp, Gg^Ve, Gg^Fp, Gg^Fp, Gg^Fp, Gg^Fp, Gg^Fp
Gd, Gd, Gd, Gd, Aa, Aa, Aa, Gd, Gd, Gd, Gd, Gd, Hhd, Gd, Gd, Gd, Hhd, Hhd, Md, Md, Md, Md, Hhd, Md, Hhd, Hhd, Rb, Re^Vo, Gd, Hhd, Hhd, Hhd, Hhd, Hhd, Rb, Re^Vo, Gd, Hhd, Hhd, Md, Hhd, Md, Gd, Gd, Md, Gd, Md, Gd, Aa, Aa, Md, Gd, Aa, Aa, Aa, Aa, Aa, Aa, Aa, Gs, Aa, Gs, Gs, Gs, Gs^Ve, Gs, Gg^Fp, Gg, Gg^Fp, Gg^Fp, Gs^Fp, Gg^Fp, Gg^Fp, Gg^Fp, Gg^Fp, Gg^Fp, Gg^Fp, Gg^Fp, Gg^Fp, Gg^Fp, Gg^Fp, Gg^Fp
Gd, Gd, Aa, Aa, Aa, Aa, Aa, Gd, Gd, Gd, Gd, Gd, Hhd, Hhd, Hhd, Hhd, Hhd, Md, Md, Md, Md, Md, Md, Md, Md, Hhd, Hhd, Rb, Rb, Rb, Re, Rb, Re, Rb, Re, Re, Hhd, Hhd, Hhd, Hhd, Hhd, Hhd, Gd, Md, Md, Gd, Gd, Md, Md, Md, Aa, Aa, Aa, Aa, Aa, Gs, Gs^Vh, Aa, Gs, Gs, Gs, Gs, Gs, Gs, Gs, Gs, Gs^Fp, Gg^Fp, Gg^Fp, Gg, Gg^Fp, Gs^Fp, Gg^Fp, Gg^Fp, Gg^Fp, Gg^Fp, Gg^Fp, Gg^Fp, Gg^Fp, Gg^Fp, Gg^Fp, Gg^Fp
Gd, Gd, Gd, Gd, Aa, Aa, Aa, Gd, Gd^Vc, Gd, Gd, Gd, Hhd, Gd, Gd, Hhd, Md, Md, Md, Md, Hhd, Gd, Hhd, Md, Md, Hhd, Hhd, Gd, Re^Vo, Re, Gd, Re, Hhd^Vo, Hhd, Hhd, Re, Hhd, Hhd, Hhd, Hhd, Md, Hhd, Md, Md, Md, Gd, Aa, Aa, Aa, Md, Aa, Aa, Aa, Aa, Gs, Gs, Gs, Gs, Gs, Gs, Gs, Gs, Gs, Gs, Gs, Gs, Gs, Gg^Fp, Gg, Gg, Gg, Gg^Em, Gg^Fp, Gg^Fet, Gg^Fp, Gg^Fp, Gg^Fp, Gg^Fp, Gg^Fet, Gg^Fp, Gg^Fp, Gg^Fp
Gd, Gd, Gd, Aa, Aa, Aa, Aa, Aa, Gd, Gd, Gd, Gd, Gd, Hhd, Gd, Gd, Gd, Gd, Hhd, Hhd, Gd, Gd, Md, Md, Md, Md, Hhd, Hhd, Hhd, Gd, Hhd, Hhd, Hhd, Hhd, Hhd, Hhd, Hhd, Hhd, Md, Md, Hhd, Md, Md, Md, Gd, Aa, Aa, Aa, Aa, Aa, Aa, Aa, Aa, Gs, Gs, Gs, Gs, Gs, Gd, Gs, Gs, Gs, Gs, Gs, Gs, Gs, Gs, Gs^Fp, Gg^Fp, Gg^Fp, Gg, Gg^Fp, Gg^Fp, Gg^Fp, Gg^Fp, Gg^Fp, Gg^Fp, Gg^Fp, Gg^Fp, Gg^Ve, Gg^Fp, Gg^Fp
Gd, Gd, Gd, Aa, Aa, Aa, Gd, Aa, Aa, Gd, Gd, Gd^Es, Gs, Gd, Gs, Gs, Gd, Gd, Gd, Gd, Hhd, Gd, Hhd, Md, Re, Re, Hhd, Hhd, Hhd, Hhd, Hhd, Hhd, Hhd, Re, Hhd, Hhd, Hhd, Re, Re, Hhd, Hhd, Gd, Md, Md, Aa, Aa, Aa, Aa, Aa, Aa, Aa, Aa, Aa, Aa, Aa, Aa, Gd, Gd, Gd, Gs, Gs, Gs, Gs, Gs, Gs^Vh, Gs, Gs, Gs, Gg^Fp, Gg, Gg^Fp, Gg^Fp, Gg^Fp, Gg^Fp, Gg^Fp, Gg^Fp, Gg^Fp, Gg^Fp, Gg^Fp, Gg^Fp, Gg^Fp, Gg^Fp
Gd, Gd, Gd, Gd, Aa, Aa, Aa, Aa, Aa, Aa, Gd, Gs, Gs, Gs^Vc, Gs, Gd, Gd, Hhd, Hhd, Gd, Gd, Gd, Hhd, Hhd, Gd, Re, Re, Hhd, Hhd, Hhd, Hhd, Hhd, Hhd, Hhd, Hhd, Hhd, Hhd, Re, Gd, Re, Gd, Gd, Gd, Hhd, Gd, Gd, Aa, Aa, Aa, Aa, Aa, Aa, Aa, Aa, Aa, Aa, Aa, Aa, Aa, Gd, Gd, Gs, Gs, Gs, Gs, Gs, Gs, Gs^Fp, Gg, Gg, Gg, Gg^Fp, Gg^Fp, Gg^Ve, Gg^Fp, Gg^Fp, Gg^Fp, Gg^Fp, Gg^Fp, Gg^Fp, Gg^Fp, Gg^Fp
Gd, Gs, Gs, Gs, Gs, Aa, Aa, Gd, Aa, Aa, Aa, Gs, Gs, Gd, Gs, Gd, Gs, Gd, Gd, Gd, Gd, Gd, Re, Re, Re, Re, Hhd, Re, Re, Gd, Gd, Gd^Vo, Gd, Hhd, Gd, Hhd, Hhd, Hhd, Gd, Gd, Gd, Gd, Gd, Hhd, Gd, Gd, Gd, Gd, Aa, Aa, Aa, Aa, Aa, Aa, Aa, Aa, Aa, Aa, Aa, Gd, Gd, Gs, Gs, Gs, Gs, Gs, Gs, Gs^Fp, Gg^Fp, Gs, Gs^Fp, Gg^Fp, Gs^Fp, Gg^Fp, Gg^Fp, Gg^Fp, Gg^Ve, Gg^Fp, Gg^Fp, Gg^Fp, Gg^Fp, Gg^Fp
Gs, Gs, Gs, Hh, Hh, Hh, Gs, Gs, Gs, Gs, Gs, Gd, Gs, Gs, Gs, Gd, Gs, Gs, Gd, Hhd, Hhd, Gd, Gd, Hhd, Hhd, Hhd, Hhd, Hhd, Re, Hhd, Hhd, Gd, Re, Re, Gd^Vo, Hhd, Gd, Re, Gd, Gd, Gd, Hhd, Gd, Hhd, Gd, Gd, Gd, Aa, Aa, Aa, Aa, Aa, Aa, Aa, Aa, Aa, Aa, Gd, Gd, Gd, Gs, Gs, Gs, Gs, Gs, Gs, Gs, Gs^Fp, Gg^Fp, Gg, Gg, Gg^Fp, Gg^Fp, Gg^Fp, Gg^Fp, Gg^Fp, Gg^Fp, Gg^Fp, Gg^Fp, Gg^Fp, Gg^Fp, Gg^Fp
Gs, Gs, Hh, Hh, Hh, Gs, Gs, Gs, Aa, Aa, Gs, Gs, Gs, Gs, Gs, Gs, Gs, Gs, Gd, Hhd, Gd, Gd, Gs, Gs, Gs, Gs, Gs, Gd, Hhd, Gd, Hhd, Hhd, Gd, Hhd, Hhd, Hhd, Gd, Gd, Gd, Gd, Gd, Gd, Gd, Gd, Gd, Gd, Gd, Gd, Aa, Aa, Aa, Aa, Aa, Aa, Aa, Aa, Aa, Aa, Gd, Gd, Gd, Gs, Gs, Gs, Gs, Gs^Ve, Gs, Gs, Gs^Fp, Gs^Fp, Gg, Gg, Gg^Fp, Gg^Fp, Gg^Fet, Gg^Fp, Gg^Fp, Gg^Fp, Gg^Fp, Gg^Fp, Gg^Fp, Gg^Fp
Gs, Gs, Gs, Hh, Hh, Gs, Gs, Gd, Gs, Gs, Gs, Gs, Aa, Aa, Gs, Gs, Gd, Gs, Gs, Gs, Gs, Gs, Gs, Hh, Hh, Gs, Hh, Gd, Gd, Hhd, Gd, Gd, Gd, Gd, Gd, Gd, Gd, Gd, Hh, Gd, Gs, Gs, Hh, Gd, Gd, Gd, Gd, Aa, Aa, Aa, Aa, Aa, Aa, Aa, Aa, Gd, Gd, Gd, Gd, Gd, Gd, Gs, Gs, Gs, Gs, Gs, Gs, Gs, Gs, Gs^Fp, Gs^Fp, Gg, Gg, Gg^Fp, Gg^Fp, Gg^Fp, Cv, Gg^Fp, Cv, Gg^Fp, Gg^Fp, Gg^Fp
Gs, Gs, Gs, Gs, Ce, Gs, Gd, Gs, Gs, Gs, Aa, Aa, Gs, Aa, Gs, Gs, Gs, Gs, Gs, Gs, Gs, Gs, Gs, Gs, Gs, Gs, Gs, Gs, Gs, Gd, Gs, Gd, Gs, Gd, Gd, Gd, Gd, Gs, Gd, Gd, Gd, Hh, Hh, Gd, Gd, Gd, Gd, Gd, Gd, Aa, Aa, Aa, Aa, Gd, Aa, Aa, Gd, Gd, Gd, Gd, Gd, Gs, Gs, Gs, Gs, Gs, Gs, Gs, Gs, Gs^Fp, Gg^Fp, Gs^Fp, Gg^Fp, Gg^Fp, Gg^Fp, Cv, Cv^Ve, Cv, Cv^Ve, Cv, Gg^Fp, Gg^Fp
Gs, Gs, Gs, Ce, 1 Ke, Ce, Gs, Gs, Gs, Gs, Gs, Gs, Gs, Gs, Gd, Gs, Gs, Gs, Gs, Gs, Gs, Gs, Gs, Gs, Gs, Gs, Gs, Gs, Gs, Gs, Gs, Gs, Gd, Gd, Gd, Gd, Gd, Gd, Gd, Gd, Gd, Hh, Gs, Gd, Gd, Gd, Gd, Gd, Aa, Aa, Aa, Aa, Gd, Gd, Gd, Gd, Gd, Gd, Gs, Gd, Gs, Gs, Gs, Gs, Gs, Gs, Gs, Gs, Gs, Gs, Gs^Ve, Gg^Fp, Gg, Gg^Fp, Gg^Fp, Cv, Cv^Ve, 4 Kv, Cv^Ve, Cv, Gg^Fp, Gg^Fp
Gs, Gs, Hh, Ce, Ce, Ce, Gs, Gs, Gs, Gs, Gs, Gs, Gs, Gd, Gd, Gs, Gs, Gs, Gs^Vc, Gs, Gs, Gs, Gs, Gd, Gs, Gs, Gs, Gs, Gs, Gs, Gd, Gs, Gd, Gs, Gd, Gd, Gd, Gd, Gd, Gd, Gs, Gs, Gd, Gs, Gd, Gd, Gd, Gd, Gd, Aa, Aa, Gd, Gd, Gd, Gd, Gd, Gd, Gd, Gd, Gs, Gs, Gs, Gs, Gs, Gs, Gs, Gs, Gs, Gs, Gs, Gs^Fp, Gg^Fp, Gg, Gg, Gg^Fp, Cv, Cv, Cv, Cv, Cv, Gg^Fp, Gg^Fp
Gs, Gs, Gs, Gs, Gs, Gs, Gs, Gs, Gs, Gs, Gs, Gs, Gs, Gs, Gd, Gs, Gs, Gs, Gs, Gs, Gs, Gs, Gd, Gd, Gd, Gs, Gs, Gs, Gs, Gs, Gs, Gd, Gs, Gd, Gd, Gd, Gd, Gd, Gd, Gd, Gs, Gd, Gd, Gd, Gd, Gd, Gd, Gd, Gd, Gd, Gd, Gd, Gd, Gd, Gd, Gd, Gd, Gd, Gs, Gs, Gs, Gs, Gs^Vc, Gs, Gs, Gs, Gs, Gs, Gs, Gs, Gg^Fp, Gs, Gg^Fp, Gg, Gg^Fp, Gg^Fp, Gg^Fp, Gg^Fp, Gg^Fp, Gg^Fp, Gg^Fp, Gg^Fp
Gs, Gs, Gs, Gs^Vh, Gs, Gs, Gs, Gs, Aa, Aa, Gs, Gd, Gs, Gs, Gs, Gd, Gd, Gs, Gs, Gs, Gd, Gs, Gd, Gd, Gd, Gd, Gs, Gd, Gd, Gd, Gd, Gs, Gs, Gd, Gd, Gd, Gd, Gd, Gs, Gs, Gs^Vc, Gs, Gs, Gd, Gd, Gd, Gd, Gd, Gd, Gd, Gd, Gd, Gd, Gd, Gd, Gd, Gd, Gs, Gs, Gs, Gs, Gs, Gs, Gs, Gs, Gs, Gs, Gs, Gs, Gs, Gs, Gs^Fp, Gs^Fp, Gg, Gg^Fp, Gg^Fp, Gg^Fp, Gg^Fet, Gg^Fp, Gg^Ve, Gg^Fp, Gg^Fp
Gs, Gs, Gs, Gs, Gs, Gs, Gs, Gs, Gs, Gs, Gs, Aa, Gs, Gs, Gs, Gs, Gs, Gs, Gd, Gd, Gd, Gd, Gd, Aa, Aa, Gd, Gd, Gd, Gd, Gd, Gd, Gd, Gd, Gd, Gd, Gd, Gd, Gd, Gd, Gs, Gs, Gs, Gd, Gd, Gd, Gd, Gd, Gd, Gd, Gd, Gd, Gd, Gs, Gd, Gs^Vc, Gs, Gs, Gs, Gs, Gs, Gs, Gs, Gs, Gs, Gs, Gs, Gs, Gs, Gs, Gs, Gs, Gs, Gs, Gg^Fp, Gg^Fp, Gg, Gg, Gg^Fp, Gg^Fp, Gg^Fp, Gg^Fp, Gg^Fp
Gs, Gs, Gs, Gs, Gs, Gs, Gs, Gs, Gs, Gs, Gs, Aa, Aa, Gs, Gs, Ds, Ds, Ds, Ds, Ds, Ds, Gd, Gd, Aa, Aa, Aa, Aa, Gd, Gd, Gd, Gd, Gd, Gd, Gd, Gd, Gd, Gd, Gd, Gs, Gs, Gd, Gd, Gd, Gd, Gd, Gd, Gd, Gd, Gd, Gd, Gd, Gd, Gs, Gs, Gs, Gs, Gs, Gs, Gs, Gs, Gs, Gs, Gs, Gs, Gs, Gs, Gs, Gs, Gs, Gs, Gs, Gs, Gs, Gs^Fp, Gg^Fet, Gg^Fp, Gs^Fp, Gg^Fp, Gs^Fp, Gg^Fp, Gg^Fp, Gg^Fp
Gs, Gs, Gs, Gs, Gs, Gs, Gs, Gs, Gs, Aa, Gs, Gs, Gs, Gs, Ds, Ds, Ww, Ww, Ww, Ww, Ww, Ds, Ds, Gd, Aa, Aa, Aa, Aa, Aa, Gd, Gd, Gd, Gd, Gd, Gd, Gd, Gd, Gd, Gd, Gs, Gd, Gd, Gd, Gd, Gd, Gs, Gd, Gd, Gs, Gd, Gd, Gs, Gs, Gs, Gs, Gs, Gs, Gs, Gs, Gs, Gs, Gs, Gs, Gs, Gs^Es, Gs, Gs, Gs, Gs, Gs, Gs, Gs, Gs, Gs^Fp, Gs^Fp, Gg^Fp, Gg^Fp, Gg^Fp, Gg^Fp, Gg^Fp, Gg^Fp, Gg^Fp
Gs, Gs, Gs, Gs, Gs, Gs, Gs, Gs, Gs, Gs, Gs, Gs, Gs, Gs, Ds, Ww, Ww, Wo, Wo, Wo, Ww, Ww, Ds, Gd, Aa, Aa, Aa, Aa, Gd, Gd, Gd, Gd, Gd, Gd, Gd, Gs, Gd, Gd, Gd, Gd, Gd, Gd, Gd, Gd, Gd, Gs, Gs, Gs, Gs, Gs, Gd, Gs, Gs, Gs, Gs, Gs, Gs, Gs, Gs, Gs, Gs, Gs, Gs, Gs, Gs, Gs, Gs, Gs, Gs, Gs^Vh, Gs, Gs, Gs, Gs^Fp, Gg^Fp, Gg^Fp, Gg^Fp, Gg^Em, Gg^Fp, Gg, Gg^Fp, Gg^Fp
Rr, Rr, Rr, Rr, Rr, Gs, Gs, Gs, Gs, Gs, Gs, Gs, Gs, Gs, Ds, Ww, Ww, Wo, Wo, Ww, Ww, Ww, Ds, Gd, Aa, Aa, Aa, Aa, Aa, Gd, Gd, Gd, Gd, Gs, Gs, Gd, Gd, Gd, Gd, Gd, Gd, Gd, Gd, Gs, Gs, Gs, Gs, Gs^Vc, Gs, Gs, Gd, Gs, Gs, Gs, Gs, Gs, Gs, Gs, Gs, Gs, Gs, Gs, Gs, Gs, Gs, Gs, Gs, Gs, Gs, Gs, Gs, Gs, Gs, Gs, Gg^Fp, Gg, Gs^Fp, Gg^Fp, Gg^Fp, Gg^Fet, Gg^Fp, Gg^Fp
Gs, Gs, Gs, Gs, Gs, Rr, Rr, Gs, Gs, Gs, Gs, Gs, Gs, Gs, Ds, Ds, Ww, Wo, Ww, Ww, Ww, Ds, Gd, Gd, Aa, Aa, Aa, Aa, Aa, Aa, Gd, Gd, Gs, Gs, Gs^Vh, Gs, Gs, Gd, Gd, Gd, Gd, Gd, Gs, Gs, Gs, Gs, Ww, Gs, Gs, Gs, Gs, Gs, Gs, Gs, Gs, Gs, Gs, Gs, Gs, Gs, Gs^Vh, Gs, Gs, Gs, Gs, Gs, Gs, Gs, Gs, Gs, Gs, Gs, Gs, Gs, Gs^Fp, Gg^Fp, Gg^Fp, Gg^Fp, Gg^Fp, Gs^Fp, Gg^Fp, Gg^Fp
Gs, Gs, Gs, Gs, Gs, Gs, Gs, Rr, Rr, Rr, Gs, Gs, Gs, Ds, Ds, Ww, Ww, Ww, Ww, Ds, Ds, Ds, Gd, Gd, Aa, Aa, Aa, Aa, Aa, Gd, Gd, Gd, Gs, Gs, Gs, Gs, Gs, Gd, Gs, Gs, Gs, Gd, Gs, Gs, Ww, Ww, Gs, Ww, Ww, Gs, Gs, Gs, Gs, Gs, Gs, Gs, Gs, Gs, Gs, Gs, Gs, Gs, Gs, Gs, Gs, Gs, Gs, Gs, Gs, Gs, Gs, Gs, Gs, Gs, Gs^Fp, Gg^Fp, Gs, Gg^Fp, Gs^Fp, Gs, Gg^Fp, Gg^Fp
Gs, Gs, Gs, Gs, Gs, Gs, Gs, Gs, Gs, Gs, Rr, Gs, Gs, Ds, Ww, Ww, Ww, Ww, Ds, Ds, Gs, Gd, Gd, Aa, Aa, Aa, Aa, Gd, Gd, Gd, Gs, Gd, Gs, Gs, Gs, Gd, Gd, Gd, Gs, Gd, Gs, Gs, Ww, Ww, Gs, Gs, Gs, Gs, Gs, Ww, Ww, Ww, Ww, Ww, Ww, Gs, Gs, Gs, Gs, Gs, Gs, Gs, Gs, Gs, Gs, Gs, Gs, Gs, Gs, Gs, Gs, Gs, Gs, Gs, Gs, Gs, Gs, Gs, Gs, Gs, Ww, Ww
Gs, Gs, Gs, Gs, Gs, Gs, Gs, Gs, Ww, Gs, Ww, Wwf, Wwf, Ww, Ds, Ds, Ds, Ds, Gs, Gs, Gd, Gd, Gs, Gs, Gd, Gd, Gd, Gd, Gd, Gd, Gs, Gd, Gs, Gs, Gs, Gs, Gs, Gs, Gs, Gs, Ww, Ww, Gs, Gs, Gs, Gs, Gs, Gd, Gs, Gs, Gs, Gs, Gs, Gs, Gs, Ww, Ww, Gs, Gs, Gs, Gs, Gs, Gs, Gs, Gs, Gs, Gs, Gs, Ww, Ww^Bw|, Ww, Ww, Ww, Gs, Gs, Gs, Gs, Gs, Ww, Ww, Gs, Gs
Gs, Gs, Gs, Gs, Gs, Gs, Ww, Ww, Ww, Ww, Ww, Wwf, Wwf, Rr, Rr, Rr, Gs, Gs, Gs, Gs, Gs, Rr, Rr, Rr, Gd, Gd, Gs, Gd, Gs, Gs, Gs, Gs, Gs, Gs, Gs, Gs, Gs, Gs, Gd, Gs, Ww, Gs, Gs, Gs, Gs, Gs, Gs, Gs, Gs^Vh, Gs, Gs, Gs, Gs, Gs, Gs, Gs, Gs, Ww, Ww, Gs, Gs, Gs, Gs, Gs, Gs, Gs, Ww^Bw\, Ww, Gs, Re, Gs, Gs, Gs, Ww, Ww, Gs, Ww, Ww, Gs, Gs, Gs, Gs
Gs, Gs, Gs, Ww, Ww, Ww, Ww, Ww, Gs, Ww, Gs, Ww, Ww, Gs, Gs, Gs, Rr, Rr, Rr, Rr, Rr, Gs, Gs, Gd, Rr, Rr, Rr, Rr, Rr, Rr, Rr, Gs, Gs, Gs, Gs, Gs, Gs, Gs, Gs, Gs, Gd, Ww, Gs, Gs, Gs, Gs, Gs, Gs, Gs, Gs, Gs, Gs, Gs, Gs, Gs, Gs, Gs, Gs, Gs, Ww, Ww, Gs, Gs, Gs, Ww, Ww, Gs, Re, Gs, Re, Re, Gs, Gs, Gs, Gs, Ww, Gs^Vh, Gs, Gs, Gs, Gs, Gs
Gs, Gs, Gs, Ww, Ww, Ww, Gs, Gs, Gs, Gs, Gs, Gs, Gs, Ww, Ww, Gs, Gs, Gs, Gs, Gs, Gs, Gs, Gs, Gs, Gs, Gs, Gs, Gs, Gs, Gs, Gs, Rr, Rr, Rr, Rd, Gs, Gs, Gs, Gs, Gs, Ww, Ww, Gs, Gs, Gs, Gs, Gs, Gs, Gs, Gs, Gs, Gs, Gs, Gs, Gs, Gs, Gs, Gs, Gs, Gs, Gs, Ww, Ww, Ww^Bw\, Re, Gs, Gs, Re, Gs, Gs, Re, Gs, Gs, Gs, Gs, Gs, Gs, Gs, Gs, Gs, Gs, Gs
Gs, Gs, Ww, Ww, Ww, Gs, Gs, Gs, Gs, Gs^Vh, Gs, Gs, Gs, Gs, Gs, Ww, Ww, Ww, Ww, Gs, Gs, Gs, Gs, Gs, Gs, Gs, Gs, Gs, Gs, Gs, Gs, Gs, Gs, Gs, Gs, Rr, Ww^Bw\, Ww, Ww, Ww, Gs, Gs, Gs, Gs, Gs, Gs, Gs, Gs, Gs, Gs, Gs, Gs, Gs, Gs, Gs, Gs, Gs, Gs, Rr, Gs^Vh, Rr, Gs, Gs, Gs, Re, Gs^Vh, Gs, Ce, Ke, Ce, Rr, Rr, Rr, Rr, Rr, Rr, Rr, Gs, Gs, Gs, Gs, Gs
Ww, Ww, Ww, Ww, Gs, Gs, Gs, Gs, Gs, Gs, Gs, Gs, Gs, Gs, Gs, Gs, Gs, Gs, Gs, Ww, Gs, Gs, Gs, Gs, Gs, Gs, Gs, Gs, Gs, Gs, Gs, Gs, Ww, Ww, Ww, Ww, Ww, Rr, Rr, Gs, Gs^Vh, Gs, Gd, Gs, Gs, Gs, Gs, Gs, Gs, Gs, Gs, Gs, Gs, Gs, Rr, Rr, Rr, Rr, Gs, Rr, Gs, Rr, Rr, Gs, Gs, Re, Ce, Ke, Ce, Ke, Ce, Gs, Gs, Gs^Vh, Gs, Gs, Gs, Rr, Rr, Rr, Rr, Rr
Ww, Ww, Gs, Gs, Gs, Gs, Gs, Gs, Gs, Gs, Gs, Gs, Gs, Gs, Gs, Gs, Gs, Gs, Gs, Ww, Ww, Gs, Gs, Gs, Gs, Gs, Gs, Gs, Gs, Gs, Ww, Ww, Gs, Gs, Gs, Gs, Gs, Gs, Gs, Rr, Rr, Rr, Rr, Rr, Rr, Gs, Gs, Gs, Gs, Gs, Rr, Rr, Rr, Rr, Gs^Vh, Gs, Gs, Gs, Gs, Gs, Gs, Gs, Gs, Rr, Rr, Gs, Rr, Ke, 3 Ke, Ke, Gs, Gs, Gs, Gs, Gs, Gs, Gs, Gs, Gs, Gs, Gs, Gs
Gs, Gs, Gs, Gs, Gs^Vh, Gs, Gs, Gs, Gs, Gs, Gs, Gs, Gs, Gs, Gs, Gs, Gs, Gs, Gs, Gs, Gs, Ww, Ww, Gs, Ww, Gs, Ww, Ww, Ww, Ww, Gs, Gs, Gs, Gs, Gs, Gs, Gs, Gd, Gs, Gs, Gs, Gs, Gs, Gs, Gs, Rr, Rr, Rr, Rr, Rr, Gs, Gs, Gs, Gs, Gs, Gs, Gs, Gs, Gs, Gs, Gs, Gs, Gs, Gs, Gs, Rr, Gs, Ce, Gs^Vh, Ce, Gs, Gs, Gs, Gs, Gs, Gs, Gs, Gs, Gs, Gs, Gs, Gs
Gs, Gs, Gs, Gs, Gs, Gs, Gs, Gs, Gs, Gs, Gs, Gs, Gs, Gs, Gs^Vh, Gs, Gs, Gs, Gs, Gs, Gs, Gs, Gs, Ww, Gs, Ww, Gs, Ww, Gs, Gs, Gs, Gd, Gs, Gs, Gs, Gs, Gs, Gs, Gs, Gs, Gs, Gs, Gs, Gs, Gs, Gs, Gs, Gs, Gs, Gs, Gs, Gs, Gs, Gs, Gs, Gs, Gs, Gs, Gs, Gs, Gs, Gs, Gs, Gs, Gs, Gs, Gs, Gs, Gs, Gs, Gs, Gs, Gs, Gs, Gs, Gs, Gs, Gs, Gs, Gs, Gs, Gs
Gs, Gs, Gs, Gs, Gs, Gs, Gs, Gs, Gs, Gs, Gs, Gs, Gs, Gs, Gs, Gs, Gs, Gs, Gs, Gs, Gs, Gs, Gs, Gs, Gs, Gs, Gs, Gs, Gs, Gs, Gs, Gd, Gs, Gs, Gs, Gs, Gs, Gs, Gs, Gs, Gs, Gs, Gs, Gs, Gs, Gs, Gs, Gs, Gs, Gs, Gs, Gs, Gs, Gs, Gs, Gs, Gs, Gs, Gs, Gs, Gs, Gs, Gs, Gs, Gs, Gs, Gs, Gs, Gs, Gs, Gs, Gs, Gs, Gs, Gs, Gs, Gs, Gs, Gs, Gs, Gs, Gs