Md^Qhh, Md^Qhh, Md^Qhh, Md^Qhh, Mm^Qhh, Ms^Qhh, Ms^Qhh, Ms^Qhh, Ms^Qhh, Mm^Qhh, Ms^Qhh, Ha^Qhh, Ha^Qhh, Xue, Xue, Cud^Qhh, Uhe^Qhh, Uhe^Qhh, Xue^Qhh, Xue^Qhh, Xor^Qhh, Uu, Uhe^Dr, Uhe^Qhh, Ur, Xue, Xue, Xue, Xor, Xor, Xue, Cud, Rp, Rr, Xue, Xue, Hh^Qhh, Hh^Qhh, Mm^Qhh, Mm^Qhh, Md^Qhh, Md^Qhh, Md^Qhh, Ms^Qhh, Ms^Qhh, Md^Qhh, Ms^Qhh, Md^Qhh, Ms^Qhh, Md^Qhh, Md^Qhh, Rd^Qhh, Md^Qhh, Rd^Qhh
Md^Qhh, Ms^Xm, Md^Xm, Md^Xm, Mm, Ms, Ms, Ms, Ms, Ms, Ha, Ms, Ha^Qhh, Uue^Dr, Uhe^Qhu, Ur^Dr, Ha^Qhh, Uhe^Dr, Cud, Xue, Cud^Dr, Xue^Qhh, Xue^Qhh, Uue^Dr, Xor, Xue, Cud^Dr, Uhe^Qhh, Uue^Dr, Xor, Xue, Uhe^Dr, Uue^Dr, Rd, Rp, Hh, Mm, Mm^Qhh, Mm^Qhh, Md^Qhh, Mm, Mm^Qhh, Mm, Ms^Xm, Ms^Xm, Ms^Xm, Ms^Xm, Ms^Xm, Ms^Xm, Md^Xm, Mm, Hh, Hh^Qhh, Mm^Xm
Md^Qhh, Ms^Xm, Ms^Xm, Ms, Ms, Ms^_mh, Ha^Dr, Ms, Ms, Ms, Hh^Qhh, Ha^Qhh, Rd, Uue^Dr, Hh^Qhh, Mm^Qhh, Ms, Hh^Dr, Hh^Edt, Uhe, Hh^Edt, Hh, Hh^Qhh, Rr, Uue^Dr, Cud^Dr, Hh, Hh^Dr, Hh^Edt, Hh, Mm, Mm, Mm, Rd, Rr, Hh, Hh, Mm, Hh, Mm^Qhh, Hh^Es, Mm^Qhh, Mm^Qhh, Md^Xm, Md^Qhh, Ms^Xm, Md^Xm, Ms^Xm, Ms, Ms^Xm, Mm^Qhh, Mm^Qhh, Mm^Xm, Mm^Xm
Ms^Qhh, Ms^Xm, Ms^Xm, Md^Xm, Mm^Qhh, Ms^Qhh, Ms^Qhh, Mm, Mm, Hh^Es, Hh^Qhh, Uue^Dr, Uhe^Qhu, Hh, Mm^Qhh, Ms, Ms, Ms, Hh, Hh^Edt, Mm, Mm, Mm^Qhh, Ur, Mm, Mm, Hh, Hh^Edt, Hh, Mm, Mm, Mm, Hh^Dr, Hh, Mm, Rp, Rp, Rr, Rr, Hh^Qhh, Hh^Dr, Mm, Mm, Mm^Qhh, Md^Xm, Mm^Qhh, Mm^Qhh, Mm^_mhh, Ms^Qhh, Ms^Qhh, Hh, Mm, Mm, Mm
Ms^Qhh, Ms^Xm, Ms^Qhh, Ms^Qhh, Mm, 4 Kfr, Cfr, Ms^Qhh, Hh^Qhh, Hh^Qhh, Rp^Edt, Rp^Edt, Hh, Hh^Qhh, Hh, Ms, Ms, Ha, Mm, Mm, Mm, Mm, Mm^Qhh, Ur^Dr, Mm, Mm, Mm, Hh, Mm, Cfr, Mm, Md^Xm, Ms^Xm, Mm, Mm, Hh, Hh, Hh, Rr, Hh, Mm, Mm^Qhh, Mm^Qhh, Mm, Ms, Ms, Ms^Qhh, Mm^Qhh, Cfr^Dr, Hh, Gs^Edt, Hh, Hh, Hh
Ms^Qhh, Ms^Xm, Ms^Qhh, Mm, Cfr^Dr, Cfr^Edt, Gd^Edt, Hh^Qhh, Hh^Edt, Rp^Edt, Rp^Edt, Hh^Es, Hh^Qhh, Mm^Qhh, Ha, Ha^Es, Ha, Ha, Ha, Cfr^Dr, Mm, Hh^Qhh, Hh^Dr, Rr, Hh, Hh, Hh, Hh, Mm, Mm, Ms, Ms^Xm, Ms, Ms, Ms, Mm, Mm, Hh^Dr, Rp, Hh, Hh, Cfr^Dr, 7 Kfr^Dr, Ms^Qhh, Ms, Ms^Qhh, Ms^Qhh, Mm^Qhh, Hh^Qhh, Hh, Gs^Edt, Gs, Rb^Gvs, Rb^Gvs
Md, Ms^Qhh, Md, Md, Hhd, Gd^Edt, Gd^Edt, Hh, Hh, Rp^Edt, Hh, Hh^Qhh, Mm, Ms, Ms, Ms, Ms, Ms, Ha^Qhh, Hh^Qhh, Hh^Qhh, Mm^Qhh, Hh^Es, Rp, Hh, Mm, Hh, Hh, Mm, Mm, Mm, Ms, Ms, Ms, Hh, Gs, Gd^Edt, Rd, Rp^Edt, Rr^Edt, Hh^Edt, Cfr^Edt, Mm^Qhh, Mm^Qhh, Ms^Xm, Ms^Xm, Ms, Mm, Hh^Qhh, Hh, Re^Gvs, Re^Gvs, Re^Gvs, Re^Gvs
Hhd, Hhd, Hhd, Md, Hhd, Gd^Es, Gs, Rr, Rp, Rp, Rp, Hh^Qhh, Mm^Qhh, Mm, Mm^_mh, Mm, Hh^Qhh, Ha^Qhh, Rr, Rr, Cfr^Dr, Kfr^Dr, Hh^Eb, Rp, Hh^Dr, 3 Kfr, Cfr^Dr, Mm, Rb^Es, Rb^Gvs, Rb^Gvs, Mm, Mm, Hh^Es, Rd, Gs^Edt, Gd, Rr^Edt, Rp^Edt, Hh, Hh, Mm, Mm^Qhh, Mm, Ms, Ms, Mm, Mm, Hh^Qhh, Rb^Gvs, Re^Gvs, Re^Gvs, Re^Gvs, Rb^Gvs
Hhd, Gd, Gd^Dr, Gd, Gs^Efm, Gd, Hh, Hh, Rr, Hh, Hh^Vhr, Mm, Ms^Qhh, Ms, Ms, Mm, Hh^Qhh, Rr, Gd^Es, Rr, Rr, Cfr, Rp, Rp, Rd^Dr, Cfr^Edt, Rd^Edt, Rb, Rb^Gvs, Rb^Gvs, Rb^Gvs, Mm, Rr, Rd, Hh, Rr, Rr, Gd, Rd, Hh, Ha, Hh^Dr, Hh^Vhr, Mm^Qhh, Mm, Ms, Hh, Mm, Hh^_mh, Rb^Qhh, Rb^Vhr, Rb^Gvs, Rb^Gvs, Re^Gvs
Hh, Cfr, 5 Kfr, Cfr^Edt, Gs^Edt, Gs^Efm, Hh^Es, Hh^Edt, Hh, Rd, Hh^Qhh, Hh^Qhh, Ms, Ms, Hh^Qhh, Ha^Qhh, Rp, Rd, Gd, Rp, Ww, Rp, Rd, Rp, Hh, Rd, Hh, Rd, Rb^Vhr, Rb^Gvs, Rb^Gvs, Mm, Rr, Rb^Vhr, Hh^Qhh, Rp, Hh, Rr, Rd, Rd, Ha, Ha, Mm^Qhh, Mm^Qhh, Mm, Cfr^Edt, Gs^Edt, Hh, Gs^Qhh, Gs^Qhh, Gs, Rb, Gs, Rb
Mm, Mm, Mm, Cfr^Dr, Mm, Hh^Vhr, Mm, Hh^Edt, Hh, Rr, Hh, Mm^Qhh, Mm^Qhh, Mm^Qhh, Hh, Rp, Rp, Gd, Gd, Wwr, Ww^Dr, Rd, Rr, Hh, Hh^Qhh, Hh^Qhh, Hh^Qhh, Hh, Hh, Rb^Gvs, Rb^Gvs, Rp, Hh^Qhh, Hh^Qhh, Mm, Hh^Qhh, Hh, Rp, Rd, Hh, Mm^Qhh, Ms^Qhh, Ms, Ms, Hh^Fmf, Hh^Edt, Gs^Qhh, Gs^Qhh, Gll^Fmf, Gs, Hh, Hh, Hh, Hh
Mm, Mm, Ms, Mm, Mm, Mm, Hh, Hh^Edt, Rp, Rr, Hh^Es, Mm^Qhh, Rp, Chr^Dr, Rr, Rd, Hh, Rp, Wwr, Ww, Ww, Rr^Dr, Hh^Qhh, Hh^Qhh, Mm, Hh^Fmf, Mm, Mm^Qhh, Rd, Rb, Rr, Rr, Hh^Qhh, Chr^Dr, Mm, Hh^Qhh, Hh^Qhh, Hh, Rd, Hh, Hh, Ha^Qhh, Mm, Ms, Hh^Qhh, Gs^Qhh, Gs, Gs^Fmw, Gll^Fmf, Hh^Fmf, Mm, Mm^Xm, Mm, Mm
Mm^Xm, Ms^Xm, Ms^Xm, Ms, Ms, Mm, Mm, Hh, Hh, Rr, Rp, Hh, Rp, Rr, Hh, Hh, Gs, Rp, Ww^Bsb\, Ww, Ww^Dr, Rp, Hh^Qhh, Mm^Qhh, Chr^Dr, Mm, Mm, Hh^Qhh, Hh, Rr, Rr, Hh^Vhr, Hh^Qhh, Mm, Mm^Xm, Mm, Mm, Hh^Qhh, Hh, Rr, Hh^Vhr, Hh^Qhh, Mm^Qhh, Mm^Qhh, Hh^Dr, Gs^Dr, Hh^Es, Gs^Edt, Gs^Edt, Hh, Mm, Mm, Mm, Mm
Ms, Mm, Ms, Ms^Xm, Ms, Mm, Ms, Hh, Mm, Rp, Hh, Rp, Rr, Rd, Hh, Hh, Wwr, Wwr, Wwr, Rp, Rp, Rp, Hh, Hh^Qhh, Hh^Qhh, Mm^_mh, Mm, Hh^Qhh, Rd, Rd, Hh^Qhh, Hh^Qhh, Mm, Mm^_mh, Mm^Xm, Mm, Hh, Hh^Qhh, Mm^Qhh, Rr, Rr, Hh, Mm, Mm, Mm, Hh^Dr, Hh^Fmf, Hh^Fmf, Gd^Edt, Hh^Vhr, Chr^Dr, Mm, Mm, Mm
Mm^Xm, Ms^Xm, Ms, Ms, Ms, Ms, Ms, Mm, Mm, Hh, Hh^Fmf, Rd, Rp, Hh, Gd, Gd, Re^Gvs, Rb^Gvs, Rb^Dr, Gs^Dr, Gd^Edt, Rp^Edt, Rb^Dr, Rb^Vhr, Rb, Mm^Qhh, Hh^Qhh, Hh^Qhh, Rr, Hh, Hh^Qhh, Mm, Mm^Xm, Mm^Xm, Mm^Xm, Mm, Hh, Mm^Qhh, Mm^Qhh, Hh, Rd, Hh, Mm, Mm^Xm, Mm, Mm, Md, Hhd, Gd, Gd^Dr, Chr^Edt, 8 Chr^Kov, Chr^Edt, Hh
Mm^Xm, Mm^Xm, Mm, Mm, Hh^Dr, Mm, Hh, Hh, Hh^Dr, Hh, Gd, Gd, Rp^Edt, Gd, Chr, Re^Vhr, Rb^Dr, Rb^Gvs, Rb^Gvs, Rb^Dr, Rr, Rr^Edt, Rb^Gvs, Rb^Gvs, Rb^Dr, Mm^Qhh, Hh, Rr, Rd, Gd, Mm^Qhh, Mm, Mm, Mm, Mm, Chr, Mm, Mm^Qhh, Gs^Vhr, Gs^Es, Rd, Mm, Hh, Mm, Mm, Md, Md, Hhd, Gd^Edt, Gd^Edt, Hhd^Qhux, Chr^Dr, Hh^Qhux, Hh^Qhux
Mm, Mm, Mm, Mm, Hh, Hh, Ha^Es, Ha, Ha^Edt, Hh, Rb^Gvs, Rb^Edt, Rb, Rp, Chr^Edt, Chr^Dr, Rd^Edt, Rb^Gvs, Rr^Edt, Rr^Edt, Gd^Dr, Rb^Dr, Rb^Gvs, Rb^Dr, Gs^Dr, Hh, Chr, Rr, Gs, Gs, Mm, Hh^Qhh, Hh^Qhh, Mm, Mm, Mm, Mm^Qhh, Mm^Qhh, Rb^Gvs, Rb^Gvs, Rb^Gvs, Rr, Gs, Hh, Hh, Hh, Hhd, Hhd^Dr, Gd, Hhd^Qhux, Md^Qhux, Md^Qhux, Mm^Qhux, Mm^Qhux
Hh, Hh, Hh, Hh^Es, Ha^Edt, Ha^Edt, Ha, Ha, Rb^Gvs, Rb^Gvs, Rb^Gvs, Rb^Gvs, Re^Gvs, Rd, Rd, Rd, Rr, Rr, Chr, Hhd, 2 Khr, Gd^Edt, Rb^Vhr, Rb, Rd^Wm, Rb^Vhr, Gs^Dr, Rd, Rr, Gs^Efm, Hh, Hh, Hh^Qhh, Mm^Qhh, Hh^Qhh, Hh^Qhh, Rb^Gvs, Hh, Rb^Gvs, Rb^Gvs, Rb^Gvs, Rd^Vhr, Gs, Rb, Re^Gvs, Re^Gvs, Re^Gvs, Gd, Gd^Dr, Hhd^Qhux, Md^Qhux, Ms^Qhux, Ms^Qhux, Mm^Qhux
Gg, Gg, Gg, Hh, Hh^Es, Ha, Ha^Gvs, Rb^Gvs, Rb^Gvs, Rb^Gvs, Re^Gvs, Re^Gvs, Re^Gvs, Rb^Gvs, Gs, Gs, Gs^Edt, Hh, Gs^Dr, Chr^Edt, Chr^Dr, Chr, Hh, Hh, Chr^Dr, Chr, Gs, Gs, Gs, Rr, Rr, Gs, Chr^Dr, Hh, Rb^Gvs, Rb^Gvs, Re^Gvs, Rb^Gvs, Rb^Gvs, Rb^Gvs, Rr, Rr, Rb^Gvs, Rb^Gvs, Re^Gvs, Re^Gvs, Re^Gvs, Hh^Qhux, Hh^Qhux, Mm^Qhux, Ms^Qhux, Ms^Qhux, Ms^Qhux, Ms^Qhux
Hh^Qhh, Hh, Gg, Gs, Gs, Ha, Rb, Rb^Gvs, Re^Gvs, Re^Gvs, Re^Gvs, Re^Gvs, Re, Rd^Wm, Rd, Gs^Edt, Rd^Edt, Gs, Rd, Rr^Edt, Rr, Hh, Hh, Gs, Gd, Gs, Gs^Efm, Gs^Efm, Gg^Efm, Gs^Efm, Gg^Efm, Rd, Rd, Rd, Rd, Re^Gvs, Rd, Re^Gvs, Rr, Rd, Rd, Rb, Rb^Gvs, Rb^Gvs, Rb^Gvs, Re^Gvs, Re^Gvs, Hh^Qhux, Mm^Qhux, Mm^Qhux, Ms^Qhux, Ms^Qhux, Ms^Qhux, Ms^Qhux
Ha^Qhh, Ha^Qhh, Ha^Qhh, Hh, Ms^Qhh, Gs, Gs, Rb, Rb, Re^Vhr, Re, Re, Chr^Edt, Hh, Hh, Gs^Edt, Gs^Edt, Rd, Hh, Gs, Rb, Rb, Rb^Gvs, Rb, Rb^Gvs, Gs, Gs, Gs, Gs, Gg^Efm, Gs, Gg^Efm, Gg, Gg, Hh, Rd, Hh, Rd^Vhr, Hh, Gs, Gs, Rb^Wm, Rb, Rb^Gvs, Rb^Gvs, Re^Gvs, Rb^Gvs, Hh^Qhux, Mm^Qhux, Ms^Qhux, Ms^Qhux, Ms^Qhux, Ms^Qhux, Ms^Qhux
Mm^Qhh, Ms^Xm, Ms^Xm, Ms^Qhh, Ms, Ms^Qhh, Ms^Qhh, Ha, Ha, Ha, Gs, Hh, Mm^Qhh, Mm^Qhh, Mm^Qhh, Mm, Mm, Mm, Hh^Edt, Rb, Rb^Gvs, Rb^Gvs, Rb^Gvs, Rb^Gvs, Re^Gvs, Rb^Gvs, Hh, Hh, Gs, Gg^Dr, Hh, Hh, Hh^Dr, Hh, Hh^Dr, Hh^Dr, Mm, Hh, Hh, Hh, Hh, Hh, Rb, Rb^Gvs, Gs, Rb^Gvs, Gd^Vhr, Hh^Qhux, Hh^Qhux, Mm^Qhux, Hh^Qhux, Ms^Qhux, Mm^Qhux, Ms^Qhux
Mm^Qhh, Mm, Mm^Xm, Mm^Xm, Ms^Xm, Ms, Ms^Qhh, Chr^Dr, Mm^Qhh, Mm^Qhh, Mm^Qhh, Mm^Qhh, Mm, Mm, Mm, Mm^Qhh, Chr^Qhh, Mm, Gs^Edt, Hh, Rb, Rb^Gvs, Re^Gvs, Re^Gvs, Re^Gvs, Rb^Gvs, Rb, Gs, Chr^Edt, Chr^Edt, Mm, Mm, Mm, Mm, Chr, Mm, Mm, Mm, Mm, Mm^Xm, Mm, Hh, Hh^Dr, Hh, Hh, Chr, Chr^Dr, Hh^Dr, Hh^Dr, Hh^Qhux, Gs, Hh^Qhux, Gll^Fdf, Hh^Qhux
Hh^Qhh, Hh^Qhhf, Hh^Qhhf, Mm^Xm, Mm, Ms, Ms, Ms^Qhh, Ms^Xm, Mm^Xm, Mm^Xm, Mm, Mm^Xm, Mm, Mm, Mm, Chr^Dr, Chr^Qhh, Hh^Qhh, Hh, Rb^Vhr, Rb^Gvs, Rb^Gvs, Re^Gvs, Re^Es, Rb^Gvs, Rb^Gvs, Gs^Dr, Gs^Wm, Chr^Dr, Chr^Dr, Mm, Mm, Mm, Mm, Mm, Mm, Mm^Xm, Mm^Xm, Mm, Ms, Mm, Mm^Xm, Mm, Mm, Mm, Mm, Mm, Hh^Fdf, Gs, Gll^Fdf, Gs^Fp, Gs^Fp, Gs^Fp
Hh, Gll^Fdf, Gs, Hh^Qhhf, Hh^Qhh, Mm^_mh, Mm, Ms, Mm, Ms^Xm, Ms^Xm, Ms^Xm, Ms^Xm, Mm^Xm, Ms^Xm, Mm, Mm, Mm, Mm, Hh^Qhh, Ha^Qhh, Rb^Gvs, Rb^Gvs, Rb^Gvs, Rb^Gvs, Rb^Gvs, Rb^Gvs, Rb^Gvs, Rb^Gvs, Hh, Rb, Hh, Gs, Hh, Hh, Mm, Mm, Mm, Mm, Mm^Xm, Mm^Xm, Ms, Ms, Ms^Xm, Ms^Xm, Mm, Ms, Mm, Ms, Hh^Fdf, Hh^Fdf, Gs, Gs, Gs
Gs, Gs, Gs, Hh, Hh^Vhr, Hh^Qhh, Mm, Mm, Mm, Mm, Mm^Xm, Ms^Xm, Ms^Xm, Ms^Xm, Ms, Ms, Ms^Xm, Ms^Xm, Ms, Mm, Ha^Qhh, Rb^Gvs, Rb^Gvs, Rb^Gvs, Rb^Gvs, Rb^Gvs, Rb^Gvs, Rb^Gvs, Rb^Gvs, Rb^Gvs, Rb^Gvs, Rb^Gvs, Rb^Gvs, Gs, Gs, Hh, Hh, Mm, Mm, Mm, Mm, Mm, Mm, Ms^Xm, Ms^Xm, Ms, Ms, Ms^Xm, Ms^Xm, Ms, Ms, Hh^Fdf, Ha^Fma, Hh^Fp
Gs, Co, Co, Gs, Hh, Hh^Qhh, Mm, Mm, Hh^Fp, Mm, Mm, Ms^Xm, Ms, Ms^Xm, Ms, Ms, Ms, Ms, Mm, Mm, Mm, Ha^Qhh, Hh^Qhh, Rb^Gvs, Chr, Rb^Gvs, Rb^Gvs, Rb^Gvs, Rb^Gvs, Rb^Gvs, Re^Gvs, Rb^Gvs, Rb^Gvs, Rb^Gvs, Gs^Es, Gs, Gs, Hh, Hh, Mm, Chr, Chr^Dr, Hh^Dr, Mm, Hh, Mm, Mm, Ms, Ms, Ms^Xm, Ms, Ha^Fma, Ha^Fma, Ha^Fma
Co, 6 Ko, Gd^Edt, Gs, Gs, Hh^Qhh, Hh^Qhh, Hh^Fp, Mm, Mm^Xm, Mm, Mm, Ms, Ms, Ms, Ms, Ms, Mm, Mm, Mm, Mm, Mm, Hh^Qhh, Chr^Kov, Chr, Rb, Rb^Gvs, Rb^Gvs, Re^Gvs, Re^Gvs, Re^Gvs, Re^Gvs, Rb, Rb^Vhr, Gs, Gs, Gs^Efm, Gg, Gg, Gg, Gg, Hh, Gg^Edt, Hh^Edt, Gg, Hh^Vhr, Hh, Mm, Mm, Ms, Ms, Ms^Xm, Ms, Ms
Co, Co, Gs, Gs^Edt, Gs^Edt, Hh, Gg^Edt, Hh^Qhh, Mm^Qhh, Mm, Mm^Qhh, Mm, Mm, Mm, Mm^Qhh, Chr, Hh^Qhh, Ms, Mm^Qhh, Mm^Qhh, Mm^Qhh, Mm^Qhh, Hh, Chr, Rb, Rb^Gvs, Rb^Gvs, Rb^Gvs, Rb^Gvs, Re^Gvs, Rb, Rb, Hh^Qhux, Hh^Qhux, Hh^Qhux, Gs, Hh^Qhux, Gs^Efm, Gs^Efm, Gg^Efm, Gg^Efm, Gg^Efm, Gg^Efm, Gg^Edt, Gg, Gg, Hh, Hh^Edt, Hh, Mm, Ms, Ms, Ms^Xm, Ms
Gs, Gs, Gs, Gs^Es, Gg, Gg, Gg, Hh, Hh, Mm^Qhh, Hh^Fp, Mm^Qhh, Mm^Qhh, Mm^Qhh, Hh, Hh^Qhh, Rb^Vhr, Hh^Qhh, Hh, Hh, Gs, Hh, Gs, Rb, Rb^Gvs, Rb^Gvs, Gs, Rb, Hh^Qhux, Rb, Hh^Qhux, Chr, Hh^Qhux, Hh^Qhux, Hh^Qhux, Hh^Qhux, Mm^Qhux, Hh^Qhux, Hh^Qhux, Gg^Efm, Gg^Efm, Gs^Efm, Gs, Gs, Hh, Hh, Co, Hh, Hh, Mm, Ms^Xm, Mm^Xm, Ms, Ms
Hh, Hh, Hh, Hh, Hh^Fdf, Gg, Gll^Fdf, Gs^Fp, Gs^Fp, Hh, Gs, Gs^Fmf, Hh, Gs, Rb^Gvs, Rb^Gvs, Re^Gvs, Rb, Re^Gvs, Re, Rb^Gvs, Rb^Gvs, Rb^Gvs, Gs^Es, Gs, Gs, Hh^Qhux, Hh^Qhux, Mm^Qhux, Mm^Qhux, Mm^Qhux, Hh^Qhux, Mm^Qhux, Mm^Qhux, Mm^Qhux, Mm^Qhux, Mm^Qhux, Mm^Qhux, Mm^Qhux, Hh^Qhux, Hh^Qhux, Gs, Hh^Qhux, Gs, Hh, Hh^Edt, 9 Ko, Co, Mm, Mm, Ms, Ms, Ms, Ms
Mm, Mm, Mm, Mm, Mm, Hh^Fdf, Hh, Gll^Fdf, Gs, Gs, Gs, Gs^Fmf, Rb, Rb^Gvs, Rb^Gvs, Re^Gvs, Rb, Re^Gvs, Rb^Gvs, Re^Gvs, Re, Rb^Gvs, Rb^Gvs, Rb^Gvs, Gs, Hh^Qhux, Gs^Qhux, Mm^Qhux, Mm^Qhux, Mm^Qhux, Mm^Qhux, Mm^Qhux, Mm^Qhux, Mm^Qhux, Mm^Qhux, Mm^Qhux, Mm^Qhux, Mm^Qhux, Mm^Qhux, Mm^Qhux, Hh^Qhux, Hh^Qhux, Gs^Qhux, Hh^Qhux, Hh^Qhux, Co, Hh, Mm, Mm, Mm, Mm, Ms, Ms, Ms
