Xor, Xu, Xu, Xu, Xu, Xu, Xu, Xu, Xu, Xu, Xu, Xu, Xu, Xu, Xu, Xu, Xu, Xu, Xos, Uhe, Uhe^Dr, Xos, Xu, Xu, Xu, Xu, Xu, Xu, Xu, Xu, Xu, Xu, Xu, Xu, Xu, Xu
Urb^Es, Xos, Xor, Xu, Xor, Xu, Xu, Xu, Xu, Xu, Xu, Xu, Xu, Xu, Xu, Xu, Xu, Xu, Xos, Uhe^Qhh, Uue^Qhu, Xos, Xu, Xu, Xu, Xu, Xu, Xor, Xor, Xu, Xu, Xu, Xor, Xu, Xu, Xu
Urb^Br\, Urb, Urb^Dr, Xor, Xor, Xor, Xor, Xu, Xor, Xu, Xor, Xor, Xuc, Xu, Xor, Xu, Xu, Xu, Xor, Uhe^Dr, Urb^Vud, Xor, Xor, Xor, Xor, Xu, Xor, Xor, Xor, Xor, Xor, Xor, Xor, Xor, Xu, Xu
Xor, Urb^Br\, Urb^Br\, Urb, Urb^Es, Xor, Wwf, Xor, Xor, Xor, Xor, Xuc, Uhe, Uhe^Dr, Uhe^Qhh, Xu, Xu, Xu, Xor, Uue^Qhu, Urb^Edt, Xor, Xor, Xor, Xor, Xor, Xor, Xor, Xos, Xor, Cud^Xo, Xor, Xor, Xor, Xor, Xu
Xor, Xor, Xor, Urb^Br\, Urb^Br/, Urb^Dr, Wwf, Wwf, Wwg^Qhu, Xor, Wwg^Qhu, Wwg^Qhu, Wwg^Qhu, Wwg^Qhu, Xor, Xu, Xor, Xu, Xor, Xor, Xor, Urb^Pr/, Urb^Edt, Urb^Dr, Wwf, Xor, Xor, Xos, Urb^Eb, Urb^Xo, Xor, Urb^Edt, Cud^Dr, Cud, 2 Kud, Xor
Xor, Xor, Urb^Dr, Urb^Br/, Urb, Urb, Xor, Wwf, Wwf, Wwg^Qhu, Wwg^Qhu, Wwg^Qhu, Xuc, Xuc, Xor, Xu, Xor, Xor, Xor, Xor, Xor, Urb^Vud, Urb^Edt, Urb^Edt, Wwf^Es, Wwf^Dr, Xor, Xor, Xor, Xor, Wwf^Edt, Urb^Vud, Urb, Cud, Cud, Cud^Xo
Urb^Br/, Urb^Br/, Urb^Es, Urb, Cud^Xo, Xor, Xu, Xor, Xor, Urb^Dr, Urb, Wwg^Qhu, Wwg^Qhu, Xuc, Cud^Xo, Xu, Xor, Wwf, Wwf^Pr/, Xor, Urb, Urb, Cte^Edt, 3 Kte^Edt, Cte, Xor, Xor, Xos, Wwf^Dr, Wwf, Wwf, Urb^Edt, Urb^Dr, Urb^Xo, Xor, Urb^Xo
Urb, Urb^Es, Xos, Xor, Xu, Xu, Xu, Xu, Xu, Xor, Xor, Urb^Vud, Urb, Wwg^Qhu, Wwg^Qhu, Xor, Xor, Xos, 4 Kte^Edt, Wwf, Wwf, Urb, Wwf, Cte, Wwf, Wwf^Edt, Wwf^Edt, Urb^Pr\, Urb^Pr\, Urb, Urb, Urb^Vud, Xor, Xor, Urb^Eb, Urb^Edt
Xor, Xos, Xu, Xu, Xu, Xu, Xu, Xu, Xu, Xu, Wwf, Urb^Dr, Xor, Wwg^Qhu, Wwg^Qhu, Wwg^Qhu, Wwg^Qhu, Cte^Ii, Cte^Edt, Xor, Wwf^Edt, Wwf^Edt, Xor, Wwf^Dr, Wwf, Wwf^Es, Wwf^Dr, Urb^Edt, Urb, Urb^Pr\, Xor, Xor, Xos, Xor, Xor, Xu
Xu, Xu, Xu, Xu, Xu, Xu, Xu, Uhe^Qhh, Uhe^Dr, Urb^Es, Wwf, Wwg^Qhu, Xor, Xor, Wwg^Qhu, Wwf^Qhu, Wwg^Qhu, Wwg^Qhu, Wwg^Qhu, Wwg^Qhu, Qxu, Wwf, Urb, Urb, Xor, Wwf^Ii, Wwf^Es, Wwf, Xor, Urb, Urb, Xos, Urb^Br\, Urb^Vud, Urb^Br\, Xor
Xu, Xu, Xu, Xu, Xu, Xu, Xu, Uhe^Dr, Uue^Qhu, Urb^Edt, Xor, Uue^Pr/o, Uue^Edt, Xor, Urb^Es, Urb^Es, Wwf^Qhu, Wwg^Qhu, Qxu, Qxu, Qxu, Qxu, Qxu, Urb^Edt, Urb^Ii, Urb, Xor, Urb, Cte, Urb, Xor, Urb^Edt, Urb^Br/, Urb^Br\, Urb^Dr, Urb^Br\
Xu, Xu, Xu, Xu, Xu, Xu, Xu, Xu, Xu, Xor, Xor, Uue^Vud, Wwf^Edt, Urb^Edt, Xor, Urb^Ii, Qxu, Qxu, Qxu, Qxu^Ii, Qxu^Ii, Qxu, Qxu^Ii, Qxu^Ii, Qxu^Ii, Uue^Qhu, Uue^Qhu, Uue^Qhu, Xor, 5 Kte, Cte, Urb^Dr, Urb, Urb^Edt, Cud^Xo, Urb^Br\
Xu, Xu, Xu, Xu, Xu, Xu, Xu, Xu, Xu, Xor, Wwf^Dr, Wwf, Xor, Wwf, Urb, Urb, Xor, Qxu, Qxu, Qxu^Ii, Qxu, Qxu, Qxu, Qxu, Qxu, Qxu, Qxu^Ii, Uue^Qhu, Urb, Cte, Urb^Edt, Urb^Edt, Xos, Xor, Xor, Xor
Xu, Xu, Xu, Xu, Xu, Xu, Xu, Xu, Xu, Xor, Wwf, Wwf, Wwf^Dr, Wwf, Urb^Dr, Urb, Urb, Wwf, Xor, Qxu, Qxu^Ii, Qxu, Qxu, Qxu, Qxu, Qxu, Qxu, Qxu, Urb^Edt, Urb, Xor, Urb^Edt, Urb, Xor, Xor, Xor
Xu, Xu, Xu, Xu, Xu, Xu, Xu, Xu, Xu, Xor, Xor, Wwf, Urb^Edt, Urb^Es, Urb^Ii, Urb, Xor, Wwf, Wwf^Edt, Wwf^Ii, Xor, Qxu, Qxu, Qxu^Ii, Qxu, Qxu, Uue^Qhu, Urb, Urb^Dr, Urb, Uue^Qhu, Urb, Xor, Urb^Pr/, Uue^Vud, Xor
Xu, Xu, Xu, Xu, Xu, Xu, Xu, Xu, Xor, Xor, Xor, Urb^Edt, Uue^Qhu, Urb, Urb, Urb^Edt, Urb^Edt, Wwf^Edt, Xor, Cte, 6 Kte, Cte, Uue^Dr, Qxu, Uue^Qhu, Uue^Qhu, Xor, Urb, Urb, Urb, Urb^Edt, Xor, Xu, Xu, Uue^Qhu, Uhe^Qhh
Xu, Xu, Xu, Xu, Xu, Xu, Xu, Xor, Xos, Xor, Urb^Dr, Urb^Edt, Uue^Qhu, Uue^Qhu, Urb^Vud, Urb, Xor, Urb, Urb^Edt, Wwf^Edt, Xor, Cte^Edt, Urb^Edt, Urb^Edt, Urb, Uue^Qhu, Urb, Urb, Urb^Vud, Urb, Urb^Edt, Urb^Edt, Uhe^Dr, Xor, Xor, Uhe^Dr
Xu, Xu, Xu, Xu, Xor, Xu, Xor, Xor, Uu^Vud, Urb^Br/, Urb, Urb, Xor, Xor, Xu, Xor, Xor, Xor, Urb, Urb, Urb, Urb, Xor, Urb, Urb, Urb^Ii, Urb, Xor, Xos, Xor, Xor, Uhe^Qhu, Uhe^Qhh, Xu, Xu, Xu
Xu, Xu, Xu, Xor, Xor, Xor, Uhe^Qhh, Uue^Dr, Uue^Qhu, Urb, Wwf, Xor, Xor, Xu, Xor, Xor, Urb^Vud, Urb^Dr, Urb, Urb^Edt, Xuc, Xor, Xu, Cud^Xo, Xor, Urb^Edt, Urb^Edt, Urb^Edt, Urb, Xor, Xor, Xu, Xor, Xu, Xu, Xu
Xu, Xu, Xuc, Xuc, Xu, Xu, Uue^Dr, Uhe, Urb, Wwf^Es, Wwf, Cud^Dr, Xor, Xor, Xuc, Xuc, Urb^Edt, Urb, Uue^Qhu, Urb^Vud, Urb^Pr/, Xuc, Xor, Xu, Xu, Xor, Xor, Urb, Urb, Urb^Edt, Urb, Xor, Uue^Dr, Xor, Xu, Xu
Xor, Xor, Uue^Dr, Uue^Br/, Uhe^Qhh, Xu, Xor, Xor, Xor, Wwf^Es, Wwf, Xor, Xor, Xu, Uhe^Dr, Uhe^Dr, Xor, Xor, Xor, Uue^Pr/, Uue, Uue, Xuc, Xu, Xu, Xu, Xu, Cud^Dr, Xor, Urb^Edt, Urb^Es, Uue^Vud, Uhe^Qhh, Uue^Dr, Xor, Xu
Urb^Br/, Urb^Br/, Uhe^Qhu, Uue^Vud, Xor, Xor, Xor, Xor, Xor, Urb^Edt, Wwf^Edt, Xor, Xu, Xu, Xu, Uhe^Qhh, Xu, Xu, Xu, Xor, Xor, Xuc, Xu, Xu, Xu, Xu, Xor, Xor, Urb, Urb, Urb^Es, Urb^Es, Xor, Xor, Xu, Xu
Urb, Urb^Es, Xor, Xor, Xor, Xor, Cud^Xo, Xor, Urb, Urb^Edt, Urb, Xos, Xor, Xu, Xu, Xu, Xu, Xu, Xu, Xu, Xu, Xu, Xu, Xu, Xu, Xor, Xuc, Uue^Dr, Uue^Qhu, Urb, Urb, Xor, Xor, Xor, Xor, Xu
Xor, Urb, Urb, Xor, Xor, Xor, Urb^Edt, Urb, Urb^Es, Urb, Xos, Xos, Xor, Xu, Xu, Xu, Xu, Xu, Xu, Xu, Xu, Xu, Xu, Xu, Xu, Xu, Uhe^Qhh, Uue^Dr, Uue^Br/, Urb^Br\, Urb^Dr, Urb, Urb, Xor, Xor, Xor
Xos, Xor, Xor, Urb, Uue^Dr, Urb, Urb^Edt, Urb, Urb^Pr/o, Xor, Xor, Xor, Xor, Xu, Xu, Xu, Xu, Xu, Xu, Xu, Xu, Xu, Xu, Xu, Xu, Xu, Xu, Uue^Br/, Xu, Xor, Xor, Urb^Br\, Urb^Br\, Urb^Es, Urb, Xor
Xos, Xor, Urb^Es, Urb^Es, Uue^Dr, Uue^Qhu, Xos, Xor, Xor, Urb, Urb, Uu^Vud, Xuc, Xuc, Xor, Xu, Xu, Xu, Xu, Xu, Xu, Xu, Xu, Xu, Xu, Xu, Xu, Xu, Xu, Xu, Xu, Cud^Xo, Xor, Urb^Br\, Urb^Br\, Urb
Urb, Urb, Urb, Uue, Xor, Xor, Xu, Xor, Xor, Urb^Dr, Xor, Urb, Urb^Es, Urb^Dr, Xuc, Xor, Xor, Xu, Xu, Xu, Xu, Xu, Xu, Xu, Xu, Xu, Xu, Xu, Xu, Xu, Xu, Xu, Xu, Xor, Xor, Urb^Br\
Urb, Urb^Es, Xor, Xor, Xor, Xu, Xu, Xu, Xu, Xor, Xor, Xor, Xor, Urb^Dr, Urb, Xuc, Xor, Xu, Xu, Xu, Xu, Xu, Xu, Xu, Xu, Xu, Xu, Xu, Xu, Xu, Xu, Xu, Xu, Xu, Xor, Xor
