Xu, Xu, Xu, Xu, Xu, Xu, Xu, Uhe^Qhh, Xu, Uhe^Qhh, Xu, Xu, Uu, Uu, Uu^Em, Uhe^Qhh, Uhe^Qhh, Xu, Xu, Qxu, Qxu, Uu, Uu, Qxu, Uu, Xu, Xu, Xu, Xu, Xu, Xu, Xu, Xu, Xu, Uu, Uu, Uu, Uu, Rb, Rb, Rb, Uhe^Qhh, Uhe^Qhh, Uhe^Qhh
Xu, Xu, Xu, Xu, Xu, Xu, Xu, Xu, Xu, Xu, Xu, Xu, Rb^Es, Rb^Em, Rb^Em, Uhe^Qhh, Uhe^Qhh, Xu, Xu, Xu, Xu, Uu, Qxu, Uu^Vu, Qxu, Qxu, Xu, Xu, Xu, Xu, Xu, Xu, Xu, Xu, Uu, Uu, Rb, Rb, Uu, Rb, Uhe^Qhh, Uhe^Qhh, Uhe^Qhh, Uhe^Qhh
Xu, Xu, Xu, Xu, Xu, Xu, Ce^Edt, Uhe^Qhh, Uu, Uu, Uu, Uu, Rb^Vct, Rb^Es, Xu, Uu^Em, Uhe^Qhh, Uhe^Qhh, Xu, Xu, Xu, Qxu, Qxu, Uu, Uu, Qxu, Xu, Xu, Xu, Xu, Xu, Xu, Uhe^Qhh, Uhe^Qhh, Uu^Vct, Uu, Rb, Uu, Xu, Uu, Xu, Xu, Xu, Xu
Xu, Xu, Xu, Xu, Xu, Ce, Ke^Edt, Uu, Ce, Rb, Xu, Xu, Xu, Xu, Xu, Xu, Uu, Uhe^Qhh, Xu, Xu, Xu, Xu, Xu, Qxu, Xu, Xu, Xu, Xu, Xu, Xu, Xu, Xu, Ce, Uhe^Qhh, Uu, Rb, Uu, Uhe^Qhh, Uhe^Qhh, Xu, Xu, Xu, Xu, Xu
Uhe^Qhh, Uhe^Qhh, Uhe^Qhh, Xu, Uhe^Qhh, Ce^Edt, Uu, Ce, Ce^Edt, Uu, Xu, Xu, Xu, Xu, Uhe^Qhh, Xu, Uu, Rb, Uu^Em, Xu, Xu, Xu, Xu, Xu, Xu, Xu, Tb^Qhh, Tb^Qhh, Xu, Xu, Xu, Uu^Tf, Rb, Uu, Uu, Rb, Uu, Uhe^Qhh, Ce, Ce, Xu, Xu, Xu, Xu
Rb, Uhe^Qhh, Uu^Vct, Xu, Rb, Rb^Edt, Rb^Edt, Ce^Edt, Ur^Qhu, Rb^Edt, Uu, Ce^Edt, Uu, Xu, Ur^Qhu, Ur^Qhu, Qxu, Rb^Es, Rb^Es, Rb^Em, Uhe^Qhh, Xu, Xu, Xu, Uhe^Qhh, Rb^Vud, Tb^Tf, Tb^Qhh, Uu^Tf, Tb^Tf, Uu^Tf, Tb^Tf, Rb, Rb, Uue^Qhu, Uu, Uu^Vct, Rb, Rb, Ke^Edt, Xu, Xu, Xu, Xu
Ur^Qhu, Ur^Qhu, Ur^Qhu, Ur^Qhu, Uu, Rb^Edt, Rb, Ur^Qhu, Ur^Qhu, Ur^Qhu, Ur^Qhu, Uu^Em, Uhe^Qhh, Ur^Qhu, Qxu, Qxu, Qxu, Qxu, Ur^Qhu, Uu^Em, Qxu, Xu, Xu, Uhe^Qhh, Uhe^Qhh, Uhe^Qhh, Uhe^Qhh, Tb^Tf, Uu^Tf, Uu, Rb, Rb, Uu^Vct, Uue^Qhu, Uue^Qhu, Uu, Rb, Rb, Rb, Ce, Uu, Xu, Ur^Qhu, Xu
Uhe^Qhh, Ur^Qhu, Uhe^Qhh, Uu^Es, Uu, Uu, Uu, Uu^Vct, Uu^Es, Ur^Qhu, Uu, Xu, Xu, Uhe^Qhh, Qxu, Qxu, Uu^Vu, Ur^Qhu, Ur^Qhu, Uu, Qxu, Xu, Qxu, Uhe^Qhh, Tb^Tf, Uhe^Qhh, Uu, Uu^Tf, Rb, Uu, Xu, Uu, Xu, Uue^Qhu, Qxu, Qxu, Ce, Ce, Uu, Uu, Uu^Vct, Ur^Qhu, Uu, Ur^Qhu
Xu, Uhe^Qhh, Xu, Xu, Xu, Ce, Xu, Uu^Es, Ur^Qhu, Ur^Qhu, Ur^Qhu, Xu, Xu, Xu, Qxu, Qxu, Qxu, Ur^Qhu, Ur^Qhu, Qxu, Qxu, Qxu, Uu^Em, Uu^Tf, Rb, Uu^Tf, Rb^Es, Uu, Uu, Uu, Xu, Xu, Xu, Qxu, Qxu, Qxu, Qxu, Ce, Xu, Xu, Xu, Xu, Xu, Uu
Xu, Xu, Xu, Xu, Xu, Xu, Xu, Uhe^Qhh, Uhe^Qhh, Ur^Qhu, Ur^Qhu, Xu, Xu, Xu, Uu^Em, Qxu, Qxu, Qxu, Ur^Qhu, Ur^Qhu, Rb, Uu, Uu^Em, Rb^Em, Rb^Em, Rb^Es, Rb^Es, Rb^Vu, Xu, Xu, Xu, Xu, Qxu, Qxu, Qxu, Qxu, Qxu, Qxu, Xu, Xu, Xu, Xu, Xu, Xu
Xu, Xu, Xu, Xu, Xu, Xu, Xu, Xu, Uhe^Qhh, Uhe^Qhh, Uu^Em, Rb^Em, Rb, Xu, Uue^Qhu, Qxu, Uue^Qhu, Qxu, Tb^Tf, Tb^Tf, Rb, Rb^Vu, Uu^Es, Uu^Es, Uu^Es, Rb, Uu, Uu, Uu^Vu, Xu, Xu, Xu, Xu, Qxu, Xu, Qxu, Qxu, Xu, Xu, Xu, Xu, Xu, Xu, Xu
Xu, Xu, Xu, Xu, Xu, Xu, Xu, Xu, Xu, Xu, Uhe^Qhh, Uu^Vu, Uhe^Qhh, Rb, Uu^Em, Uue^Qhu, Uue^Qhu, Uue^Qhu, Rb, Uu^Tf, Xu, Xu, Qxu, Uu^Es, Qxu, Uu, Uu^Vu, Uu, Uu^Es, Xu, Xu, Xu, Xu, Xu, Qxu, Qxu, Xu, Xu, Uhe^Qhh, Uhe^Qhh, Cte^Dr, Xu, Xu, Xu
Xu, Xu, Xu, Xu, Qxu, Xu, Xu, Xu, Xu, Xu, Uhe^Qhh, Uhe^Qhh, Uhe^Qhh, Uhe^Qhh, Uu, Uue^Qhu, Qxu, Rb, Rb, Uu^Es, Rb, Xu, Qxu, Qxu, Qxu, Qxu, Uu^Tf, Uu, Uu^Tf, Uu^Es, Uu^Es, Uhe^Qhh, Uhe^Qhh, Xu, Qxu, Qxu, Qxu, Xu, Uu^Vct, Uhe^Qhh, Rb^Dr, Kte, Xu, Xu
Xu, Xu, Xu, Qxu, Qxu, Xu, Xu, Xu, Xu, Xu, Xu, Uhe^Qhh, Uu^Em, Uu^Em, Uue^Qhu, Uue^Qhu, Qxu, Uu^Vu, Rb^Es, Rb^Es, Rb^Es, Cte, Cte, Uue^Qhu, Rb^Vu, Qxu, Xu, Tb^Tf, Tb^Tf, Uu^Es, Uu, Uu, Uu^Es, Qxu, Uu^Es, Uu^Es, Rb, Xu, Uu, Rb^Es, Uu, Uu^Vct, Xu, Xu
Xu, Xu, Xu, Xu, Xu, Qxu, Xu, Xu, Xu, Xu, Xu, Uu, Qxu, Uu^Em, Qxu, Uue^Qhu, Qxu, Qxu, Uu^Vud, Uu, Uu, Kte, Qxu, Tb^Tf, Tb^Tf, Xu, Xu, Xu, Uhe^Qhh, Uhe^Qhh, Tb^Tf, Uu^Es, Uu^Es, Uu, Uu^Vct, Uu, Uu^Tf, Rb^Es, Rb^Es, Rb^Vct, Xu, Xu, Xu, Xu
Xu, Uu^WebS, Uu^WebS, Xu, Xu, Qxu, Qxu, Xu, Uu^WebS, Xu, Uu^Es, Uu, Qxu, Qxu, Qxu, Qxu, Qxu, Qxu, Uu, Uu, Qxu, Rp^Qhu, Rp^Qhu, Qxu, Uue^Qhu, Xu, Tb^Tf, Tb^Tf, Uhe^Qhh, Uhe^Qhh, Tb^Tf, Qxu, Uue^Qhu, Uue^Qhu, Qxu, Tb^Tf, Tb^Tf, Rb^Es, Uu, Cte, Xu, Xu, Xu, Xu
Uu, Uhe^Qhh, Uu, Uhe^Qhh, Uhe^Qhh, Qxu, Qxu, Xu, Rb^Qhu, Rb^Qhu, Uu^Es, Uu^Es, Xu, Xu, Xu, Qxu, Xu, Uu^Vud, Uu, Qxu, Uhe, Qxu, Uhe^Qhh, Uu, Uu^Es, Uu^Es, Uu, Uu^Tf, Rb^Es, Uu^Tf, Tb^Tf, Qxu, Qxu, Uue^Qhu, Uue^Qhu, Qxu, Qxu, Uu^Vct, Ur^Qhu, Rb^Es, Rb^Es, Xu, Rb^Vct, Uu^Es
Qxu^Bs/, Ur^Qhu, Ur^Qhu, Uu^Es, Uu^Es, Rb^Qhu, Rb^Qhu, Uu^Es, Rb^Qhu, Rb^Qhu, Qxu, Uu^Es, Uu^Es, Xu, Qxu, Xu, Xu, Uh^Qhh, Rb^Es, Uu^Qhh, Qxu, Qxu, Uu^Vu, Uhe^Qhh, Xu, Uu^Vu, Cte^Dr, Rb^Es, Rb, Tb^Tf, Uu^Vu, Tb^Tf, Qxu, Qxu, Qxu, Qxu, Qxu, Qxu, Ur^Qhu, Rb^Es, Uu, Rb, Uu^Es, Rb
Uue^Qhu, Qxu, Qxu, Qxu, Qxu, Rb^Qhu, Qxu, Qxu, Qxu, Qxu, Qxu, Qxu, Ur^Qhu, Xu, Ur^Qhu, Qxu, Qxu, Xu, Rb, Rb^Es, Uu, Uu^Es, Xu, Xu, Xu, Xu, Xu, Qxu, Qxu, Rb^Em, Uu, Uue^Qhu, Uue^Qhu, Qxu, Qxu, Qxu, Qxu, Qxu, Qxu, Ur^Qhu, Uu^Tf, Uu^Tf, Xu, Uhe^Qhh
Xu, Xu, Xu, Qxu, Xu, Qxu^Bp|, Uu^Edt, Qxu, Qxu, Qxu, Qxu, Qxu, Qxu, Ur^Qhu, Qxu, Qxu^Bs\, Uu, Rb^Es, Uu^Vu, Xu, Xu, Uu, Ur^Qhu, Uu^WebS, Xu, Xu, Xu, Qxu, Qxu, Uu^Tf, Tb^Tf, Uue^Qhu, Uue^Qhu, Qxu, Qxu, Qxu, Xu, Qxu, Qxu, Uu, Tb^Tf, Xu, Xu, Xu
Xu, Uu^WebS, Uhe^Qhh, Xu, Xu, Rb, Rb^Edt, Uue^Qhu, Qxu, Qxu, Qxu, Qxu, Qxu, Qxu, Qxu, Qxu, Qxu, Uu^Es, Uue^Qhu, Xu, Uu^Vu, Xu, Ur^Qhu, Ur^Qhu, Xu, Xu, Xu, Uu^WebS, Cte, Qxu, Uu^Tf, Uu^Vu, Uue^Qhu, Qxu, Uu^Tf, Xu, Tb^Tf, Uhe^Qhh, Uhe^Qhh, Uhe^Qhh, Xu, Xu, Xu, Xu
Uu^Es, Uu^Em, Uhe^Qhh, Uhe^Qhh, Xu, Xu, Rb^Es, Qxu, Qxu, Qxu, Qxu, Qxu, Qxu, Qxu, Qxu, Qxu, Qxu, Uue^Qhu, Uue^Qhu, Uue^Qhu, Qxu, Qxu, Ur^Qhu, Xu, Uu^WebS, Xu, Xu, Xu, Xu, Rb^Em, Rp^Qhu, Rb^Es, Rb, Uu, Uu^Tf, Tb^Tf, Xu, Uhe^Qhh, Uhe^Qhh, Uhe^Qhh, Xu, Xu, Xu, Xu
Uu^Es, Uue^Qhu, Uue^Qhu, Xu, Xu, Uh^Qhh, Ur^Qhu, Rb^Es, Uu^Edt, Uu^Vu, Qxu, Qxu, Qxu, Qxu, Qxu, Qxu, Qxu, Qxu, Qxu, Qxu^Bs\, Ur^Qhu, Qxu, Qxu, Uu, Qxu, Qxu, Qxu, Xu, Kte, Cte^Dr, Uu, Rp^Qhu, Rp^Qhu, Rp^Qhu, Rp^Qhu, Rb^Es, Rb, Uu, Uu, Xu, Xu, Xu, Xu, Xu
Ur^Qhu, Xu, Uue^Qhu, Xu, Uh^Qhh, Ur^Qhu, Ur^Qhu, Qxu, Qxu, Qxu, Qxu, Qxu, Qxu, Qxu, Uue^Qhu, Qxu, Qxu, Qxu, Qxu, Qxu, Ur^Qhu, Ur^Qhu, Rb^Es, Qxu^Bs|, Uu^Vu, Qxu, Qxu, Qxu, Qxu, Cte, Uu, Rp^Qhu, Uu, Xu, Cte, Rb, Rp^Qhu, Rp^Qhu, Uu, Xu, Xu, Xu, Xu, Xu
Ur^Qhu, Xu, Uu^Edt, Uue^Qhu, Ce, Ur^Qhu, Uu, Ur^Qhu, Qxu, Qxu, Uue^Qhu, Qxu, Qxu, Qxu, Tb^Tf, Uue^Qhu, Qxu, Qxu, Qxu, Qxu, Tb^Tf, Tb^Tf, Tb^Tf, Rb^Es, Xu, Uu, Uue^Qhu, Uue^Qhu, Uue^Qhu, Uue^Qhu, Uu, Uu, Xu, Xu, Xu, Uu, Uu^Vct, Rp^Qhu, Rp^Qhu, Rb^Es, Rb^Es, Cte, Kte, Xu
Qxu, Ur^Qhu, Uu^Edt, Ce, Ce, Uh^Qhh, Uh^Qhh, Uu, Uue^Qhu, Uue^Qhu, Qxu, Qxu, Qxu, Tb^Tf, Qxu, Qxu, Uue^Qhu, Uu^Vud, Uh^Qhh, Qxu, Qxu, Tb^Tf, Rb^Em, Rb^Es, Uhe^Qhh, Xu, Rb^Es, Uue^Qhu, Uu^Tf, Rb^Em, Uu^Tf, Uu, Ur^Qhu, Xu, Uu^WebS, Xu, Xu, Uu, Uu, Rb^Es, Uu, Cte, Cte^Dr, Cte^Dr
Uue^Qhu, Tb^Tf, Tb^Tf, Ur^Qhu, Ur^Qhu, Uh^Qhh, Uh^Qhh, Uu, Uue^Qhu, Uue^Qhu, Qxu, Uue^Qhu, Xu, Qxu, Qxu, Uue^Qhu, Rb^Es, Uh^Qhh, Uh^Qhh, Qxu, Xu, Qxu, Rb^Es, Rb^Es, Uu, Uu, Xu, Rb^Em, Tb^Tf, Tb^Tf, Tb^Tf, Ur^Qhu, Ur^Qhu, Uhe^Qhh, Uhe^Qhh, Xu, Xu, Xu, Cte^Dr, Rb, Uu, Uu^Vct, Cte^Dr, Cte^Dr
Uue^Qhu, Tb^Tf, Uu^Tf, Ur^Qhu, Ce, Ke, Ce, Uh^Qhh, Qxu, Rb, Rb^Em, Rb^Es, Xu, Xu, Xu, Qxu, Rb^Es, Rb^Es, Rb^Es, Xu, Xu, Uh^Qhh, Rb, Uhe^Qhh, Uhe^Qhh, Uhe^Qhh, Xu, Xu, Xu, Tb^Qhh, Tb^Qhh, Ur^Qhu, Uu^Tf, Ur^Qhu, Uhe^Qhh, Uhe^Qhh, Xu, Xu, Rb, Rb, Rb^Es, Uu, Rb, Uu
Rb^Edt, Rb^Vu, Uu, Ur^Qhu, Qxu, Ce, Qxu, Qxu, Uue^Qhu, Rb, Ce, Rb^Es, Rb^Es, Uu^Vu, Rb, Qxu^Bp/, Qxu, Xu, Tb^Tf, Rb, Rb, Rb, Uhe^Qhh, Uhe^Qhh, Xu, Xu, Xu, Xu, Xu, Tb^Qhh, Tb^Qhh, Uu^Vud, Tb^Tf, Uu^Tf, Uu, Rb^Em, Rb^Em, Rb^Es, Rb^Es, Uu, Uu, Rb, Uu^Vct, Rb
Rb^Em, Qxu, Qxu, Qxu, Ur^Qhu, Ur^Qhu, Qxu, Qxu, Uue^Qhu, Uue^Qhu, Xu, Tb^Tf, Tb^Tf, Rb, Uh^Qhh, Xu, Xu, Qxu, Xu, Uu^WebS, Xu, Tb^Tf, Xu, Xu, Xu, Xu, Xu, Xu, Xu, Xu, Xu, Tb^Tf, Tb^Qhh, Uu^Tf, Uu^Tf, Xu, Xu, Xu, Uu, Uu, Xu, Rb, Uu, Uu
Ur^Qhu, Uu, Uu^Edt, Qxu^Bs/, Qxu, Uu^Edt, Uu^Em, Uue^Qhu, Xu, Xu, Xu, Uu^WebS, Uu^WebS, Qxu, Xu, Xu, Xu, Xu, Xu, Xu, Xu, Xu, Xu, Xu, Xu, Xu, Xu, Xu, Xu, Xu, Xu, Xu, Xu, Xu, Xu, Xu, Uu, Uu, Uu, Cte, Xu, Xu, Xu, Uu
Ur^Qhu, Ce^Edt, Ce, Qxu, Qxu, Qxu, Uh^Qhh, Uh^Qhh, Xu, Xu, Xu, Xu, Xu, Xu, Xu, Xu, Xu, Xu, Xu, Xu, Xu, Xu, Xu, Xu, Xu, Xu, Xu, Xu, Xu, Xu, Xu, Xu, Xu, Xu, Xu, Uu, Uu, Uu, Uu, Uu, Xu, Xu, Xu, Xu
