Hh          , Hh          , Hh          , Hh          , Hh          , Hh          , Hh          , Mm          , Mm          , Mm          , Hh          , Mm          , Mm          , Mm          , Mm          , Mm          , Hh          , Mm          , Hh          , Hh          , Mm          , Mm          , Mm          , Mm          , Mm          , Mm          , Mm          , Mm          , Mm          
Hh          , Hh          , Hh          , Hh          , Hh          , Hh          , Hh          , Mm          , Gg          , Mm          , Hh          , Mm          , Mm          , Mm          , Mm          , Mm          , Hh          , Hh          , Hh          , Gg          , Gg          , Hh          , Mm          , Mm          , Gg          , Re          , Re          , Re          , Mm          
Hh          , Hh          , Hh          , Mm          , Mm          , Hh          , Hh          , Mm          , Gg          , Gg          , Hh          , Mm          , Hh          , Hh          , Hh          , Mm          , Mm          , Mm^Vhh      , Mm          , Gg          , Gs^Fp       , Gg          , Mm          , Mm          , Mm          , Mm          , Hh          , Gg          , Mm          
Hh          , Mm          , Mm          , Mm          , Mm          , Mm          , Hh          , Hh          , Gg          , Mm          , Hh          , Hh          , Gg          , Rr          , Gg          , Hh          , Mm          , Mm          , Mm          , Gg          , Gs^Fp       , Gg          , Gg          , Gg          , Mm          , Gg          , Mm          , Gg          , Mm          
Mm          , Gg          , Mm          , Mm          , Mm          , Mm          , Mm          , Mm          , Mm          , Mm          , Mm          , Hh          , Gg          , Rr          , Gg          , Hh          , Mm          , Mm          , Gg          , Gg          , Gs^Fp       , Gg          , Gg          , Gg          , Gg          , Mm          , Mm          , Gg          , Mm          
Mm          , Gg          , Gg          , Gg          , Mm          , Gg          , Mm          , Gg          , Gg          , Mm          , Mm          , Mm          , Gg          , Rr          , Gg          , Mm          , Mm          , Gg          , Gg          , Gg          , Gg          , Gs^Fp       , Gs^Fp       , Gg          , Gg          , Gg          , Gg          , Gg          , Mm          
Gg          , Gg          , Gg          , Hh          , Gg          , Gg          , Gg          , Gg          , Gg          , Gg          , Gg          , Mm          , Hh          , Rr          , Hh          , Mm          , Mm          , Gg          , Gg          , Gg          , Gs^Fp       , Gg          , Gs^Fp       , Gg          , Gg^Vh       , Gg          , Gg          , Gg          , Gg          
Mm          , Mm          , Hh          , Hh          , Hh          , Hh^Vhh      , Gg          , Mm          , Mm          , Gs          , Gg          , Mm          , Chr         , Rr          , Chr         , Mm          , Hh          , Gg          , Gg          , Gg          , Gg          , Gs^Fp       , Gg          , Gs^Fp       , Gg          , Gg          , Gg          , Gg          , Gg          
Mm          , Mm          , Mm          , Hh          , Hh          , Gg          , Mm          , Gg          , Mm          , Mm          , Gs          , Gs          , Hh          , Rr          , Hh          , Hh          , Hh          , Gg          , Gg          , Gg          , Gg          , Gg          , Gs^Fp       , Gs^Fp       , Gg          , Gg          , Gg          , Gg          , Gg^Vh       
Mm          , Mm          , Mm          , Mm          , Hh          , Gg          , Gg          , Mm          , Gg          , Gs          , Gs          , Gs          , Gs          , Rr          , Gg^Vh       , Hh          , Hh          , Gg          , Gg          , Gg          , Gg          , Gs^Fp       , Gg          , Gg          , Gg          , Gs^Fp       , Gg          , Gg          , Gg          
Gg          , Gg          , Mm          , Gg          , Gg          , Gg          , Gg          , Mm          , Gs          , Ww          , Ww          , Ww          , Gs          , Gs          , Gs          , Hh          , Hh          , Gg          , Gg          , Gg          , Gg          , Gs^Fp       , Gg^Vh       , Gg          , Gg          , Gs^Fp       , Gs^Fp       , Gg          , Gg          
Gg          , Gg          , Gg          , Hh          , Hh          , Gg          , Gs^Fp       , Mm          , Mm          , Mm          , Wo          , Wo          , Ww          , Ww          , Gs          , Hh          , Hh          , Gg^Vh       , Gg          , Gg          , Gg          , Gg          , Gg          , Gg          , Gg          , Gg          , Gs^Fp       , Gg          , Gg          
Gg          , Chr         , Gg          , Hh          , Hh          , Hh          , Gg          , Gg          , Mm          , Mm          , Wo          , Wo          , Wo          , Ww          , Gs          , Chr         , Chr         , Gg          , Gg          , Gg          , Gg          , Gg          , Gg          , Gg          , Gg          , Gs^Fp       , Gs^Fp       , Gs^Fp       , Gg          
4 Khr       , Chr         , Gg          , Gg          , Hh          , Gs^Fp       , Gs^Fp       , Gg          , Gg          , Mm          , Mm          , Ww          , Ww          , Hh          , Gs          , Gg          , Chr         , Gg          , Gg          , Gg          , Gg          , Gg          , Gg          , Gg          , Gg          , Gg          , Gs^Fp       , Gg          , Gs^Fp       
Chr         , Chr         , Gg          , Gg          , Gs^Fp       , Gs^Fp       , Gg          , Gg          , Gg          , Gg          , Mm          , Hh          , Hh          , Hh          , Gs          , Gg          , Gg          , Gg          , Hh          , Hh          , Gg          , Gg          , Gg          , Gg          , Gg          , Gg          , Gg          , Gg          , Gg          
Gg          , Hh          , Gg          , Gg          , Gs^Fp       , Gs^Fp       , Gg          , Gs^Fp       , Gg^Vh       , Hh          , Mm          , Hh          , Hh          , Gg          , Re          , Hh          , Gg          , Gg          , Hh          , Gg          , Gg          , Gg          , Gg^Vh       , Gg          , Gg          , Gs^Fp       , Gs^Fp       , Gg          , Gg          
Gg          , Hh          , Hh          , Gg          , Gs^Fp       , Gg          , Gg          , Gg          , Hh          , Gg          , Hh          , Hh          , Hh          , Gg          , Re          , Gg          , Hh          , Gg          , Gg          , Hh          , Gg          , Gg          , Gg          , Gg          , Gg          , Gg          , Gs^Fp       , Gs^Fp       , Gg          
Gg          , Gg          , Hh          , Gg          , Gg          , Gg          , Gg          , Gg          , Gg          , Gg          , Gs^Fp       , Hh          , Hh          , Gg          , Gs          , Gg          , Gg          , Gg          , Hh          , Hh          , Gg          , Hh          , Gg          , Gs^Fp       , Gs^Fp       , Gs^Fp       , Gs^Fp       , Gs^Fp       , Gg          
Gg          , Gg          , Gg          , Hh          , Hh          , Hh          , Gg          , Gg          , Gg          , Gs^Fp       , Gs^Fp       , Gs^Fp       , Hh          , Gg          , Gg          , Gg          , Gg          , Gg          , Gg          , Gg          , Gg          , Gg          , Gs^Fp       , Gs^Fp       , Gs^Fp       , Mm          , Mm          , Hh          , Gg          
Gg          , Gg          , Gg          , Gg          , Hh          , Gg          , Gg          , Gg          , Gs^Fp       , Gs^Fp       , Gs^Fp       , Gs^Fp       , Chr         , Chr         , Rr          , Khr         , Chr         , Gg          , Gg          , Gg          , Gg          , Aa          , Aa          , Mm          , Mm          , Gg          , Hh          , Hh          , Hh          
Gg          , Gg          , Gg          , Gg          , Gg          , Gg          , Gg          , Gg          , Gs^Fp       , Gs^Fp       , Gs^Fp       , Gs^Fp       , Chr         , Hh          , Rr          , Gg          , Chr         , Gg          , Gg          , Gg          , Aa          , Aa          , Aa          , Aa          , Gs^Fp       , Gg^Vh       , Gs          , Chr         , 2 Khr       
Gg          , Gg          , Gs^Fp       , Gg          , Gs^Fp       , Gg          , Gs^Fp       , Gg          , Gg          , Gs^Fp       , Gs^Fp       , Gs^Fp       , Gg          , Gg          , Gg          , Gg          , Gg          , Gg          , Gg          , Aa          , Aa          , Aa^Vha      , Aa          , Aa          , Gs^Fp       , Gs^Fp       , Gs          , Chr         , Chr         
Gg          , Gg          , Gg          , Gg          , Gs^Fp       , Gg^Vh       , Gs^Fp       , Gg          , Gg          , Gg          , Gs^Fp       , Gg          , Gg          , Gg          , Gg          , Gg          , Gg          , Gg          , Gg          , Aa          , Aa          , Aa          , Aa          , Aa          , Gs^Fp       , Gs^Fp       , Gs          , Gs          , Gs^Fp       
Gs^Fp       , Gs^Fp       , Gg          , Gg          , Gs^Fp       , Gg          , Gs^Fp       , Gg          , Gg          , Gs^Fp       , Gg          , Gg          , Gg          , Gg          , Re          , Gg          , Gg          , Gg^Vh       , Gg          , Aa          , Aa          , Aa          , Aa          , Aa          , Gs^Fp       , Gs          , Gs          , Gs          , Gs^Fp       
Gs^Fp       , Gs^Fp       , Gs^Fp       , Gs^Fp       , Gg          , Gg          , Gg          , Gs^Fp       , Gs^Fp       , Gs^Fp       , Gg          , Gg          , Gg          , Gg          , Re          , Gg          , Gg          , Gg          , Gg          , Gg          , Gg          , Hh          , Aa          , Aa          , Gs^Fp       , Gs          , Gs^Fp       , Gs          , Gs^Fp       
Gs^Fp       , Gs^Fp       , Gs^Fp       , Gg          , Gs^Fp       , Gg          , Gg^Vh       , Gg          , Gs^Fp       , Chr         , Gg          , Gg          , Gg          , Gg          , Gg          , Gs^Fp       , Gs^Fp       , Gg          , Gs          , Gs          , Hh          , Hh          , Hh          , Aa          , Aa          , Aa          , Gs^Fp       , Gs^Fp       , Gs^Fp       
Gg          , Gg          , Gg          , Gg          , Gg          , Aa          , Aa          , Aa          , Gg          , Chr         , Chr         , Gg          , Gg          , Gg          , Gg          , Gs^Fp       , Gs^Fp       , Gs^Fp       , Gs          , Gs          , Gs          , Gs          , Gg          , Aa          , Aa          , Aa          , Gs^Fp       , Gs^Fp       , Gs^Fp       
Gg          , Aa          , Aa          , Aa          , Aa          , Aa          , Aa          , Aa          , Gg          , Gg          , Gg          , Gs^Fp       , Gg          , Gg          , Re          , Gs^Fp       , Gs^Fp       , Gs^Fp       , Gg          , Gs          , Gs          , Gs          , Gg^Vh       , Aa          , Aa          , Gs^Fp       , Gs^Fp       , Gs^Fp       , Gs          
Gg          , Rd          , Gg          , Aa          , Aa          , Aa          , Aa          , Aa          , Gg          , Gs^Fp       , Gs^Fp       , Gs^Fp       , Gg          , Re          , Gg          , Gs^Fp       , Gs^Fp       , Gs^Fp       , Gs^Fp       , Gg          , Gs          , Gs          , Gs          , Gs          , Aa          , Gs^Fp       , Gs^Fp       , Gs^Fp       , Gs          
Gg          , Gg          , Gg^Vh       , Gg          , Aa          , Aa          , Aa          , Aa          , Gg          , Gs^Fp       , Gs^Fp       , Gs^Fp       , Gg          , Re          , Gg          , Gs^Fp       , Gs^Fp       , Mm          , Gs^Fp       , Gg          , Gg          , Mm          , Gs          , Gg          , Gs          , Gs          , Gg          , Gs^Fp       , Gs          
Rd          , Gg          , Gg          , Aa          , Aa          , Aa          , Aa          , Aa          , Gg          , Gs^Fp       , Gs^Fp       , Gs^Fp       , Gg          , Gg          , Gg          , Gg          , Gs^Fp       , Mm          , Mm          , Mm          , Gg          , Mm          , Gg^Vh       , Gg          , Gg          , Gs          , Gs          , Gs^Fp       , Gs          
Rd          , Rd          , Rd          , Rd          , Aa          , Aa          , Aa          , Aa          , Rd          , Rd          , Gs^Fp       , Gs^Fp       , Gs^Fp       , Gg          , Gg          , Gg          , Hh          , Hh          , Mm          , Mm          , Mm          , Mm          , Gg          , Gg          , Gg          , Gg          , Gs          , Gs          , Gs          
Rd          , Rd          , Rd          , Hh          , Hh          , Hh          , Aa          , Gg          , Mm          , Mm          , Gs^Fp       , Gs^Fp       , Gs^Fp       , Gs^Fp       , Gg          , Gg          , Hh          , Hh          , Hh          , Hh          , Mm          , Mm          , Mm          , Gg          , Gg          , Gg          , Gs          , Mm          , Gs          
Chr         , Chr         , Rd          , Hh          , Chr         , Hh          , Gg          , Rd          , Gg          , Mm          , Gs^Fp       , Hh          , Hh          , Gs^Fp       , Gg          , Re          , Gg          , Gg          , Hh          , Hh          , Hh          , Hh          , Mm          , Mm          , Gg          , Gg          , Mm          , Mm          , Gs          
3 Khr       , Chr         , Rd          , Hh          , Hh          , Hh          , Gg          , Gg          , Gg          , Mm          , Gs^Fp       , Gs^Fp       , Gs^Fp       , Hh          , Gg^Vh       , Gg          , Re          , Gg          , Gg          , Gg          , Hh          , Hh          , Mm          , Mm          , Mm          , Gg          , Mm          , Mm          , Mm          
Chr         , Rd          , Rd          , Rd          , Rd          , Rd          , Gg          , Gg          , Rd          , Gg          , Mm          , Mm          , Mm          , Hh          , Hh          , Gg          , Gg          , Gg          , Re          , Re          , Gg          , Hh          , Mm          , Mm          , Mm          , Gg          , Gg^Vh       , Mm          , Mm          
Rd          , Gs^Fp       , Gs^Fp       , Gs^Fp       , Gs^Fp       , Gs^Fp       , Gg          , Gg          , Gg          , Gg          , Hh          , Mm          , Mm          , Hh          , Hh          , Gg          , Gg          , Gg          , Gg          , Re          , Gg          , Gg^Vh       , Hh          , Mm          , Mm          , Mm          , Hh          , Hh          , Mm          
Gs^Fp       , Hh          , Hh          , Hh          , Gs^Fp       , Gs^Fp       , Gg          , Gg          , Rd          , Rd          , Hh          , Mm          , Mm          , Hh          , Hh          , Gg          , Gg          , Gg          , Re          , Gg          , Gg          , Gg          , Hh          , Mm          , Mm          , Mm          , Hh          , Hh          , Mm          
Mm          , Mm          , Mm          , Mm          , Mm          , Hh          , Gs^Fp       , Gg          , Gg          , Gg^Vh       , Hh          , Mm          , Mm          , Hh          , Hh          , Gg^Vh       , Gg          , Gg          , Gg          , Gg          , Gg          , Gg          , Hh          , Mm          , Mm          , Hh          , Hh          , Hh          , Mm          
Mm          , Hh          , Mm          , Mm          , Mm          , Mm          , Gs^Fp       , Gg          , Gg          , Hh          , Hh          , Mm          , Mm          , Hh          , Hh          , Hh          , Gg          , Gg          , Re          , Re          , Gg          , Hh          , Hh          , Mm          , Mm          , Mm          , Hh          , Mm          , Mm          
Mm          , Mm          , Mm          , Mm          , Mm          , Mm          , Mm          , Rd          , Gg          , Hh          , Mm          , Mm          , Mm          , Mm          , Hh          , Hh          , Gg          , Gg          , Gg          , Re          , Gg          , Gg          , Hh          , Mm          , Mm          , Hh          , Hh          , Mm          , Mm          
Mm          , Mm          , Mm          , Mm          , Hh          , Gs^Fp       , Mm          , Mm          , Gg          , Gg          , Mm          , Mm          , Mm          , Mm          , Hh          , Hh          , Hh          , Hh          , Gg          , Ce          , Gg          , Gg          , Hh          , Mm          , Mm          , Hh          , Mm          , Mm          , Mm          
Mm          , Mm          , Hh          , Mm          , Gs^Fp       , Gs^Fp       , Gs^Fp       , Gs^Fp       , Gs^Fp       , Gs^Fp       , Mm          , Mm          , Mm          , Mm          , Mm          , Mm          , Hh          , Hh          , Ce          , 1 Ke        , Ce          , Hh          , Hh          , Mm          , Mm          , Mm          , Hh          , Mm          , Mm          
Mm          , Mm          , Hh          , Hh          , Hh          , Mm          , Gs^Fp       , Gs^Fp       , Gs^Fp       , Mm          , Mm          , Mm          , Mm          , Mm          , Mm          , Mm          , Hh          , Hh          , Ce          , Re          , Ce          , Hh          , Mm          , Mm          , Mm          , Mm          , Hh          , Hh          , Mm          
Mm          , Mm          , Hh          , Hh          , Hh          , Mm          , Gs^Fp       , Gs^Fp       , Mm          , Mm          , Mm          , Mm          , Mm          , Mm          , Mm          , Mm          , Mm          , Mm          , Hh          , Re          , Hh          , Mm          , Mm          , Mm          , Mm          , Mm          , Mm          , Mm          , Mm          

