Gs^Fp       , Gs^Fp       , Gs^Fp       , Gs^Fp       , Gs^Fp       , Gs^Fp       , Gs^Fp       , Gs^Fp       , Gg^Fet      , Ww          , Ww          , Gs^Fp       , Gs^Fp       , Gs^Fp       , Ggf         , Gs^Fp       , Gs^Fp       , Gs^Fp       , Gg^Fet      , Ggf         , Gs^Fp       
Gg^Fet      , Ggf         , Hh          , Gs^Fp       , Gg^Fet      , Gs^Fp       , Hh          , Gs^Fp       , Gs^Fp       , Ww          , Ww          , Gs^Fp       , Gg^Fet      , Gs^Fp       , Gs^Fp       , Gs^Fp       , Gs^Fp       , Gs^Fp       , Gs^Fp       , Gs^Fp       , Gs^Fp       
Gs^Fp       , Ggf         , Gs^Fp       , Gs^Fp       , Gs^Fp       , Gs^Fp       , Gs^Fp       , Gs^Fp       , Gg^Fet      , Ww          , Ww          , Hh          , Gs^Fp       , Gs^Fp       , Gs^Fp       , Gs^Fp       , Hh          , Gs^Fp       , Gs^Fp       , Gs^Fp       , Hh          
Gs^Fp       , Gs^Fp       , Gg^Fet      , Gs^Fp       , Hh          , Gs^Fp       , Gs^Fp       , Ggf         , Gs^Fp       , Ww          , Ww          , Ww          , Gs^Fp       , Gs^Fp       , Ggf         , Gs^Fp       , Gs^Fp       , Gs^Fp       , Gs^Fp       , Gs^Fp       , Gg^Fet      
Gs^Fp       , Gs^Fp       , Gs^Fp       , Gs^Fp       , Gs^Fp       , Gs^Fp       , Gs^Fp       , Gs^Fp       , Gs^Fp       , Gg^Fet      , Ww          , Ww          , Ww          , Gs^Fp       , Gs^Fp       , Gs^Fp       , Gg^Fet      , Gs^Fp       , Ggf         , Gs^Fp       , Gs^Fp       
Gs^Fp       , Hh          , Gs^Fp       , Gg^Fet      , Ggf         , Gs^Fp       , Gs^Fp       , Gg^Fet      , Gg^Fet      , Cv          , Cv          , Ww^Bw\      , Ww          , Gg^Fet      , Gs^Fp       , Gs^Fp       , Gs^Fp       , Gs^Fp       , Hh          , Gs^Fp       , Gs^Fp       
Gs^Fp       , Gs^Fp       , Gs^Fp       , Gs^Fp       , Gs^Fp       , Hh          , Gg^Fet      , Cv          , Cv          , Gg^Fet      , Gg^Ve       , Ww          , Ww^Bw\      , Cv          , Gg^Fet      , Gg^Fet      , Gs^Fp       , Gs^Fp       , Gs^Fp       , Ggf         , Gs^Fp       
Gg^Fet      , Gs^Fp       , Gs^Fp       , Gs^Fp       , Ggf         , Gg^Fet      , Gg^Fet      , Cv          , Gg^Ve       , Cv          , Cv          , Ww          , Ww          , Gg^Ve       , Cv          , Cv          , Gg^Fet      , Gg^Fet      , Gs^Fp       , Gs^Fp       , Gs^Fp       
Gs^Fp       , Gs^Fp       , Gs^Fp       , Hh          , Gg^Fet      , Cv          , Cv          , Ggf         , Gg^Fet      , Cv          , Kv          , Ww^Bw\      , Ww          , Cv          , Gg^Fet      , Ggf         , Cv          , Gg^Fet      , Gs^Fp       , Gg^Fet      , Gs^Fp       
Hh          , Gg^Fet      , Gs^Fp       , Gg^Fet      , Gg^Fet      , Cv          , Gg^Ve       , Cv          , Cv          , Kv          , 3 Kv        , Ww^Bw\      , Ww^Bw\      , Kv          , Cv          , Gg^Ve       , Cv          , Gg^Fet      , Gs^Fp       , Gs^Fp       , Gs^Fp       
Gs^Fp       , Gs^Fp       , Ggf         , Gg^Fet      , Cv          , Gg^Ve       , Ggf         , Cv          , Cv          , Ww^Bw|      , Ww^Bw|      , Ww          , Ww^Bw\      , 2 Kv        , Cv          , Gg^Fet      , Cv          , Gg^Fet      , Gs^Fp       , Hh          , Ggf         
Gs^Fp       , Gs^Fp       , Gs^Fp       , Ww          , Cv          , Ww          , Gg^Fet      , Ww          , Ww          , Ww^Bw|      , Ww^Bw|      , Ww^Bw/      , Ww^Bw/      , Kv          , Cv          , Ggf         , Cv          , Gg^Fet      , Gs^Fp       , Gs^Fp       , Hh          
Gs^Fp       , Ww          , Ww          , Gg^Fet      , Ww^Bw|      , Wwf         , Ww          , Cv          , Wwf         , Kv          , 1 Kv        , Ww^Bw/      , Ww^Bw/      , Cv          , Cv          , Gg^Ve       , Cv          , Gg^Fet      , Gs^Fp       , Gs^Fp       , Ggf         
Ww          , Gs^Fp       , Gs^Fp       , Gg^Fet      , Cv          , Gg^Ve       , Cv          , Cv          , Cv          , Cv          , Kv          , Ww          , Ww          , Gg^Ve       , Cv          , Ggf         , Cv          , Gg^Fet      , Ggf         , Gs^Fp       , Gg^Fet      
Gs^Fp       , Ggf         , Gs^Fp       , Gg^Fet      , Cv          , Cv          , Gg^Fet      , Ggf         , Cv          , Gg^Fet      , Wwf         , Ww          , Ww          , Cv          , Gg^Fet      , Cv          , Cv          , Gg^Fet      , Gs^Fp       , Gs^Fp       , Gs^Fp       
Gs^Fp       , Gs^Fp       , Gs^Fp       , Hh          , Gg^Fet      , Cv          , Gg^Ve       , Gg^Fet      , Gg^Ve       , Cv          , Gg^Ve       , Ww^Bw/      , Ww^Bw/      , Ww          , Cv          , Gg^Fet      , Gg^Fet      , Gs^Fp       , Gs^Fp       , Gs^Fp       , Ggf         
Hh          , Ggf         , Gs^Fp       , Gs^Fp       , Gg^Fet      , Gg^Fet      , Cv          , Cv          , Cv          , Gg^Fet      , Cv          , Gg^Fet      , Ww          , Ww          , Gg^Fet      , Gs^Fp       , Gs^Fp       , Gs^Fp       , Hh          , Ggf         , Gs^Fp       
Gg^Fet      , Gs^Fp       , Gs^Fp       , Gs^Fp       , Gs^Fp       , Ggf         , Gg^Fet      , Gg^Fet      , Gg^Fet      , Hh          , Gg^Fet      , Gs^Fp       , Ww          , Ww          , Ww          , Ww          , Gs^Fp       , Gs^Fp       , Gg^Fet      , Gs^Fp       , Gs^Fp       
Gs^Fp       , Gs^Fp       , Gs^Fp       , Ggf         , Gs^Fp       , Gs^Fp       , Gs^Fp       , Gs^Fp       , Gs^Fp       , Gs^Fp       , Gs^Fp       , Ggf         , Gs^Fp       , Ww          , Ww          , Ww          , Ww          , Ww          , Gs^Fp       , Gs^Fp       , Gg^Fet      
Ggf         , Hh          , Gs^Fp       , Gg^Fet      , Hh          , Gs^Fp       , Gs^Fp       , Gs^Fp       , Gg^Fet      , Hh          , Ggf         , Gs^Fp       , Gs^Fp       , Ww          , Ww          , Hh          , Ww          , Ww          , Ww          , Ww          , Gs^Fp       
Gs^Fp       , Gs^Fp       , Hh          , Gs^Fp       , Gs^Fp       , Gs^Fp       , Gs^Fp       , Gs^Fp       , Gs^Fp       , Gs^Fp       , Gs^Fp       , Gs^Fp       , Ww          , Hh          , Gs^Fp       , Gs^Fp       , Ggf         , Gs^Fp       , Ww          , Ww          , Hh          
Gs^Fp       , Gs^Fp       , Gs^Fp       , Ggf         , Gs^Fp       , Ggf         , Hh          , Gs^Fp       , Gs^Fp       , Gs^Fp       , Gs^Fp       , Ww          , Ww          , Gs^Fp       , Gs^Fp       , Gs^Fp       , Gg^Fet      , Gs^Fp       , Ww          , Ww          , Ww          
Hh          , Ggf         , Gs^Fp       , Gs^Fp       , Gs^Fp       , Gs^Fp       , Gs^Fp       , Gs^Fp       , Gg^Fet      , Ww          , Ww          , Gs^Fp       , Gg^Fet      , Gs^Fp       , Ggf         , Hh          , Hh          , Ggf         , Gs^Fp       , Gs^Fp       , Ww          
