Mm^Xm       , Mm^Xm       , Mm^Xm       , Mm^Xm       , Mm^Xm       , Ha          , Mm^Xm       , Mm^Xm       , Mm^Xm       , Mm          , Mm^Xm       , Mm^Xm       , Mm^Xm       , Mm^Xm       , Mm^Xm       , Mm^Xm       , Mm^Xm       , Mm^Xm       , Aa^Fpa      , Ha          , Mm^Xm       , Mm^Xm       , Mm^Xm       , Mm^Xm       , Mm^Xm       , Mm^Xm       , Mm^Xm       , Ha          , Mm^Xm       , Mm          , Mm^Xm       , Mm^Xm       , Xu          , Xu          , Uu^Uf       , Uh^Ii       , Ww          , Ww          , Uu^Ii       , Uh^Ii       , Xu          , Mm^Xm       , Mm          , Mm^Xm       , Mm          , Mm^Xm       , Mm^Xm       , Mm^Xm       , Mm          , Mm          , Mm^Xm       , Mm^Xm       , Mm^Xm       , Wo          , Wo          
Mm^Xm       , Mm^Xm       , Aa^Fpa      , Mm^Xm       , Mm^Xm       , Mm          , Mm^Xm       , Aa^Fpa      , Mm^Xm       , Mm^Xm       , Mm          , Mm          , Mm          , Mm          , Mm          , Mm          , Mm          , Mm          , Mm^Xm       , Mm          , Mm^Xm       , Aa^Fpa      , Mm^Xm       , Mm          , Aa^Fpa      , Mm^Xm       , Mm          , Mm^Xm       , Aa^Fpa      , Mm          , Mm          , Ww          , Mm^Xm       , Mm          , Hh          , Ww          , Wwf         , Ww          , Ww          , Ww          , Mm          , Ww          , Mm^Xm       , Ww          , Mm^Xm       , Wo          , Wo          , Wo          , Hh          , Wo          , Mm^Xm       , Wo          , Wo          , Wo          , Wo          
Mm^Xm       , Hh          , Mm          , Wwf         , Mm          , Hh          , Mm^Xm       , Mm          , Mm^Xm       , Mm^Xm       , Mm^Xm       , Wwf         , Ww          , Ww          , Ww          , Ww          , Ww          , Ww          , Mm          , Mm^Xm       , Mm          , Mm          , Mm^Xm       , Mm          , Mm^Xm       , Mm          , Mm^Xm       , Mm          , Mm          , Ww          , Ww          , Ww          , Ww          , Ww          , Ww          , Ww          , Ww          , Ww          , Ww^Vm       , Ww          , Ww          , Ww          , Ww          , Ww          , Ww          , Ww          , Wo          , Wo          , Wo          , Wo          , Wo          , Wo          , Wo          , Wo          , Wo          
Wwf         , Ww          , Ww          , Ww          , Ww          , Ww          , Wwf         , Ww          , Mm          , Wwf         , Wwf         , Wo          , Wwf         , Wo          , Ww          , Ww          , Ww          , Ww          , Ww          , Ww          , Ww          , Ww          , Mm          , Wwf         , Mm          , Wwf         , Mm          , Ww          , Ww          , Ww          , Ww          , Mm          , Ww          , Ww          , Ww          , Ww          , Ww          , Ww          , Ww          , Wo          , Ww          , Ww          , Ww          , Ww          , Ww          , Ww          , Wo          , Wo          , Wo          , Wo          , Wo          , Wo          , Wo          , Wo          , Wo          
Ww          , Ww          , Ww          , Ww          , Ww          , Ww          , Ww          , Ww          , Ww          , Ww          , Ww          , Ww          , Wo          , Ww          , Ww          , Mm          , Ww          , Ww          , Ww          , Ww          , Ww          , Ww          , Ww          , Ww          , Ww          , Ww          , Ww          , Ww          , Ww          , Mm          , Mm          , Mm          , Ww          , Ww          , Ww^Vm       , Ww          , Ww          , Ww          , Ww          , Ww          , Wo          , Ww          , Ww          , Mm          , Ww          , Ww          , Ww          , Wo          , Wo          , Wo          , Wo          , Wo          , Wo          , Wo          , Wo          
Wwf         , Wwf         , Ww          , Ww          , Ww^Vm       , Ww          , Ww          , Ww          , Ww          , Ww          , Ww          , Ww          , Ww          , Ww          , Mm          , Mm          , Mm          , Gs^Fp       , Ww          , Ww          , Ww          , Hh          , Ww          , Ww          , Ww          , Ww          , Ww^Vm       , Ww          , Wwf         , Hh          , Mm          , Ww          , Ww          , Ww          , Ww          , Ww          , Ww          , Mm          , Wwf         , Wwf         , Ww          , Ww          , Mm          , Ww          , Ww          , Ww          , Ww          , Wo          , Wo          , Wo          , Wo          , Mm          , Mm          , Mm          , Mm          
Ce          , Ce          , Wwf         , Wwf         , Ww          , Ww          , Ww          , Ww          , Ww          , Ww          , Ww^Vm       , Ww          , Ww          , Ww          , Mm          , Mm          , Hh          , Hh          , Ww          , Ww          , Wwf         , Mm          , Mm          , Wwf         , Wwf         , Ww          , Ww          , Ww          , Ww          , Ww          , Ww          , Ww          , Ww          , Ww          , Ww          , Ww          , Mm          , Mm          , Mm          , Wwf         , Ww          , Ww          , Ww          , Ww          , Ww          , Ww          , Ww          , Hh          , Wo          , Mm^Xm       , Mm          , Mm          , Aa^Fpa      , Mm          , Mm          
Ce          , Ce          , Gs          , Mm          , Ww          , Mm          , Ww          , Ww          , Ww          , Ww          , Ww          , Ww          , Ww          , Ww          , Ww          , Wwf         , Wwf         , Wwf         , Ww          , Ww          , Ww          , Mm          , Mm          , Ww          , Ww          , Ww          , Ww          , Mm          , Ww          , Ww          , Ww          , Wo          , Wo          , Wo          , Ww          , Ww          , Mm          , Mm          , Mm          , Ww          , Ww          , Wo          , Ww          , Ww          , Ww          , Mm          , Mm          , Mm          , Mm^Xm       , Mm^Xm       , Ai          , Mm^Xm       , Mm          , Aa^Fpa      , Mm          
Ke          , Ce          , Mm          , Mm          , Mm          , Mm          , Ww          , Ww          , Ww          , Ww          , Ww          , Mm          , Ww          , Ww          , Ww          , Ww          , Ww^Vm       , Ww          , Ww          , Ww          , Ww          , Wwf         , Ww          , Ww          , Ww          , Wwf         , Mm          , Mm          , Mm          , Wwf         , Ww          , Ww          , Wo          , Ww          , Ww          , Ww          , Wwf         , Ww          , Ww          , Ww          , Ww          , Ww          , Ww          , Wwf         , Hh          , Mm          , Mm          , Ha          , Aa^Fpa      , Mm^Xm       , Mm^Xm       , Mm^Xm       , Mm^Xm       , Ha          , Mm^Xm       
Ce          , Ce          , Mm^Xm       , Mm^Xm       , Mm          , Ww          , Ww          , Ww          , Ww          , Ww          , Mm          , Mm          , Mm          , Wwf         , Ww          , Ww          , Ww          , Wo          , Ww          , Ww          , Ww          , Ww          , Ww          , Ww          , Ww          , Ww          , Mm          , Mm          , Wwf         , Ww          , Ww          , Ww          , Ww          , Ww          , Ww          , Ww          , Ww          , Ww^Vm       , Ww          , Ww          , Ww          , Ww          , Ww          , Ww          , Mm          , Mm          , Mm          , Mm^Xm       , Mm^Xm       , Mm^Xm       , Ha          , Mm^Xm       , Mm^Xm       , Mm^Xm       , Mm^Xm       
Ce          , Rd          , Gs^Fp       , Ww          , Ww          , Ww          , Ww          , Ww          , Ww          , Ww          , Mm          , Mm          , Gs^Fp       , Wwf         , Ww          , Ww          , Ww          , Ww          , Ww          , Ww          , Ww          , Wwf         , Ww          , Wwf         , Ww          , Ww          , Ww          , Ww          , Wwf         , Ww          , Ww          , Ww          , Ww          , Mm          , Ww          , Ww          , Ww          , Ww          , Ww          , Hh          , Mm          , Mm          , Ww          , Ww          , Ww          , Ww          , Mm          , Mm          , Mm^Xm       , Ha          , Mm^Xm       , Mm^Xm       , Aa^Fpa      , Mm^Xm       , Mm^Xm       
Gs^Fp       , Ww          , Wwf         , Ww          , Ww          , Wwf         , Gg          , Ww          , Wwf         , Wwf         , Mm          , Hh          , Wwf         , Ww          , Wwf         , Ww          , Ww          , Ww^Vm       , Ww          , Wwf         , Ww          , Hh          , Mm          , Mm          , Wwf         , Ww          , Ww          , Ww          , Ww          , Ww          , Ww          , Wwf         , Mm          , Mm          , Hh          , Wwf         , Ww          , Ww          , Wwf         , Gs^Fp       , Mm          , Hh          , Ww          , Ww          , Ww^Vm       , Ww          , Ww          , Ww          , Mm          , Mm          , Mm^Xm       , Mm          , Mm          , Mm          , Mm^Xm       
Ww          , Ww          , Ww          , Ww^Vm       , Ww          , Ww          , Gs^Fp       , Ww          , Ww          , Ww          , Ww          , Ww          , Ww          , Ww          , Ww          , Ww          , Ww          , Ww          , Ww          , Ww          , Wwf         , Hh          , Mm          , Mm          , Mm          , Ww          , Ww          , Ww          , Wo          , Ww          , Ww          , Ww          , Mm          , Wwf         , Hh          , Wwf         , Ww          , Ww          , Ww          , Wwf         , Mm          , Ww          , Ww          , Ww          , Ww          , Ww          , Ww          , Ww          , Ww          , Wwf         , Hh          , Hh          , Mm          , Mm          , Mm^Xm       
Ww          , Ww          , Ww          , Ww          , Ww          , Ww          , Ww          , Ww          , Ww^Vm       , Ww          , Ww          , Ww          , Ww          , Ww          , Ww          , Wo          , Ww          , Ww          , Ww          , Ww          , Ww          , Ww          , Mm          , Ww          , Ww          , Ww          , Ww^Vm       , Ww          , Wo          , Ww          , Ww          , Ww          , Ww          , Ww^Vm       , Wwf         , Ww          , Ww          , Ww          , Ww          , Ww^Vm       , Ww          , Ww          , Ww          , Wwf         , Wwf         , Hh          , Ww          , Ww          , Ww          , Ww          , Wwf         , Wwf         , Mm          , Mm          , Mm^Xm       
Ww          , Ww          , Ww          , Ww          , Ww          , Ww          , Ww          , Ww          , Ww          , Ww          , Ww          , Wo          , Ww          , Wo          , Wo          , Wo          , Wo          , Wo          , Ww          , Ww          , Ww          , Ww          , Ww          , Ww          , Ww          , Ww          , Ww          , Ww          , Ww          , Ww          , Ww          , Ww          , Ww          , Ww          , Ww          , Ww          , Ww          , Ww          , Ww          , Ww          , Ww          , Ww          , Ww          , Mm          , Mm          , Mm          , Wwf         , Ww          , Ww          , Ww          , Ww          , Wwf         , Gs^Fp       , Mm          , Mm          
Ww          , Wo          , Ww          , Wo          , Ww          , Wo          , Ww          , Wo          , Ww          , Wo          , Wo          , Wo          , Wo          , Wo          , Wo          , Ss          , Wo          , Wo          , Wo          , Wo          , Wo          , Wo          , Ww          , Wo          , Ww          , Wo          , Ww          , Wo          , Ww          , Wo          , Ww          , Wo          , Ww          , Ww          , Ww          , Wo          , Ww          , Wo          , Ww          , Ww          , Ww          , Ww          , Mm          , Mm          , Mm          , Mm          , Hh          , Ww          , Ww          , Ww^Vm       , Ww          , Ww          , Hh          , Hh          , Mm          
Wo          , Wo          , Wo          , Wo          , Wo          , Wo          , Wo          , Wo          , Wo          , Wo          , Wo          , Ss          , Wo          , Ss          , Ss          , Gs^Fp       , Ss          , Ss          , Wo          , Ss          , Wo          , Wo          , Wo          , Wo          , Wo          , Wo          , Wo          , Wo          , Wo          , Wo          , Wo          , Wo          , Wo          , Wo          , Wo          , Wo          , Wo          , Wo          , Wo          , Ww          , Ww          , Ww          , Ww          , Ww          , Mm          , Ww          , Ww          , Ww          , Ww          , Ww          , Ww          , Ww          , Gs^Fp       , Mm          , Hh          
Wo          , Ss          , Wo          , Ss          , Ss          , Ss          , Ss          , Ss          , Ss          , Gs^Ft       , Ss          , Ss          , Ss          , Ss          , Hh          , Gg          , Gs^Ft       , Ss          , Ss          , Ss          , Ss          , Ss          , Ss          , Ss          , Ss          , Ss          , Ss          , Ss          , Ss          , Ss          , Ss          , Ss          , Wo          , Ss          , Wo          , Ss          , Ss          , Ss          , Wo          , Wo          , Ww          , Ww          , Ww          , Ww          , Ww          , Ww          , Ww          , Wo          , Wo          , Ww          , Ww          , Ww          , Gs^Fp       , Hh          , Gs^Fp       
Ss          , Ss          , Ss          , Gs^Ft       , Ss          , Ss          , Ss          , Ss          , Ss          , Ss          , Ss          , Ss          , Ss          , Ss          , Ss          , Ss          , Ss          , Ss          , Ss          , Gg          , Ss          , Ss          , Gs^Fp       , Ss          , Ss          , Gg          , Ss          , Ss          , Ss          , Gg          , Ss          , Ss          , Ss          , Gg          , Ss          , Gs^Fp       , Gs^Ft       , Hh          , Ss          , Ss          , Ww          , Ww          , Ww          , Ww          , Ww^Vm       , Ww          , Ww          , Ww          , Ww          , Ww          , Ww          , Gs^Fp       , Gg          , Gs^Ft       , Gg          
Ss          , Ss          , Ss          , Ss          , Ss          , Ss          , Ss          , Ss          , Gs^Ft       , Ss          , Ss          , Gs^Fp       , Ss          , Ss          , Ss          , Ss          , Ss          , Ss          , Ss          , Ss          , Ss          , Ss          , Ss          , Ss          , Ss          , Gs^Ft       , Gs^Ft       , Ss          , Ss          , Gs^Fp       , Gs^Ft       , Ss          , Ss          , Gs^Ft       , Ss          , Hh          , Ggf         , Ss          , Gs^Ft       , Ss          , Gs^Ft       , Ss          , Ww          , Ww          , Ww          , Ww          , Ww          , Gs^Fp       , Ww          , Ss          , Ggf         , Hh          , Hh          , Gs^Fp       , Hh          
Ss          , Ss          , Ss          , Ss          , Ss          , Gs^Ft       , Gs^Fp       , Ss          , Ss          , Ss          , Ss          , Ss          , Ss          , Ss          , Ss          , Ss          , Gs^Fp       , Ss          , Ss          , Ss          , Ss          , Ss          , Ss          , Ss          , Ss          , Ss          , Ss          , Ss          , Ss          , Ss          , Gs^Fp       , Ss          , Ss          , Ss          , Ss          , Ss          , Gs^Fp       , Ss          , Ss          , Ss          , Ss          , Ss          , Ss          , Ss          , Ww          , Hh          , Ss          , Ss          , Ss          , Gs^Fp       , Hh          , Gs^Fp       , Gg          , Hh          , Gs^Ft       
Gs^Ft       , Gs^Fp       , Ss          , Ss          , Ss          , Ss          , Ss          , Ss          , Ss          , Ss          , Ss          , Ss          , Ss          , Ss          , Gs^Ft       , Ss          , Gs^Ft       , Ss          , Ss          , Gs^Fp       , Ss          , Ss          , Ss          , Gs^Ft       , Ss          , Ss          , Ss          , Ss          , Ss          , Ss          , Ss          , Ss          , Ss          , Gs^Ft       , Ss          , Ss          , Ss          , Ss          , Ss          , Ss          , Ss          , Ss          , Gs^Fp       , Ss          , Ss          , Gs^Fp       , Hh          , Ss          , Ss          , Ss          , Hh          , Ss          , Gs^Ft       , Hh          , Gs^Fp       
