border_size=1
usage=map

Mm          , Mm          , Mm          , Mm          , Mm          , Mm          , Mm          , Mm          , Mm          , Mm          , Mm          , Mm          , Mm          , Mm          , Uu          , Rr          , Rr          , Uu          , Uu          , Uu          , Mm          , Mm          , Mm          , Mm          , Mm          , Mm          , Mm          , Mm          , Mm          , Mm          , Mm          , Mm          , Mm          , Mm          , Mm          , Mm          , Mm          , Mm          , Mm          , Mm          
Mm          , Mm          , Mm          , Mm          , Mm          , Mm          , Mm          , Mm          , Mm          , Mm          , Mm          , Mm          , Mm          , Mm          , Uu          , Rr          , Rr          , Uu          , Uu          , Uu          , Mm          , Mm          , Mm          , Mm          , Mm          , Mm          , Mm          , Mm          , Mm          , Mm          , Mm          , Mm          , Mm          , Mm          , Mm          , Mm          , Mm          , Mm          , Mm          , Mm          
Mm          , Mm          , Mm          , Mm          , Uu          , Uu          , Uu          , Mm          , Mm          , Mm          , Mm          , Mm          , Mm          , Uu          , Rr          , Rr          , Uu          , Rr          , Rr          , Uu          , Mm          , Mm          , Mm          , Mm          , Uu          , Uu          , Uu          , Mm          , Mm          , Mm          , Mm          , Mm          , Mm          , Mm          , Mm          , Mm          , Mm          , Mm          , Mm          , Mm          
Mm          , Mm          , Mm          , Uu          , Rr          , 2 Ko        , Co          , Uu          , Rr          , Mm          , Uu^Vu       , Uu          , Rr          , Rr          , Uu          , Uu          , Uu          , Uu          , Rr          , Uu          , Uu          , Mm          , Rr          , Uu^Vu       , Mm          , Uu          , Mm          , Uu          , Uu          , Mm          , Mm          , Mm          , Mm          , Mm          , Mm          , Mm          , Mm          , Mm          , Mm          , Mm          
Mm          , Mm          , Rr          , Rr          , Mm          , Rr          , Rr          , Rr          , Uu^Vu       , Rr          , Rr          , Rr          , Mm          , Mm          , Mm          , Mm          , Mm          , Uu          , Uu          , Rr          , Rr          , Uu          , Rr          , Uu          , Uu          , Mm          , Mm          , Mm          , Mm          , Mm          , Mm          , Mm          , Mm          , Mm          , Mm          , Mm          , Uu          , Mm          , Mm          , Mm          
Mm          , Mm          , Rr          , Mm          , Mm          , Mm          , Mm          , Mm          , Mm          , Mm          , Uu          , Uu          , Mm          , Mm          , Mm          , Mm          , Mm          , Mm          , Mm          , Uu          , Uu          , Rr          , Uu          , Rr          , Rr          , Uu          , Mm          , Mm          , Mm          , Mm          , Mm          , Mm          , Uu          , Mm          , Mm          , Mm          , Uu          , Uu          , Mm          , Mm          
Mm          , Mm          , Uu          , Uu          , Uu          , Mm          , Mm          , Mm          , Mm          , Uu          , Mm          , Mm          , Mm          , Mm          , Mm          , Mm          , Mm          , Mm          , Mm          , Mm          , Mm          , Uu          , Mm          , Uu          , Rr          , Uu          , Uu          , Mm          , Mm          , Mm          , Mm          , Mm          , Mm          , Uu          , Mm          , Mm          , Uu          , Mm          , Mm          , Mm          
Mm          , Mm          , Uu          , Cud         , Uu          , Mm          , Mm          , Mm          , Mm          , Mm          , Mm          , Mm          , Mm          , Mm          , Xu          , Xu          , Xu          , Mm          , Mm          , Mm          , Mm          , Mm          , Mm          , Uu          , Uu          , Rr          , Rr          , Uu          , Uu          , Mm          , Mm          , Mm          , Mm          , Uu          , Uu          , Uu          , Mm          , Mm          , Mm          , Mm          
Mm          , Mm          , Uu^Vu       , Uu          , Mm          , Mm          , Xu          , Xu          , Xu          , Mm          , Xu          , Mm          , Xu          , Xu          , Mm          , Mm          , Mm          , Xu          , Xu          , Mm          , Mm          , Mm          , Mm          , Mm          , Mm          , Uu          , Uu          , Rr          , Uu          , Uu          , Mm          , Mm          , Mm          , Mm          , Uu          , Uu          , Mm          , Mm          , Mm          , Mm          
Mm          , Mm          , Mm          , Mm          , Xu          , Xu          , Mm          , Mm          , Mm          , Xu          , Mm          , Xu          , Mm          , Mm          , Mm          , Mm          , Mm          , Mm          , Mm          , Xu          , Xu          , Mm          , Mm          , Mm          , Mm          , Mm          , Uu          , Rr          , Rr          , Uu          , Mm          , Mm          , Uu          , Mm          , Mm          , Uu          , Mm          , Mm          , Mm          , Mm          
Xu          , Xu          , Xu          , Xu          , Mm          , Mm          , Mm          , Mm          , Mm          , Mm          , Mm          , Mm          , Mm          , Mm          , Rb          , Rb          , Rb          , Mm          , Mm          , Mm          , Xu          , Mm          , Mm          , Mm          , Mm          , Mm          , Mm          , Uu          , Rr          , Uu          , Uu          , Mm          , Uu          , Uu          , Uu          , Uu          , Mm          , Mm          , Mm          , Mm          
Mm          , Mm          , Mm          , Mm          , Mm          , Mm          , Mm          , Uu          , Mm          , Mm          , Uu          , Mm          , Uu          , Rb          , Ss          , Ss          , Rb          , Mm          , Mm          , Xu          , Mm          , Mm          , Mm          , Mm          , Rb          , Mm          , Mm          , Uu          , Uu          , Rr          , Uu          , Mm          , Rb          , Rb          , Uu^Vu       , Mm          , Mm          , Mm          , Mm          , Mm          
Mm          , Mm          , Mm          , Mm          , Uu          , Mm          , Mm          , Uu          , Uu          , Uu          , Uu          , Uu          , Uu          , Rb          , Rb          , Ss          , Rb          , Mm          , Mm          , Xu          , Mm          , Mm          , Uu^Vu       , Rb          , Ss          , Rb          , Rb          , Mm          , Mm          , Uu          , Rb          , Uu          , Rb          , Uu          , Mm          , Mm          , Mm          , Mm          , Mm          , Mm          
Ww          , Ww          , Mm          , Mm          , Mm          , Uu          , Uu          , Uu          , Rb          , Uu          , Rb          , Rb          , Rb          , Rb          , Uu          , Rb          , Uu^Vu       , Mm          , Mm          , Xu          , Mm          , Mm          , Mm          , Rb          , Ss          , Ss          , Rb          , Rb          , Rb          , Rb          , Rb          , Rb          , Uu          , Mm          , Mm          , Mm          , Mm          , Mm          , Mm          , Mm          
Ww          , Ww          , Ww          , Uu          , Uu          , Uu          , Uu          , Rb          , Rb          , Rb          , Ss          , Ss          , Uu          , Uu          , Mm          , Mm          , Mm          , Mm          , Mm          , Xu          , Mm          , Mm          , Mm          , Mm          , Mm          , Ss          , Ss          , Rb          , Rb          , Rb          , Rb          , Uu          , Uu          , Mm          , Mm          , Mm          , Mm          , Mm          , Mm          , Mm          
Wo          , Wo          , Ww          , Uu          , Uu          , Uu          , Rb          , Rb          , Ww          , Rb          , Rb          , Uu          , Mm          , Mm          , Mm          , Mm          , Mm          , Mm          , Xu          , Xu          , Mm          , Mm          , Mm          , Mm          , Mm          , Mm          , Mm          , Mm          , Mm          , Mm          , Rb          , Rb          , Rb          , Uu          , Uu          , Mm          , Mm          , Mm          , Mm          , Mm          
Wo          , Wo          , Ww          , Rb          , Rb          , Rb          , Ww          , Rb          , Ww          , Rb          , Uu          , Uu          , Mm          , Mm          , Mm          , Mm          , Mm          , Mm          , Mm          , Mm          , Mm          , Mm          , Uu^Vu       , Mm          , Mm          , Mm          , Mm          , Mm          , Mm          , Mm          , Uu          , Uu          , Rb          , Uu          , Uu          , Mm          , Mm          , Mm          , Mm          , Mm          
Wo          , Wo          , Ww          , Ww          , Ww          , Ww          , Ww          , Ww          , Rb          , Rb          , Uu          , Mm          , Uu          , Uu          , Uu          , Mm          , Mm          , Mm          , Mm          , Mm          , Mm          , Mm          , Mm          , Rb          , Rb          , Mm          , Mm          , Mm          , Mm          , Mm          , Mm          , Uu          , Rb          , Rb          , Uu          , Uu          , Mm          , Mm          , Mm          , Mm          
Wo          , Wo          , Wo          , Wo          , Wo          , Wo          , Ww          , Ww          , Uu          , Uu          , Rr          , Uu          , Rr          , Cud         , Uu          , Uu          , Uu          , Uu          , Uu          , Uu          , Mm          , Mm          , Mm          , Uu          , Rb          , Uu          , Uu          , Uu          , Uu          , Mm          , Uu          , Uu          , Rb          , Rb          , Rb          , Rb          , Uu^Vu       , Mm          , Mm          , Mm          
Wo          , Wo          , Wo          , Wo          , Wo          , Wo          , Ww          , Uu          , Uu          , Rr          , Cud         , Rr          , Rr          , Rr          , Rr          , Uu          , Cud         , Uu          , Uu          , Mm          , Mm          , Mm          , Uu          , Uu          , Rb          , Rb          , Rb          , Uu          , Uu          , Uu          , Rb          , Rb          , Rb          , Rb          , Uu          , Mm          , Mm          , Mm          , Mm          , Mm          
Wo          , Wo          , Wo          , Wo          , Wo          , Ww          , Uu          , Uu          , Uu          , Uu          , Rr          , Rr          , Rr          , Rr          , Rr          , Rr          , Uu          , Uu          , Uu          , Uu          , Mm          , Mm          , Mm          , Uu          , Rb          , Ss          , Ss          , Rb          , Rb          , Rb          , Uu          , Uu          , Uu          , Rb          , Uu          , Mm          , Mm          , Mm          , Mm          , Mm          
Wo          , Wo          , Wo          , Wo          , Wo          , Ww          , Ww          , Uu          , Uu          , Uu          , Rr          , Rr          , Rr          , 1 Rr        , Rr          , Rr          , Rr          , Rr          , Uu          , Uu          , Uu          , Mm          , Mm          , Uu          , Rb          , Ss          , Rb          , Rb          , Uu          , Uu          , Mm          , Mm          , Mm          , Uu          , Uu          , Uu          , Mm          , Mm          , Mm          , Mm          
Wo          , Wo          , Wo          , Wo          , Wo          , Wo          , Ww          , Ww          , Uu          , Uu          , Cud         , Rr          , Rr          , Rr          , Rr          , Rr          , Cud         , Rr          , Rr          , Uu          , Mm          , Mm          , Uu          , Uu          , Rb          , Rb          , Uu          , Uu          , Mm          , Uu          , Mm          , Mm          , Mm          , Mm          , Mm          , Uu          , Mm          , Mm          , Mm          , Mm          
Wo          , Wo          , Wo          , Wo          , Wo          , Wo          , Ww          , Uu          , Uu          , Uu          , Uu          , Uu          , Rr          , Rr          , Rr          , Rr          , Uu          , Rr          , Rr          , Uu          , Uu          , Uu          , Rb          , Rb          , Ww          , Rb          , Uu          , Mm          , Mm          , Mm          , Mm          , Mm          , Uu          , Mm          , Uu          , Uu          , Uu          , Uu          , Mm          , Mm          
Wo          , Wo          , Wo          , Wo          , Wo          , Wo          , Ww          , Uu          , Uu          , Uu          , Ww          , Uu          , Uu          , Cud         , Uu          , Uu          , Uu          , Uu          , Uu          , Uu          , Rb          , Uu          , Rb          , Ww          , Rb          , Rb          , Uu          , Uu          , Uu          , Mm          , Mm          , Mm          , Mm          , Uu          , Mm          , Mm          , Mm          , Mm          , Mm          , Mm          
Wo          , Wo          , Wo          , Wo          , Wo          , Wo          , Ww          , Uu          , Ww          , Ww          , Ww          , Uu          , Ww          , Uu          , Uu          , Uu          , Ww          , Ww          , Ww          , Ww          , Rb          , Rb          , Ww          , Ww          , Rb          , Uu          , Mm          , Mm          , Mm          , Mm          , Mm          , Mm          , Mm          , Mm          , Mm          , Mm          , Mm          , Mm          , Mm          , Mm          
Wo          , Wo          , Wo          , Wo          , Wo          , Wo          , Wo          , Ww          , Wo          , Wo          , Wo          , Ww          , Wo          , Ww          , Ww          , Ww          , Wo          , Wo          , Wo          , Ww          , Ww          , Ww          , Wo          , Ww          , Rb          , Uu          , Mm          , Mm          , Mm          , Mm          , Mm          , Mm          , Mm          , Mm          , Mm          , Mm          , Mm          , Mm          , Ww          , Ww          
Wo          , Wo          , Wo          , Wo          , Wo          , Wo          , Wo          , Wo          , Wo          , Wo          , Wo          , Wo          , Wo          , Wo          , Wo          , Wo          , Wo          , Wo          , Wo          , Wo          , Wo          , Wo          , Wo          , Ww          , Ww          , Uu          , Ww          , Mm          , Ww          , Mm          , Mm          , Mm          , Ww          , Mm          , Ww          , Mm          , Ww          , Ww          , Wo          , Wo          
Wo          , Wo          , Wo          , Wo          , Wo          , Wo          , Wo          , Wo          , Wo          , Wo          , Wo          , Wo          , Wo          , Wo          , Wo          , Wo          , Wo          , Wo          , Wo          , Wo          , Wo          , Wo          , Wo          , Wo          , Wo          , Ww          , Wo          , Ww          , Wo          , Ww          , Ww          , Ww          , Wo          , Ww          , Wo          , Ww          , Wo          , Wo          , Wo          , Wo          
Wo          , Wo          , Wo          , Wo          , Wo          , Wo          , Wo          , Wo          , Wo          , Wo          , Wo          , Wo          , Wo          , Wo          , Wo          , Wo          , Wo          , Wo          , Wo          , Wo          , Wo          , Wo          , Wo          , Wo          , Wo          , Ww          , Wo          , Ww          , Wo          , Ww          , Ww          , Ww          , Wo          , Ww          , Wo          , Ww          , Wo          , Wo          , Wo          , Wo          
