Ms^Xm, Ms^Xm, Ms^Xm, Aa^Fpa, Aa^Fpa, Aa^Fpa, Aa^Fpa, Aa^Fpa, Aa^Fpa, Aa^Fpa, Aa^Fpa, Aa^Fpa, Aa^Fpa, Aa^Fpa, Aa^Fpa, Aa^Fpa, Aa^Fpa, Gs^Fp, Gs^Fp, Gg, Gs^Fp, Gg, Gs^Fp, Gs^Fp, Gs^Fp, Gs^Fp, Gs^Fp, Gs^Fp, Gs^Fp, Gg, Rr, Gs^Fp, Ce, Gs^Fp, Ww, Gg, Gs^Fp, Gs^Fp, Gs^Fp, Gs^Fp, Gs^Fp, Gs^Fp, Gs^Fp, Gs^Fp, Aa^Fpa, Gs^Fp, Aa^Fpa, Aa^Fpa, Aa^Fpa, Aa^Fpa, Aa^Fpa, Aa^Fpa, Aa^Fpa, Ha, Ha, Ha, Ha, Ha, Ms^Xm, Ha, Ha, Ha
Ms^Xm, Ms^Xm, Ms, Ha, Ha, Aa^Fpa, Ha, Aa^Fpa, Ha, Aa^Fpa, Aa^Fpa, Aa^Fpa, Aa^Fpa, Aa^Fpa, Aa^Fpa, Aa^Fpa, Aa^Fpa, Gs^Fp, Gd^Fmf, Gs^Fp, Gs^Fp, Gs^Fp, Gs^Fp, Gs^Fp, Gs^Fp, Gs^Fp, Gs^Fp, Gs^Fp, Gs^Fp, Gs^Fp, Rr, Ce, Gs^Fp, Ce, Ww, Gd^Fmf, Gs^Fp, Gs^Fp, Gs^Fp, Gs^Fp, Gs^Fp, Gs^Fp, Gs^Fp, Gs^Fp, Aa^Fpa, Aa^Fpa, Aa^Fpa, Aa^Fpa, Aa^Fpa, Ai, Aa^Fpa, Aa^Fpa, Ms, Ms, Ms, Ms, Ms, Ha, Ms, Ms^Xm, Ms^Xm, Ha
Ms, Ms, Ms, Ms, Ha, Ha, Ha, Ha, Ha, Ha, Aa^Fpa, Aa^Fpa, Gg, Aa^Fpa, Aa^Fpa, Aa^Fpa, Aa^Fpa, Gd^Fmf, Gd^Fmf, Gd^Fmf, Gd^Fmf, Gs^Fp, Gg, Gs^Fp, Gs^Fp, Gs^Fp, Gs^Fp, Gs^Fp, Gs^Fp, Gs^Fp, Rr, Ce, Ce, Ce, Ww, Gd^Fmf, Gs^Fp, Gs^Fp, Gs^Fp, Gs^Fp, Gs^Fp, Gs^Fp, Gs^Fp, Gs^Fp, Aa^Fpa, Aa^Fpa, Aa^Fpa, Aa^Fpa, Aa^Fpa, Ai, Aa^Fpa, Aa^Fpa, Aa^Fpa, Ms, Gg, Ms, Ms, Ms, Ms, Ms^Xm, Ms^Xm, Ms^Xm
Ms^Xm, Ms, Ms, Ms, Ms, Ha, Ha, Ha, Gg, Aa^Fpa, Gs^Fp, Gg, Gg, Gg, Gg, Aa^Fpa, Gg, Gg, Gd^Fmf, Gg, Gd^Fmf, Gd^Fmf, Gd^Fmf, Gs^Fp, Gd^Fmf, Gs^Fp, Gd^Fmf, Gs^Fp, Gs^Fp, Gs^Fp, Rr, Ce, Ce, 1 Ke, Ww, Gd^Fmf, Gd^Fmf, Gd^Fmf, Gd^Fmf, Gd^Fmf, Gd^Fmf, Gd^Fmf, Gs^Fp, Gs^Fp, Aa^Fpa, Aa^Fpa, Aa^Fpa, Aa^Fpa, Aa^Fpa, Ai, Ai, Aa^Fpa, Aa^Fpa, Gg, Gg, Gg, Gd^Fdf, Ms, Ms, Ms, Ms^Xm, Ms^Xm
Ms^Xm, Ms, Ms^Xm, Ms^Xm, Ha, Ha, Ce, Gg, Gg, Gs^Fp, Gs^Fp, Gg, Gg, Gg, Gg, Gg, Gg, Gg, Gd^Fmf, Gd^Fmf, Gg, Gg, Gg, Gd^Fmf, Gs^Fp, Gs^Fp, Gd^Fmf, Gs^Fp, Gg, Gs^Fp, Gg, Rr, Gd^Fmf, Gd^Fmf, Ww, Gd^Fmf, Gd^Fmf, Gd^Fmf, Gd^Fmf, Gd^Fmf, Gd^Fmf, Gs^Fp, Gs^Fp, Aa^Fpa, Aa^Fpa, Aa^Fpa, Aa^Fpa, Aa^Fpa, Aa^Fpa, Aa^Fpa, Ai, Aa^Fpa, Gg, Gg, Gg, Gg, Gd^Fdf, Gg, Ms^Xm, Ms^Xm, Ms^Xm, Ms^Xm
Ms^Xm, Ms^Xm, Ms^Xm, Ms^Xm, Ms^Xm, Ce, Gg, Ce, Ce, Gs^Fp, Gs^Fp, Gg, Gg, Gg, Gg, Gg, Gg, Gg, Gg, Gd^Fmf, Gd^Fmf, Gg, Gg, Gd^Fmf, Gd^Fmf, Gd^Fmf, Gd^Fmf, Gd^Fmf, Gs^Fp, Gg, Gg, Rr, Gd^Fmf, Gg, Gd^Fmf, Ww, Ww, Gg, Gg, Gd^Fmf, Gs^Fp, Gs^Fp, Gg, Gg, Gg, Aa^Fpa, Aa^Fpa, Aa^Fpa, Aa^Fpa, Aa^Fpa, Gg, Ww, Gg, Gg, Gg, Gg, Gd^Fdf, Gg, Gg, Ms^Xm, Ms^Xm, Ha^Vhha
Ms^Xm, Ms^Xm, Ms^Xm, Ms^Xm, Ms^Xm, Ce, Gg, Gg, Ce, Gs^Fp, Gs^Fp, Gg, Gg, Gg, Gg, Gg, Gg^Efm, Gg, Gg, Gg, Gg, Gg, Gg, Gg, Gg, Gg, Gg, Gg, Gg, Gs^Fp, Gg, Rr, Gg, Gd^Fmf, Gg, Gg, Gg, Ww, Ww, Gg, Gg, Gg, Gg, Gg, Gg, Gg, Gg, Aa^Fpa, Aa^Fpa, Aa^Fpa, Gg, Ww, Gg, Gg, Gg, Gd^Fdf, Gd^Fdf, Gg, Gg, Ms^Xm, Ms^Xm, Gg
Ms^Xm, Ms^Xm, Ms^Xm, Ms^Xm, Ms^Xm, Ce, Ce, 2 Ke, Gg, Gg, Gs^Fp, Gg, Gg, Gg, Gg, Gg, Gg, Gg, Gg^Efm, Gg, Gg, Gg, Gg, Gg, Gg, Gg, Gg, Gg, Gg, Gg, Gg, Rr, Rr, Gg, Gg, Gg, Gg, Gg, Gg, Ww, Ww, Gg, Gd^Fdf, Gg, Gg, Gg, Gg, Gg, Gg, Gg, Gg, Ww, Gg, Gg, Gg, Gd^Fdf, Gd^Fdf, Gg, Gg, Ms^Xm, Ms^Xm, Ms^Xm
Ms^Xm, Ms^Xm, Ms^Xm, Ms^Xm, Ms^Xm, Ms^Xm, Ms^Xm, Gg, Gd^Fdf, Gd^Fdf, Gg, Gg, Gg, Gg^Efm, Gg, Gg, Gg, Gg, Gg, Gg, Gg, Gg, Gs^Fp, Gs^Fp, Gs^Fp, Gs^Fp, Gg, Gg, Gg, Gg, Gs^Fp, Gg, Gg, Rp, Gg, Gs^Fp, Gg, Gg, Gg, Gg, Gg, Ww, Ww, Gd^Fdf, Gd^Fdf, Gg, Gg, Gg, Gg, Gg, Gg, Ww, Gg, Gg, Gg, Gd^Fdf, Gg, Gg, Gg, Ms^Xm, Ms^Xm, Ms^Xm
Ms^Xm, Ms^Xm, Ms^Xm, Ms^Xm, Ms^Xm, Ms^Xm, Ms^Xm, Gg, Gd^Fdf, Gg, Gg, Gg, Gg, Gg, Gg, Gg, Gg^Efm, Gg, Gg, Gg^Efm, Gs^Fp, Gg, Gs^Fp, Gs^Fp, Gd^Fmf, Gd^Fmf, Gs^Fp, Gd^Fmf, Gg, Gg, Gg, Gg, Gg, Rp, Gg, Gg, Gd^Fdf, Gd^Fdf, Gg, Gg, Gg, Gg, Ww, Gd^Fdf, Gd^Fdf, Gd^Fdf, Gd^Fdf, Gg, Gg, Gg, Gg, Ww, Gg, Gg, Gg, Gd^Fdf, Gg, Gg, Gg, Gg, Gg, Ms^Xm
Gg, Ms^Xm, Ms^Xm, Ms^Xm, Ms^Xm, Ms^Xm, Ms^Xm, Gg, Gg, Gs^Fp, Gg, Gg, Gg, Gg, Gg, Gg, Gg, Gg, Gg, Gg^Efm, Gs^Fp, Gs^Fp, Gs^Fp, Gd^Fmf, Gd^Fmf, Gd^Fmf, Gd^Fdf, Gg, Gg, Gg, Gg, Gg, Gg, Rp, Gg, Gg, Gd^Fdf, Gg, Gg, Gg, Gg, Gg, Gg, Ww, Ww, Gg, Gg, Gd^Fdf, Gd^Fdf, Gd^Fdf, Gg, Ww, Gg, Gg, Gg, Gg, Gg, Gg, Gg, Gg, Gg, Ms^Xm
Gg, Gg, Gg, Gg, Gg, Gg, Gg, Gg, Gg, Gs^Fp, Gs^Fp, Gg^Efm, Gg, Gg^Efm, Gg, Gg, Gg, Gg, Gg, Gg, Gd^Fdf, Gd^Fdf, Gg, Gg, Gg^Vh, Gd^Fdf, Gg, Gg, Gg, Gg, Gg, Gg, Dd^Dr, Rp, Rp, Gg, Gd^Fdf, Gd^Fdf, Gg, Gg, Gg, Gg, Gg, Gg, Gg^Ve, Ww, Ww, Gd^Fdf, Gd^Fdf, Gd^Fdf, Gd^Fdf, Ww, Gg, Gg, Gg, Gg, Gg, Gg, Gg, Gg, Gg, Gg
Gd^Fmf, Gg, Gg, Gg, Gg, Gg, Gg, Gg, Gg, Gg, Gg^Efm, Gs^Fp, Gg, Gg, Gg, Gg, Gg, Gg, Gg, Gg, Gd^Fdf, Gd^Fdf, Gd^Fdf, Gg, Gd^Fdf, Gd^Fdf, Gg^Fet, Gg^Fet, Gg, Gg, Gg, Gg, Re^Gvs, Rp, Rp, Gd^Fdf, Gg^Fet, Gd^Fdf, Gg, Gg, Gg, Gg, Gg, Gg, Gg, Gg, Gg, Ww, Ww, Gd^Fdf, Ww, Ww, Ww, Gg, Gg, Gg, Gg, Gg, Gg, Gg, Gg, Gg
Gg, Gd^Fmf, Gg, Gg, Gg, Gg, Gg, Gg, Gg, Gg^Efm, Gg, Gd^Fdf, Gd^Fdf, Gd^Fmf, Gd^Fmf, Gg, Gg, Gg^Efm, Gg, Gg, Gg, Gd^Fdf, Gg, Gg, Gg, Gd^Fdf, Gg^Fet, Gg^Fet, Gg^Fet, Gg, Re^Gvs, Re^Gvs, Re^Gvs, Re^Gvs, Re^Gvs, Rp, Gg^Fet, Gg^Fet, Gg^Fet, Gg, Gg, Gg, Gg, Gg, Gg, Gg, Gg, Gd^Fdf, Gd^Fdf, Ww, Gg, Gg, Gg, Ww, Gg, Gg, Gg, Gg, Gg, Gg, Gg, Gg
Gg, Gd^Fmf, Gg, Gg, Gg, Gg, Gg, Gg, Gg, Gg, Gg, Gd^Fdf, Gd^Fdf, Gd^Fdf, Gg, Gg, Gd^Fmf, Gd^Fmf, Gg, Gg, Gg, Gg, Gg, Gg, Gg, Gg, Gg, Gg^Fet, Re^Gvs, Re^Gvs, Re^Gvs, Re^Gvs, Re^Gvs, Re^Gvs, Re^Gvs, Rp, Gg, Gg^Fet, Gg^Fet, Gg^Fet, Gg, Gg, Gg, Gg, Gg, Gg, Gd^Fdf, Gd^Fdf, Gg, Gg, Gg, Gg, Gg, Ww, Gg, Gg, Gg, Gg, Gg, Gg, Gg, Gg
Gg, Gg, Gg, Gg, Gg, Gg, Gg, Gg, Gg, Gg^Efm, Gg, Gg, Gd^Fdf, Gg, Gg, Gd^Fdf, Gd^Fmf, Gg, Gg, Gg, Gg, Gg, Gg, Gg, Gg, Gg, Re^Gvs, Re^Gvs, Re^Gvs, Re^Gvs, Re^Gvs, Re^Gvs, Re^Gvs, Re^Gvs, Rp, Rp, Gg, Gg, Gg^Fet, Gg^Fet, Gg^Fet, Gg, Gg, Gg, Gg, Gg, Gd^Fdf, Gd^Fdf, Gg, Gg, Gg, Gg, Gg, Ww, Gg, Gg, Gd^Fdf, Gg, Gg, Gg, Gg, Gg
Gg, Gd^Fmf, Gd^Fmf, Gg, Gg, Gg, Gg, Gg, Gg, Gg, Gg, Gg, Gg, Gg, Gg, Gd^Fdf, Gd^Fdf, Gg, Gg, Gg, Gg, Gg, Gg, Gg, Re^Gvs, Re^Gvs, Re^Gvs, Re^Gvs, Re^Gvs, Re^Gvs, Re^Gvs, Re^Gvs, Gg, Gg, Rp, Gg, Gg, Gg, Gg, Gg^Fet, Gg^Fet, Gg, Gg, Gg, Gg, Gg, Gg, Gd^Fdf, Gg, Gg, Gg, Gg, Gg, Ww, Ww, Gd^Fdf, Gd^Fdf, Gg, Gg, Gg, Gg, Gg
Gg, Gd^Fmf, Gd^Fmf, Gg, Gg, Gg^Vh, Gg, Gg, Gg, Gg, Gg, Gg, Gg, Gg, Gg, Gd^Fdf, Gd^Fdf, Gg, Gg, Gg, Gg, Gg, Gd^Fmf, Re^Gvs, Re^Gvs, Re^Gvs, Re^Gvs, Re^Gvs, Re^Gvs, Re^Gvs, Gg^Fet, Gg^Fet, Gg, Gg, Rp, Gg, Gg, Gg, Gg, Gg, Gg, Gg^Fet, Gg^Fet, Gg, Gg, Gg, Gg, Gd^Fdf, Gd^Fdf, Gg, Gg, Gg, Gg, Gg, Ww, Gd^Fdf, Gg, Gg, Gg, Gg, Gg, Gg
Gg, Gd^Fmf, Gg, Gg, Gg, Gg, Gg, Gg, Gg, Gg, Gg, Gg, Gg, Gg, Gg, Gd^Fdf, Gg, Gg, Gg, Gg, Gg, Gg, Gd^Fmf, Re^Gvs, Re^Gvs, Re^Gvs, Re^Gvs, Re^Gvs, Gg^Fet, Gg^Fet, Gg^Fet, Gg^Fet, Gg, Gg, Rp, Gg, Gg, Gg, Gg, Gg, Gg^Fet, Gg^Fet, Gg^Fet, Gg^Fet, Gg, Gg, Gg, Gd^Fdf, Gg, Gg, Gg, Gg, Gg, Ww, Gg, Gg, Gg, Gg, Gg, Gg, Gg, Gg
Gg, Gg, Gg, Gg, Gg, Gg, Gg, Gg, Gg, Gg, Gg, Gg, Gg, Gg, Gg, Gg, Gg, Gg, Gg, Gg, Gg, Gd^Fmf, Gd^Fmf, Re^Gvs, Re^Gvs, Re^Gvs, Gg, Gg, Gg, Gg^Fet, Gg^Fet, Gg, Gg, Rp, Gg, Gg, Gg, Gg, Gg, Gg, Gg, Gg^Fet, Gg^Fet, Gg^Fet, Gg, Gg, Gg, Gg, Gg, Gg, Gg, Gg, Gg, Ww, Gg, Gg, Gg, Gg, Gg, Gg, Gg, Gs^Fp
Gg, Gg, Gg, Gg, Gg, Gg, Gg, Re^Gvs, Re^Gvs, Re^Gvs, Re^Gvs, Gg, Gg, Gg, Gg^Ve, Gg, Gg, Gg, Gg, Gg, Gg, Gg, Gg, Gg, Gg, Gg, Gg, Gg, Gg, Gg, Gg, Gg, Gg, Rp, Gg, Gg, Gg, Gg, Gg, Gg, Gg, Gg^Fet, Gg^Fet, Gg^Fet, Gg, Gg, Gg, Gg, Gg, Gg, Gg, Gg, Gg, Ww, Gg, Gg, Gg, Gg, Gg, Gg, Ds, Ds
Gg, Gg, Gd^Fdf, Gg, Gg, Gg, Re^Gvs, Re^Gvs, Re^Gvs, Re^Gvs, Re^Gvs, Re^Gvs, Re^Gvs, Gg, Gg, Gg, Gg, Gg^Efm, Gg, Gg, Gg, Gg, Gg, Gg, Gg, Gg, Kh, Gg, Kh, Khr, Khr, Ch, Ch, Rp, Khr, Gg, Gg, Gg, Gg, Gg, Gg, Gg^Fet, Gg, Gg^Vh, Gg, Gg, Gg, Gg, Gg, Gg, Gg, Gg, Gg, Ww, Gg, Gg, Ss, Gg, Gg, Ds, Ww, Ww
Gg, Gd^Fdf, Gd^Fdf, Gs^Fp, Gs^Fp, Gg, Gg, Re^Gvs, Re^Gvs, Re^Gvs, Re^Gvs, Re^Gvs, Re^Gvs, Re^Gvs, Gg, Gg, Gg, Gg, Gg, Gg, Gg, Gg, Gg, Gg, Gg, Gg, Khr, Khr, Gg, Gg, Gg, Gg, Gg, Khr, Gg, Khr, Gg, Gg, Gg, Gg, Gg, Gg, Gg, Gg, Gg, Gg, Gg, Gg, Gg, Gg, Gg, Gg, Wwf, Wwf, Chs, Chs, Chs, Ss, Ss, Ds, Ww, Wo
Ww, Gd^Fdf, Gd^Fdf, Gd^Fdf, Gd^Fdf, Gg, Gg, Gg, Gg, Re^Gvs, Re^Gvs, Re^Gvs, Re^Gvs, Re^Gvs, Re^Gvs, Gg, Gg^Efm, Gg, Gg^Efm, Gg, Gg, Gg, Gg, Gg, Gg, Gg, Khr, Gg, Gg, Gg, Gg, Gg, Gg, Rr, Gg, Khr, Khr, Gg, Gg, Gg, Gg, Gg, Gg, Gg, Gg, Gg, Gg, Gg, Gg, Gg, Gg, Gg, Wwf, Chs, Ss, Ss, Chs, Ss, Ss, Ss, Ww, Wo
Wo, Ww, Ww, Gd^Fdf, Ds, Gg, Gg, Gg, Gg, Gg, Gg, Re^Gvs, Gg, Re^Gvs, Gg, Gg, Gg, Gg, Gg, Gg, Gg, Gg, Gg, Gg, Gg, Gg, Khr, Gg, Gg, Gg^Ve, Gg, Gg, Rr, Rr, Gg, Gg, Khr, Gg, Gg, Gg, Gg, Gg, Gg, Gg, Gg, Gg, Gg, Gg, Gg, Gg, Gg, Gg, Ww, Chs, Ss, Ss, 3 Kud, Ss, Ss, Ss, Ww, Wo
Wo, Wo, Wo, Ww, Ww, Ds, Ds, Gg, Gg, Gg, Gg, Gg, Gg, Gg, Gg, Gg, Gg, Gg, Gg, Gg, Gg, Gg^Ve, Gg, Gg, Gg, Gg, Khr, Gg, Gg, Gg, Gg, Rr, Rr, Rr, Gg^Ve, Gg, Khr, Gg, Gg, Gg, Gg, Gg, Gg, Gg, Gg, Gg, Gg, Gg, Gg, Gg, Gg, Ss, Ww, Chs, Chs, Chs, Ss, Ss, Ss, Ss, Ww, Wo
Wo, Wo, Wo, Wo, Wo, Ww, Ww, Ds, Ds, Gg, Gg, Gg, Gd^Fmf, Gg, Gg^Vh, Gg, Gg, Gg, Gg, Gg, Gg, Gg, Gg, Gg, Gg, Gg, Khr, Gg, Gg, Gg^Ve, Gg, Rr, Rr, Rr, Gg, Gg, Khr, Gg, Gg, Gg, Gg, Gg, Gg, Gg, Gg, Gg, Gg, Gg, Gg, Gg, Gg, Ss, Ww, Ss, Ss, Ss, Ss, Ss, Ww, Ww, Ww, Wo
Wo, Wo, Wo, Wo, Wo, Wo, Wo, Ww, Ww, Gd^Fdf, Gd^Fdf, Gd^Fdf, Gd^Fdf, Gd^Fmf, Gg, Gg, Gg, Gg, Gg, Gg, Gg, Gg, Gg, Gg, Gg, Gg, Khr, Gg, Gg, Gg, Gg, Rr, Rr, Rr, Gg, Gg, Khr, Gg, Gg, Gg, Gg, Gg, Gd^Fmf, Gg, Gg, Gg, Gg, Gg, Gg, Gg, Gg, Ss, Ww, Ss, Ss, Ss, Ww, Ww, Wo, Ww, Wo, Wo
Wo, Wo, Wo, Wo, Wo, Wo, Wo, Wo, Wo, Ww, Ww, Gd^Fdf, Gd^Fdf, Gg, Gg, Gg, Gg, Gg, Ds, Ds, Ds, Gg, Ds, Gg, Ds, Gg, Khr, Gg, Gg, Gg, Gg, Gg, Rr, Gg, Gg, Gg, Khr, Gg, Gd^Fmf, Gd^Fmf, Gd^Fmf, Gd^Fmf, Gd^Fmf, Gd^Fmf, Gg^Ve, Ds, Ds, Gg, Ds, Gg, Ds, Ds, Ww, Ww, Wo, Ww, Ww, Wo, Wo, Wo, Wo, Wo
Wo, Wo, Wo, Wo, Wo, Wo, Wo, Wo, Wo, Wo, Wo, Ww, Ww, Ds, Ds, Gg, Ds, Ds, Wo, Wo, Wo, Ds, Ww, Ds, Ww, Ds, Ww, Gg, Ww, Ww, Ww, Wwf, Wwf, Ww, Ww, Ww, Ww, Ww, Ww, Gd^Fmf, Ww, Ww, Ww, Gd^Fmf, Ww, Ww, Ww, Ds, Ww, Ds, Ww, Ww, Wo, Wo, Wo, Wo, Wo, Wo, Wo, Wo, Wo, Wo
Wo, Wo, Wo, Wo, Wo, Wo, Wo, Wo, Wo, Wo, Wo, Wo, Wo, Ww, Wo, Ds, Ww, Wo, Wo, Wo, Wo, Wo, Wo, Ww, Ww, Ww, Ww, Ww, Ww, Ww, Wwf, Wwf, Wwf, Ww, Ww, Ww, Wo, Wo, Wo, Ww, Wo, Ww, Wo, Ww, Wo, Ww, Wo, Ww, Wo, Wo, Wo, Wo, Wo, Wo, Wo, Wo, Wo, Wo, Wo, Wo, Wo, Wo
Wo, Wo, Wo, Wo, Wo, Wo, Wo, Wo, Wo, Wo, Wo, Wo, Wo, Wo, Wo, Wo, Wo, Wo, Wo, Wo, Wo, Wo, Wo, Ww, Ww, Ww, Wo, Wo, Wo, Ww, Wwf, Wwf, Wwf, Wwf, Ww, Ww, Wo, Wo, Wo, Wo, Wo, Wo, Wo, Wo, Wo, Wo, Wo, Wo, Wo, Wo, Wo, Wo, Wo, Wo, Wo, Wo, Wo, Wo, Wo, Wo, Wo, Wo
Wo, Wo, Wo, Wo, Wo, Wo, Wo, Wo, Wo, Wo, Wo, Wo, Wo, Wo, Wo, Wo, Wo, Wo, Wo, Wo, Wo, Wo, Wo, Ww, Ds, Ww, Ww, Wo, Ww, Ww, Ww, Wwf, Wwf, Wwf, Ww, Ww, Ww, Wo, Wo, Wo, Wo, Wo, Wo, Wo, Wo, Wo, Wo, Wo, Wo, Wo, Wo, Wo, Wo, Wo, Wo, Wo, Wo, Wo, Wo, Wo, Wo, Wo
Wo, Wo, Wo, Wo, Wo, Wo, Wo, Wo, Wo, Wo, Wo, Wo, Wo, Wo, Wo, Wo, Wo, Wo, Wo, Wo, Wo, Wo, Wo, Ww, Ww, Ds, Ww, Wo, Wo, Ww, Ww, Wwf, Wwf, Wwf, Ww, Ww, Ww, Wo, Wo, Wo, Wo, Wo, Wo, Wo, Wo, Wo, Wo, Wo, Wo, Wo, Wo, Wo, Wo, Wo, Wo, Wo, Wo, Wo, Wo, Wo, Wo, Wo
Wo, Wo, Wo, Wo, Wo, Wo, Wo, Wo, Wo, Wo, Wo, Wo, Wo, Wo, Wo, Wo, Wo, Wo, Wo, Wo, Wo, Wo, Wo, Wo, Wo, Ww, Wo, Wo, Wo, Ww, Ww, Ww, Kh, Ww, Kh, Ww, Ww, Wo, Wo, Wo, Wo, Wo, Wo, Wo, Wo, Wo, Wo, Wo, Wo, Wo, Wo, Wo, Wo, Wo, Wo, Wo, Wo, Wo, Wo, Wo, Wo, Wo
Wo, Wo, Wo, Wo, Wo, Wo, Wo, Wo, Wo, Wo, Wo, Wo, Wo, Wo, Wo, Wo, Wo, Wo, Wo, Wo, Wo, Wo, Wo, Wo, Wo, Wo, Wo, Wo, Wo, Ww, Ww, Kh, Rr, Kh, Rr, Kh, Kh, Wo, Wo, Wo, Wo, Wo, Wo, Wo, Wo, Wo, Wo, Wo, Wo, Wo, Wo, Wo, Wo, Wo, Wo, Wo, Wo, Wo, Wo, Wo, Ww, Ww
Ww, Wo, Wo, Wo, Wo, Wo, Wo, Wo, Wo, Wo, Wo, Wo, Wo, Wo, Wo, Wo, Wo, Wo, Wo, Wo, Wo, Wo, Wo, Wo, Wo, Wo, Wo, Wo, Wo, Wo, Ww, Kh, Rr, Rr, Rr, Rr, Kh, Ww, Ds, Wo, Wo, Wo, Wo, Wo, Wo, Wo, Wo, Wo, Wo, Wo, Wo, Wo, Wo, Wo, Wo, Wo, Wo, Wo, Ww, Ww, Ds, Ww
Gg, Ww, Ww, Wo, Wo, Wo, Wo, Wo, Wo, Wo, Wo, Wo, Wo, Wo, Wo, Wo, Wo, Wo, Wo, Wo, Wo, Wo, Wo, Wo, Wo, Wo, Wo, Wo, Wo, Wo, Ww, Kh, Kh, Rr, Kh, Kh, Ww, Ww, Gg, Ds, Ds, Wo, Wo, Wo, Wo, Wo, Wo, Wo, Wo, Wo, Wo, Wo, Wo, Wo, Wo, Wo, Ww, Ww, Ds, Ds, Ds, Ds
Gg, Ds, Ds, Ww, Ww, Ww, Ww, Wo, Wo, Wo, Wo, Wo, Wo, Wo, Wo, Wo, Wo, Wo, Wo, Wo, Wo, Wo, Wo, Wo, Wo, Wo, Wo, Wo, Wo, Wo, Ww, Ww, Ww, 4 Kh, Ww, Rr^Bw|, Gg, Gg, Gg^Vh, Gg^Efm, Gg^Ve, Ds, Ds, Ww, Ww, Wo, Ww, Ww, Ww, Wo, Ds, Ww, Ww, Ww, Ww, Ww, Ds, Ds, Gg, Gg, Gg, Gg
Gg, Gg, Gg, Ds, Ds, Ww, Ds, Ww, Ww, Wo, Wo, Wo, Wo, Wo, Wo, Wo, Wo, Wo, Wo, Wo, Wo, Wo, Wo, Wo, Wo, Wo, Wo, Wo, Wo, Wo, Ww, Gg, Gg, Ww, Gg, Rr, Gg, Gg, Rr^Cov, Rr^Cov, Rr^Cov, Gg, Gg, Ds, Ds, Ww, Ds, Ds, Ds, Ds, Ds, Ds, Ds, Ds, Ds, Ds, Gg, Gg, Gg, Gg, Gg, Gg
Rr, Gg, Gg, Gg, Gg, Ds, Gg, Ds, Ds, Ww, Ww, Wo, Wo, Wo, Wo, Wo, Wo, Wo, Wo, Wo, Wo, Wo, Wo, Wo, Wo, Wo, Wo, Wo, Wo, Ww, Ds, Gg, Gg, Gg, Rr, Rr, Rr, Rp^Vhc, Rr^Cov, 5 Kv, Rr^Cov, Rp^Vhc, Gg, Gg, Gg, Ds, Gg, Gg, Gg^Efm, Gg, Gg, Gg, Gg, Gg, Gg, Gg, Gg, Gg, Gg, Gg, Gg, Gg
Gg, Rr, Rr, Gg, Gg, Gg, Gg, Gg, Gg, Ds, Ds, Ww, Ww, Wo, Wo, Wo, Wo, Wo, Wo, Wo, Wo, Wo, Wo, Wo, Wo, Wo, Wo, Wo, Ww, Ww, Ds, Gg^Vh, Gg, Gg, Rr, Gg, Gg, Rr, Rp^Vhc, Rr^Cov, Rp^Vhc, Gg, Gg, Gg^Efm, Gg, Gg, Gg, Gg, Gg, Gg, Gg, Gg, Gg, Gg, Gg, Gg, Gg, Gg, Gg, Gg, Gg, Gg
Gg, Gg, Gg, Rr, Rr, Gg, Gg, Gg, Gg, Gg, Ds, Ds, Ds, Ww, Ww, Wo, Ww, Wo, Ww, Ww, Ww, Ww, Ww, Ww, Ww, Ww, Ww, Ww, Ds, Ds, Gg, Gg, Gg, Gg, Rr, Gg, Gg, Re^Gvs, Re^Gvs, Rr, Rr, Gg, Rr, Gg, Gg, Gg, Gg, Gg, Gg, Gg, Gg^Efm, Gg, Gg, Gg, Rr, Gg, Gg, Gg, Gg, Gg, Rr, Rr
Gg, Gg, Gg, Gg, Gg, Rr, Rr, Gg, Gg, Gg, Gg, Gg, Gg, Ds, Ds, Ww, Ds, Ww, Ds, Ds, Ds, Ds, Ds, Ds, Ds, Ds, Ds, Ds, Gg, Gg, Gg, Gg, Rr, Rr, Gg, Gg, Gg, Re^Gvs, Re^Gvs, Re^Gvs, Rr, Rr, Gg^Efm, Rr, Rr, Gg, Rr, Rr, Rr, Gg^Efm, Gg, Gg, Rr, Rr, Gd^Fmf, Rr, Rr, Gg, Rr, Rr, Gg, Gg
Re^Gvs, Gg, Gg, Gg, Gg, Gg, Gg, Rr, Rr, Gg, Gg, Gg, Gg, Gg, Gg, Ww, Gg, Ds, Gg, Gg, Gg, Gg, Gg, Ds, Gg, Gg, Gg, Gg, Gg^Vh, Gg, Rr, Rr, Gg, Gg, Gg, Gg^Vl, Gg, Re^Gvs, Re^Gvs, Re^Gvs, Rr, Gg, Gg, Gg, Gg, Rr, Gg, Gg, Gg^Efm, Rr, Rr, Rr, Gs^Fms, Gd^Fmf, Gg, Gg, Re^Gvs, Rr, Gg, Gg, Gg, Gg
Re^Gvs, Re^Gvs, Re^Gvs, Gg, Gg, Gg, Gg, Gg^Efm, Gg^Efm, Rr, Rr, Gg, Gg, Gg, Gg, Ww, Gg, Gg, Re^Gvs, Re^Gvs, Re^Gvs, Re^Gvs, Re^Gvs, Gg, Gg^Vh, Gg, Gg, Gg, Rr, Rr, Gg, Gg, Gg, Gg, Gg, Gg, Gg, Re^Gvs, Re^Gvs, Re^Gvs, Rr, Gg, Gg, Gg, Gg^Efm, Gg, Gg, Gg, Gg, Gg, Gg, Gd^Fmf, Gg, Gg, Re^Gvs, Re^Gvs, Re^Gvs, Gg^Efm, Gg, Gg, Gg, Gg
Re^Gvs, Re^Gvs, Re^Gvs, Gg, Gg^Efm, Gg, Gg, Gg, Gg, Gg, Gg, Rr, Rr, Gg, Gg, Ww, Gg^Efm, Gg, Re^Gvs, Re^Gvs, Re^Gvs, Re^Gvs, Re^Gvs, Gg, Gg, Gg, Rr, Rr, Gg, Gg, Gg, Gg^Vh, Gg, Gg, Gg^Efm, Gg, Gg, Gg, Gg, Re^Gvs, Rr, Gg, Gg, Gg^Efm, Gg, Gg, Gg, Gg, Gg, Gg, Gg, Gg, Re^Gvs, Re^Gvs, Re^Gvs, Re^Gvs, Re^Gvs, Re^Gvs, Re^Gvs, Gg, Gg, Gg
Re^Gvs, Re^Gvs, Re^Gvs, Gg, Gg, Gg, Gg, Gg, Gd^Fmf, Gg, Gg, Gg, Gg, Rr, Rr, Ww, Gg, Gg, Re^Gvs, Re^Gvs, Re^Gvs, Re^Gvs, Gg^Vh, Gg, Rr, Rr, Gg, Gg, Gg, Gg, Gg^Efm, Gg^Efm, Gg, Gg, Gg, Gg, Gg, Gg, Gg, Gg, Rr, Gg, Gg, Gg, Gg, Gg, Gg, Gg, Gg, Gg, Re^Gvs, Re^Gvs, Re^Gvs, Re^Gvs, Re^Gvs, Re^Gvs, Re^Gvs, Re^Gvs, Re^Gvs, Re^Gvs, Re^Gvs, Gg
Re^Gvs, Re^Gvs, Gg, Gg, Gg, Gg, Gd^Fmf, Gd^Fmf, Gd^Fmf, Gg, Gg, Gg, Gg, Gg, Gg, Ww^Bw\, Rr, Gg^Vh, Gg, Re^Gvs, Gg, Gg, Rr, Rr, Gg, Gg, Gg, Gg^Vh, Gg, Gg^Efm, Gg, Gg, Gg, Gg, Re^Gvs, Re^Gvs, Re^Gvs, Gg, Gg, Gg, Gg, Rr, Gg, Gg, Gg, Gg, Gg^Efm, Gg, Gg, Re^Gvs, Re^Gvs, Re^Gvs, Re^Gvs, Re^Gvs, Re^Gvs, Re^Gvs, Re^Gvs, Re^Gvs, Re^Gvs, Re^Gvs, Re^Gvs, Re^Gvs
Gg, Gg, Gg, Gg, Gg, Gd^Fmf, Gd^Fmf, Gd^Fmf, Gd^Fmf, Gd^Fmf, Gg, Gg, Gg, Gg, Gg, Ww, Gg^Efm, Rr, Rp, Rp, Rp, Rp, Gg^Ve, Gg^Efm, Gg, Gg, Gg, Gg, Gg^Efm, Gg, Gg, Gg, Re^Gvs, Re^Gvs, Re^Gvs, Re^Gvs, Re^Gvs, Re^Gvs, Gg, Gg, Gg, Rr, Gg, Gg, Gg, Gg, Gg, Gg, Gg, Re^Gvs, Re^Gvs, Re^Gvs, Re^Gvs, Re^Gvs, Re^Gvs, Re^Gvs, Re^Gvs, Re^Gvs, Re^Gvs, Re^Gvs, Re^Gvs, Re^Gvs
Gg, Gg, Gd^Fmf, Gg, Gg, Gd^Fmf, Gd^Fmf, Gd^Fmf, Gd^Fmf, Gg, Gg, Gg, Gg, Gg, Ww, Ww, Gg, Gg^Efm, Rr, Gg^Fet, Gg^Fet, Gg^Fet, Gg^Efm, Gg^Efm, Gg, Gg, Gg, Gg, Gg, Gg^Efm, Re^Gvs, Re^Gvs, Re^Gvs, Re^Gvs, Re^Gvs, Re^Gvs, Re^Gvs, Re^Gvs, Re^Gvs, Gg, Gg, Rr, Gg, Gg, Gg, Gg, Gg, Gg, Gg, Gg, Re^Gvs, Re^Gvs, Re^Gvs, Re^Gvs, Re^Gvs, Re^Gvs, Re^Gvs, Re^Gvs, Re^Gvs, Re^Gvs, Re^Gvs, Re^Gvs
Gd^Fmf, Gd^Fmf, Gd^Fmf, Gd^Fmf, Gg, Gd^Fmf, Gd^Fmf, Gd^Fmf, Gg, Gg, Gg, Gg, Gg, Gg, Ww, Gg, Gg, Gg, Rr, Gg, Gg, Gg, Gg, Gg, Gg, Gg, Gg, Gg, Re^Gvs, Re^Gvs, Re^Gvs, Re^Gvs, Re^Gvs, Re^Gvs, Re^Gvs, Re^Gvs, Re^Gvs, Re^Gvs, Gg, Gg, Gg, Rr, Gg, Gg, Gg, Gg, Gg, Gg, Gg, Gg, Gg, Re^Gvs, Re^Gvs, Re^Gvs, Re^Gvs, Re^Gvs, Re^Gvs, Re^Gvs, Re^Gvs, Re^Gvs, Gg, Gg
