Wo, Wo, Wo, Wo, Wo, Wo, Wo, Wo, Wo, Wo, Wo, Wo, Wo, Wo, Wo, Wo, Wo, Wo, Wo, Wo, Wo, Wo, Wo, Wo, Wo, Wo, Wo, Wo, Wo, Wo, Wo, Wo, Wo, Wo, Wo, Wo, Wo, Wo, Wo, Ww, Wo, Wo, Wo, Wo, Wo, Gg
Wo, Wo, Wo, Wo, Wo, Wo, Wo, Wo, Wo, Wo, Wo, Wo, Wo, Wo, Wo, Wo, Wo, Wo, Wo, Wo, Wo, Wo, Wo, Wo, Wo, Wo, Wo, Wo, Wo, Wo, Wo, Wo, Ww, Ww, Gs^Fds, Ww, Gs^Fds, Ww, Ww, Wo, Wo, Wo, Wo, Wo, Wo, Wo
Wo, Wo, Wo, Wo, Wo, Wo, Wo, Wo, Wo, Wo, Wo, Wo, Wo, Wo, Wo, Wo, Wo, Wo, Wo, Wo, Wo, Wo, Wo, Wo, Wo, Wo, Wo, Wo, Wo, Wo, Wo, Wo, Ww, Gg, Gg, Gg, Gg, Gs^Fds, Gs^Fds, Ww, Wo, Wo, Wo, Wo, Wo, Wo
Wo, Wo, Wo, Wo, Wo, Wo, Wo, Wo, Wo, Wo, Wo, Wo, Wo, Wo, Wo, Wo, Wo, Wo, Wo, Wo, Wo, Wo, Wo, Wo, Wo, Wo, Wo, Wo, Wo, Wo, Wo, Wo, Wo, Ww, Ww, Gg, Ww, Gg, Ww, Ww, Wo, Wo, Wo, Wo, Wo, Wo
Wo, Wo, Ww, Ww, Ww, Ww, Ww, Wo, Ww, Wo, Wo, Wo, Wo, Wo, Wo, Wo, Wo, Wo, Wo, Wo, Wo, Wo, Wo, Wo, Wo, Wo, Wo, Wo, Wo, Wo, Wo, Wo, Wo, Wo, Wo, Wo, Wo, Wo, Wo, Wo, Wo, Wo, Wo, Wo, Wo, Wo
Wo, Wo, Gs^Fds, Gs^Fds, Gs^Fds, Gs^Fds, Gs^Fds, Ww, Gs^Fds, Ww, Ww, Wo, Ww, Ww, Ww, Wo, Wo, Wo, Wo, Wo, Wo, Wo, Wo, Wo, Wo, Wo, Wo, Wo, Wo, Wo, Wo, Wo, Wo, Wo, Wo, Wo, Wo, Wo, Wo, Wo, Wo, Wo, Wo, Wo, Ww, Wo
Wo, Wo, Gs^Fds, Gs^Fds, Gg, Gg, Gg, Gs^Fds, Gs^Fds, Gs^Fds, Gs^Fds, Ww, Gg, Gg, Gg, Ww, Ww, Ww, Ww, Ww, Ww, Ww, Ww, Wo, Ww, Ww, Ww, Ww, Ww, Wo, Ww, Ww, Ww, Wo, Wo, Wo, Wo, Wo, Wo, Wo, Ww, Wo, Ww, Ww, Ww, Ww
Mm^Xm, Hh, Gg, Gg, Gg, Gg, Gg, Gg, Gg, Gs^Fds, Gg, Gg, Gg, Gg, Gg, Gg, Gg, Gg, Gg, Gs^Fds, Gs^Fds, Gs^Fds, Ww, Ww, Gg, Gg, Gg, Gg, Gg, Ww, Gg, Gg, Ce, Ww, Ww, Wo, Ww, Ww, Ww, Ww, Ww, Ww, Ww, Ww, Ww, Ww
Gg, Hh, Gg, Gg, Gg, Gg, Gs^Fds, Gs^Fds, Gs^Fds, Gs^Fds, Gs^Fds, Gg, Gg, Gg, Gg, Gg, Gg, Gg, Gg, Gs^Fds, Ww, Ww, Ww, Gg, Gg, Gg, Gg, Gg, Gg, Gg, Xu, Gg, Gg, Gg, Gg, Ww, Gs^Fds, Gs^Fds, Gs^Fds, Gs^Fds, Gs^Fds, Ww, Ww, Gs^Fds, Gs^Fds, Gs^Fds
Mm^Xm, Hh, Gs^Fds, Gg, Gs^Fds, Gs^Fds, Gs^Fp, Gs^Fds, Gs^Fds, Gs^Fds, Gs^Fds, Gs^Fds, Gs^Fds, Gg, Gg, Gg, Gg, Gg, Gg, Hh^Fp, Ww, Ww, Ww, Ww, Gg, Gg, Xu, Xu, Xu, Xu, Xos, Xu, Xu, Xu, Xu, Gg, Gg, Gg, Gg, Ww, Wo, Wo, Ww, Gg, Gg, Gg
Mm^Xm, Hh, Gs^Fds, Gs^Fp, Hh^Fp, Gs^Fds, Hh^Fp, Gs^Fds, Gs^Fms, Gs^Fp, Gs^Fds, Gs^Fds, Gs^Fds, Gs^Fds, Gg, Gg, Gs^Fds, Gg, Gs^Fds, Gs^Fds, Ww, Wo, Ww, Gg, Xu, Xu, Xos, Xos, Xos, Xos, Xu, Xos, Xos, Xos, Xos, Xu, Gg, Gg, Gg, Ww, Wo, Wo, Ww, Gg, Gg, Gg
Mm^Xm, Hh, Gs^Fds, Gs^Fds, Gs^Fds, Hh^Fp, Hh^Fp, Gs^Fds, Gs^Fds, Gs^Fds, Hh^Fp, Gs^Fds, Gs^Fds, Gs^Fp, Gs^Fds, Gg, Gs^Fds, Gs^Fds, Gg, Hh^Fp, Ww, Wo, Ww, Gg, Gg, Xu, Xos, Xu, Xu, Xu, Xu, Xu, Xu, Xu, Xos, Xu, Gg, Gg, Gg, Ww, Wo, Wo, Ww, Gg, Gg, Gg
Mm^Xm, Hh, Gg, Gs^Fds, Gs^Fds, Gs^Fds, Gs^Fds, Gs^Fms, Hh^Fp, Gs^Fms, Hh^Fp, Hh^Fp, Gs^Fds, Gs^Fds, Gg, Gs^Fds, Gs^Fds, Gg, Gs^Fds, Hh^Fp, Ww, Wo, Ce, Gg, Gg, Xu, Xos, Xu, Xu, Xu, Xu, Xu, Xu, Xu, Xos, Xu, Gg, Gg, Gg, Ww, Wo, Wo, Ww, Gg, Gg, Gg
Mm^Xm, Hh, Gg, Gg, Gs^Fds, Gs^Fds, Gs^Fds, Gs^Fds, Gs^Fms, Hh^Fp, Gs^Fds, Hh^Fp, Gs^Fds, Gs^Fds, Gs^Fds, Gg, Gs^Fds, Gs^Fds, Gs^Fds, Gs^Fds, Ww, Wo, Ww, Gg, Gg, Xu, Xos, Xu, Xu, Xu, Xu, Xu, Xu, Xu, Xos, Xu, Gg, Gg, Gg, Ww, Wo, Wo, Ww, Gg, Gg, Gg
Mm^Xm, Hh, Gg, Gg, Gg, Gs^Fds, Gs^Fds, Gs^Fds, Gs^Fds, Gs^Fds, Gg, Gs^Fp, Gs^Fds, Gs^Fds, Gg, Gs^Fds, Gs^Fds, Gs^Fds, Gs^Fds, Hh^Fp, Ww, Wo, Ww, Gg, Gg, Xu, Xu, Xos, Xu, Xu, Xu, Xu, Xu, Xu, Xos, Xu, Gg, Gg, Gs^Fds, Ww, Wo, Wo, Ww, Gg, Gg, Gg
Hh, Hh, Gs^Fds, Gg, Gg, Gg, Gs^Fds, Gs^Fp, Gs^Fds, Gg, Gs^Fds, Gs^Fds, Gg, Gg, Gg, Gg, Gg, Gg, Gg, Hh^Fp, Ww, Wo, Ww, Gg, Gg, Gg, Xu, Xos, Xos, Xu, Xos, Xos, Xos, Xu, Xos, Xu, Gg, Gg, Gs^Fds, Ww, Wo, Wo, Ww, Gs^Fds, Gg, Gg
Gg, Gg, Gg, Gs^Fds, Gs^Fds, Gs^Fds, Gs^Fds, Gs^Fds, Gs^Fds, Gs^Fds, Gs^Fds, Gg, Gs^Fp, Gg, Gg, Gg, Gg, Gg, Gg, Gs^Fds, Ww, Wo, Ww, Gg, Gg, Gg, Gg, Xu, Gg, Xu, Gg, Xu, Xu, Xos, Xu, Xu, Gg, Gg, Gg, Ww, Ww, Wo, Ww, Gs^Fds, Gg, Gg
Gg, Gg, Gg, Gg, Gg, Gg, Gg, Gg, Gs^Fds, Gs^Fds, Gs^Fds, Gg, Gg, Gg, Gg, Gg, Gg, Gg, Gg, Gg, Ww, Wo, Ww, Gg, Gg, Gg, Gg, Gg, Gg, Gg, Gg, Gg, Gg, Xu, Gg, Gg, Gg, Gg, Gg, Gs^Fds, Ww, Wo, Ww, Gs^Fds, Gg, Gg
Rr, Gg, Gg, Gg, Gg, Gg, Gg, Gg, Gg, Gs^Fds, Gs^Fds, Gs^Fds, Gs^Fds, Gg, Gg, Gg, Gg, Gg, Ww, Ww, Ww, Ww, Gg, Gg, Gg, Gg, Gg, Gg, Ch, Gg, Gg, Gg, Gg, Gg, Gg, Gg, Gg, Gg, Gg, Gg, Ww, Wo, Ww, Gs^Fds, Gg, Gg
Gg, Rr, Rr, Gg, Gg, Gg, Gg, Gg, Gg, Gs^Fds, Gs^Fds, Gs^Fds, Gg, Gg, Gg, Gg, Rr, Rr, Ww^Bw\, Ww, Gg, Gg, Gg, Gg, Gg, Gg, Ch, Ch, Gg, Ch, Ch, Gg, Gg, Gg, Gg, Gg, Gg, Ce, Gg, Gg, Ww, Wo, Wo, Ww, Gg, Gg
Gg, Gg, Gg, Rr, Rr, Gg, Gg, Gg, Gg, Gs^Fds, Gg, Gs^Fds, Gg, Gg, Rr, Rr, Gg, Ww, Ce, Gg, Gg, Gg, Gg, Gg, Gg, Gg, Ch, 2 Kh, Gg, Gg, Ch, Gg, Gg, Gg, Gg, Gg, Gg, Gg, Gg, Gg, Ww, Ww, Wo, Ww, Gg, Gg
Gg, Gg, Gg, Gg, Gg, Rr, Rr, Gg, Gs^Fds, Gs^Fds, Rr, Gg, Rr, Rr, Gg, Gg, Gg, Ww, Gg, Gg, Gg, Gg, Gg, Gg, Gg, Gg, Ch, Gg, Ch, Ch, Gg, Gg, Gg, Gg, Gg, Gg, Gg, Gg, Gg, Gg, Ww, Ww, Wo, Ww, Gg, Gg
Gg, Gg, Gg, Gg, Gg, Gg, Gg, Rr, Rr, Rr, Rr, Rr, Gg, Gg, Gg, Gg, Gg, Ww, Ww, Gg, Gg, Gg, Gg, Gg, Gg, Gg, Gg, Ch, Ch, Ch, Gg, Gg, Gg, Gg, Gg, Gg, Gg, Gg, Gg, Gg, Gg, Ww, Wo, Ww, Gg, Gg
Gg, Gg, Gg, Gg, Gg, Gg, Gg, Gg, Gg, Gg, Gg, Gg, Gg, Gg, Gg, Gg, Gg, Ww, Ww, Gg, Gg, Gg, Gg, Gg, Ce, Gg, Gg, Gg, Gg, Gg, Gg, Gg, Gg, Gg, Gg, Gg, Gg, Gg, Gg, Gg, Gg, Ww, Wo, Ww, Gg, Gg
Gg, Gg, Gg, Gg, Gs^Fds, Gg, Gs^Fp, Gg, Gg, Gg, Gg, Gg, Gg, Gg, Gg, Gg, Gg, Gg, Gg, Ww, Ww, Ww, Ww, Gg, Gg, Gg, Gg, Gg, Gg, Gg, Gg, Gg, Gg, Gg, Gg, Gg, Gg, Gg, Gg, Gg, Ww, Ww, Wo, Ww, Gg, Gg
Gg, Gg, Gg, Gg, Gs^Fds, Gs^Fds, Gs^Fds, Gs^Fds, Gs^Fds, Gg, Gg, Gg, Gg, Gg, Gg, Gg, Gg, Gg, Gg, Gg, Gg, Ww, Ww, Ww, Ww, Gg, Gg, Gg, Gg, Gg, Ww, Gg, Ww, Gg, Ww, Gg, Ww, Gg, Ww, Ww, Wo, Wo, Ww, Ww, Gg, Gg
Gg, Gg, Gg, Gs^Fds, Gs^Fds, Hh^Fp, Hh^Fp, Gs^Fds, Gs^Fds, Gs^Fds, Gs^Fds, Gg, Gs^Fds, Gg, Gg, Gg, Gg, Gg, Gg, Gg, Gg, Gg, Ww, Ww, Ww, Ww^Bw|, Ww, Ww, Ww, Ww, Wo, Wo, Wo, Ww, Wo, Wo, Wo, Wo, Wo, Wo, Ww, Ww, Gs^Fds, Gs^Fds, Gg, Gg
Gg, Gs^Fds, Gs^Fp, Hh^Fp, Gs^Fds, Gs^Fp, Gs^Fds, Gs^Fds, Gs^Fds, Gs^Fds, Gs^Fds, Gs^Fds, Gs^Fds, Gs^Fds, Gs^Fds, Gg, Gg, Gg, Gg, Gg, Gg, Gg, Gg, Ww, Gg, Ww^Bw|, Ww, Wo, Wo, Wo, Ww, Wo, Wo, Wo, Wo, Wo, Wo, Wo, Wo, Ww, Gs^Fds, Gs^Fds, Gs^Fds, Gs^Fds, Gg, Gg
Gg, Gs^Fds, Gs^Fds, Gs^Fds, Gg, Gg, Gg, Gs^Fds, Gs^Fds, Ce, Ce, Ce, Ce, Gs^Fds, Gs^Fp, Gs^Fds, Gs^Fp, Gs^Fds, Gs^Fds, Gs^Fds, Gs^Fds, Gg, Gg, Gg, Rr, Rr, Gg, Ww, Ww, Ww, Hh^Fp, Ww, Ww, Wo, Wo, Wo, Wo, Wo, Ww, Ww, Gs^Fds, Gs^Fds, Gg, Gg, Gg, Gg
Gg, Gs^Fds, Gs^Fds, Gg, Gg, Gg, Gs^Fds, Gs^Fds, Gs^Fds, Ce, Gs^Fp, Gg, Ce, Gs^Fds, Gs^Fds, Gs^Fds, Gs^Fds, Gs^Fds, Gs^Fds, Gs^Fds, Gg, Gg, Gg, Gg, Rr, Gg, Gs^Fds, Gs^Fds, Gs^Fds, Hh^Fp, Hh^Fp, Hh^Fp, Gs^Fds, Ww, Ww, Ww, Ww, Ww, Gs^Fds, Gs^Fds, Gs^Fds, Gg, Gg, Gg, Gg, Gg
Gg, Gs^Fds, Gs^Fms, Gs^Fds, Gg, Gg, Gs^Fds, Gs^Fp, Gs^Fds, Ce, 1 Ke, Gg, Ce, Gs^Fds, Gs^Fds, Gs^Fms, Gs^Fds, Gs^Fds, Gs^Fds, Gs^Fds, Gg, Gg, Gg, Rr, Gg, Gg, Gs^Fds, Gs^Fds, Gs^Fp, Hh^Fp, Gs^Fds, Hh^Fp, Hh^Fp, Hh^Fp, Gs^Fp, Gs^Fds, Gs^Fds, Gs^Fds, Gs^Fds, Gs^Fp, Gs^Fds, Gs^Fds, Gg, Gg, Gg, Gg
Gg, Gs^Fp, Gs^Fds, Gs^Fds, Gs^Fds, Hh^Fp, Gs^Fds, Hh^Fp, Gs^Fds, Gs^Fds, Gs^Fds, Ce, Gs^Fds, Gs^Fds, Gs^Fds, Gs^Fds, Gs^Fds, Gs^Fp, Gs^Fds, Gg, Gg, Gg, Rr, Rr, Gg, Gs^Fds, Gs^Fds, Gs^Fds, Hh^Fp, Hh^Fp, Gs^Fds, Hh^Fp, Hh^Fp, Gs^Fds, Gs^Fds, Gs^Fds, Hh^Fp, Gs^Fp, Gs^Fds, Gs^Fds, Gg, Gg, Gg, Gg, Gg, Gg
Gg, Gs^Fds, Gs^Fds, Gs^Fds, Gs^Fds, Gs^Fds, Gs^Fms, Gs^Fp, Gs^Fds, Gs^Fp, Gs^Fds, Gs^Fds, Gs^Fds, Gs^Fms, Gs^Fds, Gs^Fms, Gs^Fds, Gs^Fds, Gg, Gg, Rr, Rr, Gg, Gg^Efm, Gs^Fds, Gs^Fds, Gs^Fds, Gs^Fp, Gs^Fds, Gs^Fds, Gg, Gg, Gg, Gs^Fds, Gg, Gs^Fds, Gg, Gg, Gg, Gg, Gg, Gg, Gg, Gg, Gg, Gg
Gs^Fds, Hh^Fp, Gs^Fds, Gs^Fp, Gs^Fds, Gs^Fds, Gs^Fds, Gs^Fds, Gs^Fds, Gs^Fds, Gs^Fp, Gs^Fds, Gs^Fds, Gs^Fds, Gs^Fds, Gs^Fds, Gg, Gg, Rr, Rr, Gg, Gg, Gs^Fds, Gs^Fds, Gs^Fp, Gs^Fds, Gs^Fds, Gg, Gs^Fds, Gs^Fds, Gg, Gg, Gg, Gg, Gg, Gg, Gg, Gg, Gg, Gg, Gg, Gg, Gg, Gg, Gg, Gg
Gg, Gs^Fds, Gg, Gs^Fds, Gg, Gs^Fds, Gg, Gs^Fds, Gg, Gs^Fds, Gg, Gs^Fds, Gg, Gs^Fds, Gg, Gg, Gg, Rr, Gg, Gg, Gg, Gs^Fds, Gg, Gs^Fds, Gg, Gs^Fds, Gg, Gg, Gg, Gg, Gg, Gg, Gg, Gg, Gg, Gg, Gg, Gg, Gg, Gg, Gg, Gg, Gg, Gg, Gg, Gg
