WWWWWWWWWWWWW   WWWWWWWWWWWWWWWW
WWWWWWWWWWWWW   lWWWWWWWWWW WWWW
WWWWWWW WWWW    lWWll W      WWW
WWW W                        WWW
WW                            WW
WWW      lWWlW   WWWWlW       WW
WWW    lWlW lW  lWWlll WWWlllWWW
WWWl W  lll  ll lWWlWW WWlllWWWW
WWWWWWll lWlWll  lllWl lWWllWWWW
WWWWW Wl lWWWl    WWlW    llWWWW
WWW  WWW ll l  ll WWlWW ll   lWW
WWWW WWl        l   l W  WW  llW
WWWWl W    W     W      WWW   WW
WWWW      WWWW  llWl W   W   WWW
WWW      WWWWl  lllWWW      WWWW
WWW       Wlll  lllWWW      WWWW
Wll      WWllll  lllW       WWWW
  l     lWWllll   l  WWWll    WW
       W  WWlll    lllWlWWl    W
     WWlW Wllll    lllllWWW    W
    WWllW      l    llllWlll    
   WWWlWW lll  ll ll  llWlWWW   
    WWWl Wll  llW Wl  llWllWWW  
    WWllWWl      W    llWlWlWlW 
WW    l WWl     lll   lllWWlllW 
WW        W            llWWWlll 
WWWW         lWW   lll  lWWWWWl 
WWWWWl W   WWlll lllll      WW  
WWW lWlWWWWllllllllWlll     l   
WW    WlWllWlW llWWWWWll W lll  
W      WlWWWW  llWWWWWWWWWWWWWl 
W  WWWWWWWWWW  WWWWWWWWWWWWWWWl 
