border_size=1
usage=map

Xu          , Xu          , Xu          , Xu          , Xu          , Xu          , Xu          , Xu          , Xu          , Xu          , Xu          , Xu          , Xu          , Xu          , Ql          , Ql          , Ql          , Xu          , Xu          , Xu          , Xu          , Xu          , Xu          , Xu          , Xu          , Xu          , Xu          , Xu          , Xu          , Xu          , Xu          
Xu          , Xu          , Xu          , Xu          , Xu          , Xu          , Xu          , Xu          , Xu          , Xu          , Xu          , Xu          , Xu          , Xu          , Ql          , Ql          , Ql          , Xu          , Xu          , Xu          , Xu          , Xu          , Xu          , Xu          , Xu          , Xu          , Xu          , Xu          , Xu          , Xu          , Xu          
Xu          , Xu          , Xu          , Xu          , Xu          , Xu          , Xu          , Xu          , Xu          , Xu          , Xu          , Xu          , Xu          , Xu          , Ur          , Kud         , Uu          , Ql          , Ql          , Xu          , Xu          , Xu          , Xu          , Xu          , Xu          , Xu          , Xu          , Xu          , Xu          , Xu          , Xu          
Xu          , Xu          , Xu          , 2 Kud       , Xu          , Xu          , Xu          , Xu          , Xu          , Xu          , Uh          , Wwf^Uf      , Wwf         , Rd          , Rd          , Cud         , Ur          , Uu^Uf       , Rd          , Xu          , Xu          , Xu          , Xu          , Xu          , Xu          , Xu          , Xu          , Xu          , Xu          , Xu          , Xu          
Xu          , Xu          , Xu          , Xu          , Xu          , Xu          , Xu          , Xu          , Xu          , Xu          , Ur          , Uu^Vu       , Ur          , Wwf         , Rd          , Cud         , Cud         , Ur          , Ur          , Hh          , Ss          , Xu          , Xu          , Xu          , Xu          , Xu          , Xu          , Xu          , Xu          , Xu          , Xu          
Xu          , Xu          , Xu          , Xu          , Xu          , Xu          , Rd          , Xu          , Wwf         , Rd          , Rd          , Ur          , Ur          , Wwf         , Wwf         , Rd          , Rd          , Cud         , Rp          , Gs^Fp       , Ss^Vhs      , Ss          , Rd          , Xu          , Xu          , Xu          , Xu          , Xu          , Xu          , Xu          , Xu          
Xu          , Xu          , Xu          , Xu          , Ur          , Ur          , Ur          , Rd          , Rd          , Wwf         , Rd          , Mm          , Ur          , Ur          , Ur^Fp       , Rd^Fp       , Uh          , Rd          , Rd          , Rp          , Wwf         , Rd          , Hh          , Rd          , Uu^Vu       , Xu          , Xu          , Xu          , Xu          , Xu          , Xu          
Xu          , Xu          , Xu          , Ql          , Uu^Uf       , Xu          , Ur          , Xu          , Xu          , Wwf         , Wwf         , Rd          , Ql          , Ql          , Ur          , Uu^Uf       , Wwf         , Rd          , Rd          , Hh          , Gs^Fp       , Rp          , Xu          , Rd          , Wwf         , Xu          , Xu          , Xu          , Xu          , Xu          , Xu          
Xu          , Xu          , Xu          , Xu          , Rd          , Gs^Fp       , Rd          , Ur          , Xu          , Ww          , Ww          , Xu          , Xu          , Xu          , Uu^Vu       , Wwf         , Rd          , Rd          , Rd          , Rd          , Rd          , Rd          , Xu          , Xu          , Rp          , Xu          , Xu          , Xu          , Xu          , Xu          , Xu          
Xu          , Xu          , Ql          , Xu          , Rd          , Uu^Vu       , Xu          , Rd          , Xu          , Ww          , Wwf         , Uh          , Rd          , Rd          , Rd          , Rd^Fp       , Hh          , Rd          , Rp          , Mm          , Wwf         , Ss^Vhs      , Rd          , Rd          , Gs^Fp       , Xu          , Xu          , Xu          , Xu          , Xu          , Xu          
Xu          , Xu          , Xu          , Rp          , Xu          , Xu          , Uh          , Gs^Fp       , Xu          , Wwf         , Mm          , Wwf         , Gs^Fp       , Mm          , Hh          , Rd          , Rd          , Rd          , Rp          , Hh          , Wwf         , Rd          , Xu          , Xu          , Uh          , Xu          , Xu          , Xu          , Xu          , Xu          , Xu          
Xu          , Xu          , Wwf         , Wwf         , Gs^Fp       , Rd          , Rd          , Uu^Uf       , Xu          , Wwf         , Wwf         , Wwf         , Ww          , Ww          , Hh          , Rp          , Rd          , Rd          , Hh          , Gs^Fp       , Hh          , Wwf         , Xu          , Rp          , Rd          , Uu^Uf       , Xu          , Xu          , Xu          , Xu          , Xu          
Xu          , Rp          , Wwf         , Rp          , Rp          , Rd          , Xu          , Ur          , Xu          , Wwf         , Rp          , Ww          , Rp          , Gs^Fp       , Rp          , Rp          , Rd          , Rd          , Rd          , Gs^Fp       , Rp          , Wwf         , Uh          , Gs^Fp       , Rd          , Rd          , Uh          , Xu          , Wo          , Xu          , Xu          
Xu          , Xu          , Wo          , Ww          , Uh          , Uh          , Rd          , Xu          , Uh          , Wwf         , Rp          , Rd          , Rd          , Rp          , Rd          , Rd          , Rp          , Rp          , Rp          , Rd          , Rp          , Wwf         , Xu          , Xu          , Xu          , Uh          , Rp          , Ww          , Wwf         , Xu          , Xu          
Xu          , Xu          , Xu          , Xu          , Xu          , Rd          , Rd          , Gs^Fp       , Xu          , Wwf         , Hh          , Gs^Fp       , Hh          , Rd          , Rd          , Rp          , Hh          , Gs^Fp       , Ww          , Ww          , Wwf         , Wwf         , Xu          , Rd          , Rd          , Rd          , Gs^Fp       , Rp          , Wwf         , Rp          , Xu          
Xu          , Xu          , Xu          , Xu          , Xu          , Uu^Uf       , Uh          , Rp          , Xu          , Wwf         , Wwf         , Gs^Fp       , Rp          , Rd          , Rd          , Rp          , Hh          , Ww          , Gs^Fp       , Wwf         , Mm          , Wwf         , Xu          , Uu^Uf       , Uh          , Rd          , Xu          , Wwf         , Xu          , Xu          , Xu          
Xu          , Xu          , Xu          , Xu          , Xu          , Xu          , Gs^Fp       , Xu          , Rd          , Rd          , Wwf         , Hh          , Rp          , Rd          , Hh          , Rd          , Rd          , Mm          , Rd          , Wwf         , Wwf         , Wwf         , Xu          , Gs^Fp       , Xu          , Xu          , Rd          , Rd          , Ql          , Xu          , Xu          
Xu          , Xu          , Xu          , Xu          , Xu          , Xu          , Rp          , Rp          , Xu          , Ss^Vhs      , Rd          , Mm          , Rd          , Rd          , Rd          , Rd^Fp       , Uu^Vu       , Rd          , Xu          , Uh          , Ww          , Ww          , Xu          , Rd          , Rd          , Uu^Vu       , Rd          , Xu          , Xu          , Xu          , Xu          
Xu          , Xu          , Xu          , Xu          , Xu          , Xu          , Wwf         , Xu          , Xu          , Rd          , Rd^Fp       , Rd          , Rd          , Rd          , Wwf         , Wwf         , Ur          , Xu          , Ql          , Xu          , Wwf         , Ww          , Xu          , Ur          , Ur          , Gs^Fp       , Uu^Uf       , Xu          , Xu          , Xu          , Xu          
Xu          , Xu          , Xu          , Xu          , Xu          , Xu          , Uu^Vu       , Rd          , Hh          , Rp          , Wwf         , Hh          , Rd          , Rd          , Uh          , Uu^Uf       , Ur^Fp       , Ql          , Ur          , Rd          , Rd          , Wwf         , Rd          , Xu          , Ur          , Xu          , Ur          , Ql          , Xu          , Xu          , Xu          
Xu          , Xu          , Xu          , Xu          , Uu          , Xu          , Xu          , Rd          , Rd          , Rd          , Ss^Vhs      , Rp          , Rp          , Rd          , Rd          , Rd^Fp       , Wwf         , Ur          , Ur          , Mm          , Rd          , Wwf         , Wwf         , Rd          , Rd          , Ur          , Xu          , Xu          , Xu          , Xu          , Xu          
Xu          , Xu          , Uu          , Xu          , Ql^Bs|      , Xu          , Uu          , Xu          , Xu          , Ss          , Ss          , Gs^Fp       , Ur          , Cud         , Cud         , Rd          , Rd          , Wwf         , Ur          , Ur          , Ur          , Rd          , Xu          , Xu          , Xu          , Xu          , Xu          , Xu          , Xu          , Xu          , Xu          
Xu          , Xu          , Xu          , Ql^Bs\      , 1 Kud       , Ql^Bs/      , Xu          , Xu          , Xu          , Xu          , Xu          , Hh          , Rd          , Ur          , Ur          , Cud         , Rd          , Wwf         , Wwf         , Uu^Vu       , Uh          , Xu          , Xu          , Xu          , Xu          , Xu          , Xu          , Xu          , Xu          , Xu          , Xu          
Xu          , Xu          , Uu          , Ql^Bs/      , Ql^Bs|      , Ql^Bs\      , Uu          , Xu          , Xu          , Xu          , Xu          , Xu          , Ql          , Uu^Uf       , Uu          , Cud         , Ur          , Rd          , Xu          , Wwf^Uf      , Xu          , Xu          , Xu          , 3 Kud       , Xu          , Xu          , Xu          , Xu          , Xu          , Xu          , Xu          
Xu          , Xu          , Xu          , Xu          , Uu          , Xu          , Xu          , Xu          , Xu          , Xu          , Xu          , Xu          , Xu          , Ql          , Ql          , Kud         , Ql          , Xu          , Xu          , Xu          , Xu          , Xu          , Xu          , Xu          , Xu          , Xu          , Xu          , Xu          , Xu          , Xu          , Xu          
Xu          , Xu          , Xu          , Xu          , Xu          , Xu          , Xu          , Xu          , Xu          , Xu          , Xu          , Xu          , Xu          , Ql          , Ql          , Ql          , Ql          , Ql          , Xu          , Xu          , Xu          , Xu          , Xu          , Xu          , Xu          , Xu          , Xu          , Xu          , Xu          , Xu          , Xu          
