Ha, Ha, Ha, Ms, Ha, Ha, Ha, Ms, Ms, Ms, Ms, Ms, Ms, Ms, Ms, Ms, Ms, Ms, Ms, Ms, Ms, Ms, Ms, Ms, Ms, Ms, Ms, Aa, Ms, Ai, Ai, Ai, Ai, Ai
Ha, Ha, Ha, Ms, Ha, Ha, Ha, Ms, Ms, Ms, Ms, Ms, Ms, Ms, Ms, Ms, Ms, Ms, Ms, Ms, Ms, Ms, Ms, Ms, Ms, Ms, Ms, Aa^Vha, Ms, Ai, Ai, Ai, Ai, Ai
Gd, Gd, Gd, Ha, Aa, Aa, Gd, Ha, Ha, Ha, Ha, Ha, Ha, Ms, Ms, Ms, Ms, Ms, Ms, Ms, Ms, Ms, Ha, Ms, Ms, Ms, Ha, Ms, Cud, Ms, Ms, Ai, Ai, Ai
Ha, Ha, Gd, Gd, Aa, Aa, Ha, Gd, Gd, Ha, Ha, Ha, Ha^Vhha, Ms, Ms, Ms, Ms, Ms, Ms, Ms, Ha, Ha^Vhha, Gd, Ha, Ha, Ms, Ha, Cud, 1 Kud, Cud, Ms, Ai, Ai, Ai
Ha, Ha^Vhha, Aa^Fpa, Aa^Fpa, Gd, Ha, Gd, Gd, Gd, Ha, Gd, Gd, Gd, Ha, Ha, Ms, Ms, Ms, Ms, Ha, Ha, Aa, Aa, Aa, Ha^Fpa, Ha^Vhha, Rr, Cud, Cud, Cud, Aa, Ai, Ai, Ai
Gd, Gd, Aa^Fpa, Aa^Fpa, Aa^Fpa, Gd, Ha, Ha, Ms, Ha, Aa, Aa, Aa, Ha, Ha, Ha, Ms, Ha^Vhha, Ms, Ha, Gd, Gd, Aa^Fpa, Aa^Fpa, Aa^Fpa, Rr, Gd^Es, Gd, Gd, Gd, Ai, Ai, Ms, Ms
Aa^Fpa, Aa^Fpa, Gd, Aa^Fpa, Aa^Fpa, Gd, Ha, Ms, Ms, Ha, Gd, Aa, Aa^Fpa, Ha^Fpa, Ha^Fpa, Ha, Ha, Ms, Ms, Ha, Gd, Aa^Fpa, Aa^Fpa, Aa^Fpa, Gd, Rr, Gd, Gd, Ww, Ww, Mm, Mm, Mm, Ms
Aa^Fpa, Aa^Fpa, Aa^Fpa, Aa^Fpa, Aa^Fpa, Gd, Gd, Ms, Ms, Ms, Ha, Gd, Ha^Fpa, Ha^Fpa, Ha, Ms, Ms, Ms, Ms, Ha, Ha, Ha^Fpa, Aa^Fpa, Gd, Ww, Rr, Ww, Ww, Ha^Vhha, Ha, Mm, Mm, Ms, Ms
Aa^Fpa, Aa^Fpa, Aa^Fpa, Ha^Fpa, Aa, Aa, Ha, Ha, Ms, Ms, Ha, Ha^Fpa, Ha^Fpa, Gd, Ha, Ms, Ms, Ha, Ha, Ms, Gd, Gd, Ww, Ww, Gd, Ww^Bw|, Ai, Ai, Ai, Ha, Mm, Mm, Mm, Ms
Aa^Fpa, Aa^Fpa, Gd, Aa^Fpa, Gd, Aa, Gd, Gd, Gd, Ha, Gd, Gd, Aa^Fpa, Gd, Ha, Ms, Ms, Ha, Gd, Gd, Ww, Ww, Ha^Vhha, Gd, Gd^Es, Rr, Rr, Ai, Aa, Ha, Mm, Mm, Mm, Ms
Gd, Gd, Gd, Aa^Fpa, Gd, Gd, Gd, Ha, Gd, Ha, Gd, Gd, Gd, Gd, Gd, Ha, Ha, Ha, Ww, Ww, Ha, Ha, Mm, Ha, Ha, Gd, Rr, Aa, Aa, Ha, Ha, Mm, Ms, Ms
Aa^Fpa, Aa^Fpa, Aa^Fpa, Gd, Aa^Fpa, Aa^Fpa, Aa^Fpa, Gd, Ha^Fpa, Gd, Ms, Ha, Gd, Gd, Aa, Gd, Ww, Ww, Gd, Gd, Ha^Fpa, Ha, Mm, Cud, Mm, Ha, Rr, Gd, Aa^Fpa, Gd, Ha, Mm, Ms, Ms
Aa^Fpa, Aa^Fpa, Gd, Gd, Gd, Gd, Aa, Gd, Gd, Ha, Ms, Ms, Ha, Aa, Aa, Ww, Ww, Gd, Aa^Fpa, Aa^Fpa, Aa^Fpa, Ha, Ha, Mm, Ha, Ha, Rr, Gd, Aa^Fpa, Gd, Ha^Fpa, Mm, Ha^Fpa, Ms
Gd, Gd, Aa, Gd, Gd, Aa, Aa, Gd, Gd, Gd, Ha, Ha, Gd, Gd, Ww, Ww, Gd, Gd, Ha, Aa^Fpa, Rr, Ha, Rr, Ha, Rr, Rr, Gd, Aa^Fpa, Aa^Fpa, Ha^Fpa, Ha^Fpa, Ha^Fpa, Gs^Fp, Aa^Fpa
Aa, Aa, Aa, Gd, Ai, Aa, Ai, Gd, Gd, Gd, Gd, Gd, Ww, Ww, Ww, Ww, Gd, Mm, Ha, Rr, Gd, Rr, Ha, Rr, Ha^Vhha, Gd, Gd, Aa^Fpa, Aa^Fpa, Gd, Ha, Aa^Fpa, Gd, Gs^Fp
Gd, Gd, Ww, Ww, Ww, Ai, Ww, Ai, Ww, Ww, Ww, Ww, Ww, Ww, Aa, Aa, Aa, Gd, Rr, Rr, Ha, Ha, Ha, Mm, Ha, Ha, Ha, Ha, Ha, Aa, Ha, Aa, Aa^Fpa, Gd
Ww, Ww, Ww, Ww, Gd, Ww, Gd, Ww, Ww, Ww, Ww, Ww, Ai, Ai, Aa, Aa, Gd, Rr, Gd, Gd, Ha, Ha, Ha, Ha, Mm, Mm, Mm, Ha, Mm, Ha, Mm, Mm, Mm, Ms
Ww, Ww, Gd, Gd, Gd, Gd, Aa, Gd, Gd, Ai, Ai, Ai, Ha, Gd, Gd, Aa, Gd, Rr, Gd^Es, Gd, Ha, Mm, Mm, Mm, Ha, Mm, Ha, Ha, Mm, Mm, Mm, Mm, Mm, Mm
Aa, Aa, Aa, Gd, Gd^Vh, Gd, Gd, Gd, Aa, Gd, Ai, Ai, Gd, Mm, Ha, Gd, Gd^Vh, Rr, Gd, Gd, Ha^Fpa, Ha, Ha, Ha, Mm, Ha, Mm, Mm, Ha, Mm, Mm, Mm, Mm, Mm
Aa, Aa, Gd, Gd, Gd, Gd, Gd, Gd, Aa, Aa, Gd, Gd, Gd, Ha, Gd, Gd, Rr, Rr, Gd, Aa^Fpa, Ha, Ha^Fpa, Aa^Fpa, Ha, Ha, Mm, Ha, Mm, Mm, Mm, Mm, Mm, Mm, Mm
Gd, Gd, Gd, Gd, Gd, Gd, Gd, Gd, Gd, Aa, Gd, Gd, Gd, Gd, Gd, Gd, Rr, Gd, Gd, Gd, Mm, Ha, Gd, Ha^Fpa, Ha, Ha, Ha, Ha, Ha, Ha, Ha, Mm, Mm, Mm
Gd, Gd, Gd, Gd^Es, Gd, Gd, Gd, Gd, Gd^Vh, Gd, Gd, Gd, Gd, Gd, Gd, Gd, Rr, Gd, Gd, Ha, Ha, Gd, Gd, Gd^Fp, Gd, Aa^Fpa, Aa^Fpa, Ha, Aa^Fpa, Ha, Ha, Ha, Mm, Mm
Gd, Gd, Gd, Gd, Gd, Gd, Gd, Gd, Gd, Gd, Gd, Gd, Gd, Gd, Rr, Rr, Gd, Gd, Gd, Gd, Gd, Gd, Gd, Gd, Gd^Fp, Aa^Fpa, Gd^Fp, Gd^Fp, Gs^Ve, Ha, Ha, Mm, Mm, Mm
Gd, Gd, Gd, Gd, Gd, Gd, Gd, Gd, Gd, Gd, Gd, Gd, Gd, Gd^Fp, Rr, Gd, Gd, Gd, Gd, Gd, Gd, Gd, Gd, Gd, Cv, Cv, Cv, Gd^Fp, Gd, Hhd, Hhd, Mm, Mm, Mm
Gd, Gd, Ce, Gd^Vh, Gd, Gd, Gd, Gd, Gd, Gd, Gd, Gd, Rr, Rr, Gd, Gd, Gd, Gd, Gd, Gd^Fp, Gd^Fp, Gd^Ve, Gs^Fp, Gs^Fp, Cv, 3 Kv, Cv, Gd, Hh, Hhd, Mm, Ha, Ha^Fpa, Aa^Fpa
Gd, Ce, 2 Ke, Ce, Gd, Gd, Gd, Gd, Gd, Gd, Rr, Rr, Gd^Vh, Gd, Gd, Gd, Gd^Fp, Gd, Gd, Gd^Fp, Gd, Gd, Gd, Gs^Fp, Gd, Cv, Gs^Fp, Gd^Ve, Hh^Fp, Hh^Fp, Mm, Hhd, Ha^Fpa, Ha^Fpa
Gd, Ce, Ce, Ce, Gd, Gd, Gd, Gd, Rr, Rr, Gd, Gd, Gd, Gd, Gd, Gd^Fp, Gs^Fp, Gd^Fp, Gd^Fp, Gd, Gs^Fp, Gd, Gd^Ve, Gd, Gs^Fp, Gs^Fp, Gs^Fp, Gs^Fp, Hh, Mm, Hh, Hh^Fp, Hh, Hh
Gd, Gd, Gd, Gd, Gd, Gd, Gd, Rr, Gd, Gd, Gd, Gd, Gd, Gd, Gd, Gd, Gd, Gd, Gd^Fp, Gs^Fp, Gs^Fp, Gs^Fp, Gs^Fp, Gs^Fp, Gd, Gd, Hh, Gs^Ve, Hh, Hh, Mm, Mm, Hh^Fp, Hh^Fp
Gd, Gd, Gd, Gd, Rr, Gd, Rr, Rr, Gd, Gd, Gd, Gd, Gd, Gd, Gd^Fp, Gd, Gd, Gd^Fp, Gd^Fp, Gs^Fp, Gs^Fp, Gs^Fp, Gs^Fp, Gs^Fp, Gs^Ve, Hh, Gs^Fp, Gs^Fp, Hh^Fp, Hh, Hh, Hh, Hh^Fp, Hh^Fp
Gd, Gd, Gd, Rr, Gd^Vh, Rr, Gd, Gd, Gd, Gll^Fp, Gd, Gd, Gd, Gd^Fp, Gd^Fp, Gd, Gd^Fp, Gs^Fp, Gs^Fp, Gs^Fp, Gs^Fp, Gs^Fp, Hh, Gs, Gs^Fp, Gs^Fp, Gs^Fp, Gs^Fp, Hh, Hh^Fp, Gs, Hh^Fp, Hh^Fp, Hh^Fp
Gd, Gd, Rr, Rr, Gd, Gd, Gd, Gd, Gd, Gd, Gd, Gd, Gd, Gd^Fp, Gs, Gd^Fp, Gs^Fp, Gs^Fp, Gs, Gs^Fp, Gs^Fp, Gs, Hh^Fp, Hh^Fp, Gs^Fp, Gs^Fp, Gs^Fp, Gs, Gs^Fp, Gs^Fp, Gs^Fp, Gs, Hh^Fp, Hh^Fp
Rr, Rr, Gd, Gd, Gd, Gd, Gll^Fp, Gll^Fp, Gd, Gd, Gd, Gd^Fp, Gd^Fp, Gs^Fp, Gs, Gs^Fp, Gs, Gs^Fp, Gs^Fp, Gs^Fp, Gs, Gs^Fp, Hh, Hh, Gs, Gs^Fp, Gs, Gs^Fp, Gs^Fp, Gs^Fp, Gs, Gs, Hh, Hh
Rr, Rr, Gd, Gd, Gd, Gd, Gd, Gll^Fp, Gd, Gd, Gd^Fp, Gs^Fp, Gd^Fp, Gs^Fp, Gs, Gs^Fp, Gs^Fp, Gs^Fp, Gs^Fp, Gs^Fp, Gs^Fp, Gs^Fp, Gs^Fp, Gs^Fp, Gs, Gs^Fp, Gs, Gs^Fp, Gs^Fp, Gs^Fp, Gs, Gs, Hh, Hh
