Xu, Xu, Xu, Uh, Uh, Uu, Uu, Xu, Xu, Xu, Xu, Xu, Xu, Xu, Xu, Xu, Xu, Xu, Xu, Xu, Xu, Xu, Xu, Xu, Xu, Xu, Xu, Xu, Xu, Xu, Xu, Xu, Xu, Xu
Xu, Xu, Xu, Uh, Uh, Uu, Uu, Xu, Xu, Xu, Xu, Xu, Xu, Xu, Xu, Xu, Xu, Xu, Xu, Xu, Xu, Xu, Xu, Xu, Xu, Xu, Xu, Xu, Xu, Xu, Xu, Xu, Xu, Xu
Xu, Xu, Xu, Uh, Uh, Uu, Uu, Xu, Xu, Xu, Xu, Xu, Xu, Xu, Uu, Xu, Xu, Xu, Xu, Xu, Xu, Xu, Xu, Xu, Xu, Xu, Xu, Xu, Xu, Xu, Xu, Xu, Xu, Xu
Xu, Xu, Xu, Xu, Xu, Uu, Uu, Uh, Uh, Xu, Xu, Xu, Xu, Uu, Cud, Uu, Xu, Xu, Xu, Xu, Xu, Xu, Xu, Xu, Xu, Xu, Xu, Xu, Xu, Xu, Xu, Xu, Xu, Xu
Xu, Xu, Uu, Uu, Uu, Uu, Uu, Uu, Uh, Uh, Uu, Uu, Uu^Vu, Uu, Uu, Uu, Xu, Xu, Xu, Xu, Xu, Xu, Xu, Xu, Xu, Xu, Xu, Xu, Xu, Xu, Xu, Xu, Xu, Xu
Xu, Xu, Uu, Cud, Uu, Xu, Xu, Uu, Uu, Uh, Uu, Xu, Xu, Xu, Xu, Xu, Xu, Xu, Xu, Xu, Xu, Xu, Xu, Xu, Xu, Xu, Xu, Xu, Xu, Xu, Xu, Xu, Xu, Xu
Xu, Xu, Cud, Uu, Xu, Xu, Xu, Uh, Uu, Uu, Uu^Vu, Xu, Xu, Xu, Xu, Xu, Xu, Xu, Xu, Xu, Xu, Xu, Xu, Xu, Xu, Xu, Xu, Xu, Xu, Xu, Xu, Xu, Xu, Xu
Mm, Mm, Mm, Xu, Xu, Xu, Xu, Xu, Xu, Uu, Uu, Xu, Xu, Xu, Xu, Xu, Xu, Xu, Xu, Xu, Xu, Xu, Uu, Xu, Xu, Xu, Xu, Xu, Xu, Xu, Xu, Xu, Xu, Xu
Mm, Mm, Mm, Mm, Xu, Xu, Xu, Xu, Xu, Uh, Uu, Uu, Uu, Xu, Xu, Xu, Xu, Xu, Uu, Uu, Uu, Uu, Rr, Uu^Vud, Uu, Uu, Uu, Xu, Xu, Xu, Xu, Xu, Xu, Xu
Ms, Ms, Ms, Ms, Ms, Xu, Xu, Xu, Xu, Xu, Xu, Uu, Uu, Uu^Vud, Uu, Uu, Uu, Uu, Uu, Uu, Rr, Rr, Rr, Rr, Rr, Uu, Uu, Uu, Uu, Xu, Xu, Xu, Xu, Xu
Ms, Ms, Ms, Ms, Ms, Mm, Xu, Xu, Uu, Uu, Uu, Xu, Uu, Uh, Uh, Uu, Rr, Rr, Rr, Rr, Rr, Rr, Uu^Vud, Rr, Rr, Rr, Rr, Uu, Uu, Uu, Uu, Uu, Uu, Uu
Ms, Ms, Aa^Vha, Ms, Ms, Ms, Xu, Xu, Uu, Cud, Uu, Uu^Vud, Uu, Uh, Rr, Rr, Rr, Rr, Rr, Rr, Uu, Uu, Cud, Uu, Uu, Rr, Rr, Rr, Rr, Uu^Vud, Uu, Uu, Uu, Uu
Ha, Ha, Ha^Esa, Ms, Ms, Ms, Mm, Xu, Xu, Uu, Xu, Xu, Uu, Rr, Rr, Rr, Uu, Uu, Uu, Uu, Uu, Cud, Kud, Cud, Uu, Uu, Uu, Rr, Rr, Rr, Rr, Uu, Rr, Rr
Ms, Ms, Ms, Ha^Fpa, Ms, Ms, Ms, Mm, Mm, Xu, Cud, Uu, Rr, Rr, Uu, Uu, Uu^Vud, Xu, Xu, Uu, Uu^Vud, Cud, Cud, Cud, Uu^Vud, Uu, Uu, Uu, Uu, Rr, Rr, Rr, Rr, Rr
Ms, Ms, Ha^Fpa, Ha^Fpa, Ms, Ms, Ms, Ha, Ha, Ha, Rr, Rr, Cud, Rr, Uu, Xu, Uu, Uu, Uu, Xu, Uu, Uu, Uu, Uu, Xu, Uu, Uu, Uu, Uu, Uu, Uu^Vud, Rr, Uu, Uu
Ha, Gd^Em, Gd^Em, Ha^Esa, Ha, Ms, Ha, Ha, Gd^Esa, Rr, Rr, Rr, Rr, Rr, Cud, Xu, Uu, Cud, Uu, Xu, Uu, Uu, Uu, Xu, Xu, Xu, Xu, Xu, Xu, Uu, Xu, Uu, Xu, Xu
Ha, Ha, Aa, Ha, Aa^Esa, Ha, Gd, Ha^Fpa, Rp^Em, Rp, Rr, 1 Rr, Rr, Rr, Ha, Xu, Xu, Uu, Xu, Xu, Xu, Uu, Uu, Uu, Uu, Xu, Xu, Xu, Xu, Xu, Xu, Xu, Xu, Xu
Ha, Aa, Aa, Aa^Esa, Ha, Ha, Gd^Vh, Gd, Rr, Rp, Aa, Aa, Gd^Vh, Ha, Ha, Xu, Xu, Xu, Xu, Xu, Xu, Xu, Xu, Uu, Uu^Vud, Xu, Xu, Xu, Xu, Xu, Xu, Xu, Xu, Xu
Gd, Aa, Gd, Ha, Aa^Es, Gd^Es, Gd^Es, Rp, Rp, Rr, Gd, Gd, Aa^Fpa, Gd, Ha, Ms, Ms, Xu, Xu, Xu, Xu, Xu, Xu, Uh, Uu, Uu, Xu, Xu, Xu, Xu, Uu, Xu, Xu, Xu
Hhd^Esa, Gd, Ha, Aa, Aa, Aa^Fpa, Gd, Rr, Rr, Gd^Em, Aa, Aa^Fpa, Aa^Fpa, Aa, Ha, Ha^Em, Ms, Ms, Xu, Xu, Xu, Xu, Xu, Uh, Uh, Uu, Uu, Xu, Xu, Uu, Cud, Uu, Xu, Xu
Hhd^Esa, Hhd^Esa, Ha, Ha, Gd^Esa, Gd, Rr, Rp, Rr^Esa, Aa, Aa, Aa^Fpa, Gd, Aa, Ha, Ms, Ha, Ha, Ms, Xu, Xu, Xu, Xu, Xu, Xu, Uu, Uu, Xu, Uu^Vu, Uu, Uu, Uu, Xu, Xu
Aa, Gd, Gd^Vh, Gd, Rr, Rr, Rp, Rr, Ha, Ha, Ha, Aa^Esa, Aa^Fpa, Gd, Gd, Ha, Ha, Ms, Ms, Ms, Xu, Xu, Xu, Xu, Xu, Uu, Uh, Uh, Xu, Xu, Xu, Xu, Xu, Xu
Gll^Fmw, Gd^Esa, Rp, Rp, Rr, Rp, Cf, Cf, Cf, Mm, Ha, Gd, Aa^Fpa, Aa^Fpa, Ha^Esa, Aa, Aa^Vha, Ha, Ha, Ms, Ms, Xu, Xu, Xu, Xu, Uu, Uu, Uh, Xu, Xu, Xu, Xu, Xu, Xu
Aa, Rr, Rp, Rp, Aa, Gd, Cf, 2 Kf, Cf, Mm, Ha, Gd, Ha, Aa^Fpa, Aa, Aa^Esa, Ha^Esa, Ha^Es, Mm, Mm, Mm, Xu, Uu, Uu, Uu, Uu^Vu, Uu, Uh, Uu, Xu, Xu, Xu, Xu, Xu
Rp, Rr, Gd, Gd, Aa, Aa^Esa, Hhd, Cf, Mm, Mm, Ha, Ha, Ms, Ms, Ha, Aa^Esa, Ha, Mm, Mm, Mm, Mm, Cud, Uu, Cud, Uu, Xu, Xu, Uu, Uu, Uu, Uu, Xu, Xu, Xu
Rp, Rp, Gll^Fmw, Gd^Es, Aa^Fpa, Aa^Vha, Ha, Mm, Ha, Ha, Ms, Ms, Ms, Ms, Ha^Fpa, Ha, Ms, Ms, Ms, Ms, Ms, Xu, Xu, Uu, Xu, Xu, Xu, Xu, Xu, Uh, Uh, Uu, Xu, Xu
Aa, Aa^Fda, Aa^Fda, Aa^Fpa, Aa^Fpa, Ha^Fpa, Aa, Gd^Es, Gd^Em, Aa^Es, Aa^Esa, Ms, Ms, Ha^Fpa, Ha^Fpa, Ha^Esa, Ha^Esa, Ms, Ms, Ms, Ms, Mm, Ms, Xu, Xu, Xu, Xu, Xu, Xu, Xu, Uu, Uu, Uu^Vu, Uu
Aa^Esa, Aa, Aa, Gd^Em, Aa, Aa^Esa, Aa, Aa^Fpa, Gd, Aa, Gd^Vh, Ms, Ms, Ha^Fpa, Ha, Aa^Vha, Ha, Mm, Ms, Ms, Ms, Ms, Ms, Xu, Xu, Xu, Xu, Xu, Xu, Xu, Xu, Uu, Uu, Uu
Wwg, Aa^Esa, Ai, Aa, Aa, Aa, Aa, Aa, Aa, Gd, Aa, Ha^Esa, Ha, Ha^Esa, Ha, Ha, Ms, Mm, Ms, Ms, Ms, Ms, Ms, Xu, Xu, Xu, Xu, Xu, Xu, Xu, Xu, Uh, Uh, Uh
Wwg, Wwg, Ai, Ai, Gd, Gd, Gd, Aa, Gd, Gd, Aa, Ha, Ha, Ha, Ms, Ms, Ms, Ms, Mm, Ms, Ms, Ms, Mm, Xu, Xu, Xu, Xu, Xu, Xu, Xu, Xu, Uh, Uh, Uh
