Xu, Xu, Xu, Xu, Xu, Xu, Xu, Xu, Xu, Xu, Xu, Xu, Xu, Xu, Xu, Xu, Xu, Xu, Uu, Uu^Br|, Uu, Xu, Xu, Xu, Xu, Xu, Xu
Xu, Xu, Xu, Xu, Xu, Xu, Xu, Xu, Xu, Xu, Xu, Xu, Xu, Xu, Xu, Xu, Xu, Uu, Wwf, Uu^Br|, Uu, Xu, Xu, Xu, Xu, Xu, Xu
Xu, Xu, Xu, Xu, Xu, Xu, Xu, Xu, Xu, Xu, Xu, Xu, Xu, Xu, Xu, Xu, Uu, Wwf, Uu^Br/, Uu^Br|, Xu, Xu, Xu, Xu, Xu, Xu, Xu
Xu, Xu, Xu, Xu, Xu, Xu, Xu, Xu, Xu, Xu, Xu, Xu, Xuc, Xuc, Wwf^Es, Uu^Dr, Wwf^Br/, Wwf^Br/, Uu^Es, Uu^Dr, Xu, Xu, Xu, Xu, Xu, Xu, Xu
Wog, Xu, Xu, Xu, Xuc, Xuc, Xuc, Xuc, Uu, Xu, Uu, Xu, Xuc, Wwg, Wwf, Wwf^Br/, Wwf^Es, Wwf, Wwf, Xu, Xu, Xu, Xu, Xu, Xu, Xu, Xu
Wog, Wog, Xu, Xu, Xuc, Uu, Uu, Uu, Uu^Br/, Uu^Br/, Uu^Br\, Uu, Uu^Dr, Wwf, Wwg^Br/, Wwf^Br|, Wwg^Es, Wwg^Es, Xu, Xu, Xu, Xu, Xu, Xu, Xu, Xu, Xu
Wog, Wog, Wog, Xu, Uu, Uu, Uu^Br/, Uu^Br/, Xu, Uu, Xu, Uu^Br\, Wwf^Br\, Wwf^Br/, Wwg, Wwg, Wwg, Xuc, Xuc, Xu, Xu, Xu, Xu, Xu, Xu, Xu, Xu
Wog, Wog, Xu, Xu, Xu, Uu^Br|, Uu^Dr, Uu, Xu, Xu, Xu, Xu, Wwg, Wwg^Br|, Wog, Wog, Wwf, Uu, Uu^Es, Xu, Xu, Xu, Xu, Xu, Xu, Xu, Xu
Wog, Wog, Wog, Xu, Xuc, Uu^Br|, Uu, Xuc, Xu, Xu, Xuc, Xu, Wwg, Wwg^Br|, Wwg, Wog, Wwf, Uu^Vu, Uu, Uu^Es, Xu, Xu, Xu, Xu, Xu, Xu, Xu
Xu, Wog, Wog, Wog, Wwg, Tb, Uu, Uu, Xu, Xuc, Ur, Xuc, Uu, Wwg^Br|, Wwg, Wwf, Uu, Uu, Tb^Tf, Xu, Xu, Xu, Xu, Xu, Xu, Xu, Xu
Xu, Wog, Wwg, Wog, Wwg, Uu^Br|, Wwf, Uu, Uu, Uu^Vu, Ur^Es, Uu^Es, Uu^Br/, Wwg^Br|, Wwg, Xu, Xu, Tb^Tf, Tb^Tf, Xu, Xu, Xu, Xu, Xu, Xu, Xu, Xu
Xu, Xu, Wwg, Wwg, Wog, Wwg^Br/, Wwf, Wwf, Wwf, Wwf, Uu^Tf, Wwf, Wwf^Br|, Wwg, Wwf, Xuc, Xuc, Xu, Xu, Xu, Xu, Xu, Xu, Xu, Xu, Xu, Xu
Xu, Xu, Xu, Wwg, Wog, Wog, Wog, Wog, Wog, Wwf, Wog, Wog, Wwg^Br|, Wog, Wog, Wwf, Xuc, Xu, Xu, Xu, Uh, Xu, Xu, Xu, Xu, Xu, Xu
Xu, Xu, Xu, Tb^Tf, Ur^Br|, Wog, Wog, Wog, Wog, 3 Wog, Wog, Uu, Wwg^Br|, Uu^Edt, Wog, Wog, Xuc, Xu, Xu, Uh, Uh, Xu, Xu, Xu, Xu, Xu, Wwg
Xu, Xu, Xu, Xu, Xu, Wwf^Br\, Wwf^Br\, Wog, Wwg, Wog, Wog, Wog, Wog^Br|, Rb^Ecf, Wwf^Edt, Wog, Wwg, Xuc, Xu, Uh, Wwf, Xu, Xu, Xu, Uh, Wwg, Wog
Xu, Xu, Xu, Xu, Xu, Wwf, Wwf^Br|, Wwg, Xu, Uh, Wwf, Wog, Wwg^Br|, Wwg, Wwg^Edt, Wog, Wog, Uh^Edt, Wog, Wwg, Wwg, Wwg, Wwg, Uh, Wog, Wog, Wwg
Xu, Xu, Xu, Xu, Xu, Uu, Uu^Br|, Wwf, Xuc, Uh, Wwg, Wwg, Wwg^Br|, Wwg, Wwf, Wwg, Wwg, Wog, Wog, Wog, Wog, 2 Wog, Wog, Wog, Wwg, Wwg, Uu
Xu, Xu, Xu, Xu, Xu, Xu, Uu, Uu^Br\, Uu^Br\, Xuc, Wwf, Wwf, Wwf^Br|, Wwf, Uh, Wwg, Xu, Xu, Xu, Wwg, Wwg, Wwf, Wwf, Wwf, Uu, Uu^Vu, Xu
Xu, Xu, Xu, Xu, Xu, Xu, Uh, Uu, Uu, Uu^Br\, Uu^Br/, Wwf^Br/, Wwf, Wwf, Xu, Xu, Xu, Xu, Xu, Wwf, Uu^Tf, Uu^Efs, Ur, Wwf, Xu, Xu, Xu
Xu, Xu, Xu, Xu, Xu, Xu, Xu, Uu, Uu^Vu, Uh, Uu^Br|, Uu, Uu, Xu, Xu, Xu, Xu, Xu, Tb^Tf, Uu^Tf, Tb^Tf, Uu, Uu, Uu^Dr, Xu, Xu, Xu
Xu, Xu, Xu, Xu, Xu, Xu, Xu, Uu, Uu^Es, Uu, Uu^Br|, Uu, Xu, Xu, Xu, Xu, Xu, Xu, Xu, Tb^Tf, Tb^Tf, Uu^Tf, Uu, Uu, Xu, Xu, Xu
Xu, Xu, Xu, Xu, Xu, Xu, Xu, Uu^Es, Uu^Es, Rb^Es, Rb^Br|, Uh, Xu, Xu, Xu, Xu, Xu, Xu, Xu, Uh, Uh, Uu, Uu, Xu, Xu, Xu, Xu
Xu, Xu, Xu, Xu, Xu, Xu, Xu, Xu, Uh, Uu, Uu^Br|, Uu, Xu, Xu, Xu, Xu, Uh, Uh, Uu, Uu, Ur, Uu, Uu, Xu, Xu, Xu, Xu
Xu, Xu, Xu, Xu, Xu, Xu, Xu, Xu, Xu, Uu, Uu^Br|, Uu, Xuc, Xu, Xuc, Xu, Uu, Uu, Ur, Uu^Vu, Ur, Uu, Xu, Xu, Xu, Xu, Xu
Xu, Xu, Xu, Xu, Xu, Xu, Xu, Xu, Xuc, Uu, Uu^Br|, Uu, Uh, Xuc, Ur^Es, Uu, Ur, Ur, Uu, Ur, Uu, Uh, Xu, Xu, Xu, Xu, Xu
Xu, Xu, Xu, Xu, Xu, Xu, Xu, Xu, Uh, Rb, Rb^Br|, Uu, Uu, Ur^Es, Ce, Ur, Uu, Uu, Uu, Uu, Xu, Xu, Xu, Xu, Xu, Xu, Xu
Xu, Xu, Xu, Xu, Xu, Xu, Xu, Xu, Uu, Uu, 1 Rb^Br|, Rb^Em, Ce, Ce, Ce, Uu, Xu, Xu, Xu, Xu, Xu, Xu, Xu, Xu, Xu, Xu, Xu
Xu, Xu, Xu, Xu, Xu, Xu, Xuc, Xuc, Rb^Br/, Rb^Br/, Uu, Uu^Es, Ur, Ke, Ce, Uu, Uu, Xu, Xu, Xu, Xu, Xu, Xu, Xu, Xu, Xu, Xu
Xu, Xu, Xu, Xu, Xu, Xuc, Re^Vct, Uu, Uu^Br|, Uu, Uu, Re^Vct, Uh, Uu, Uu, Xu, Uu, Xu, Xu, Xu, Xu, Xu, Xu, Xu, Xu, Xu, Xu
Xu, Xu, Xu, Xu, Uh, Uu, Uu, Rb^Br/, Uu, Xuc, Xu, Xu, Xu, Uh, Uu, Uu, Xu, Xu, Xu, Xu, Xu, Xu, Xu, Xu, Xu, Xu, Xu
Xu, Xu, Xu, Xu, Uh, Uu, Uu, Rb^Br|, Uu, Xu, Xu, Xu, Xu, Xu, Xu, Xu, Xu, Xu, Xu, Xu, Xu, Xu, Xu, Xu, Xu, Xu, Xu
Xu, Xu, Xu, Xu, Xu, Uu, Uu, Rb^Br|, Uu, Xu, Xu, Xu, Xu, Xu, Xu, Xu, Xu, Xu, Xu, Xu, Xu, Xu, Xu, Xu, Xu, Xu, Xu
