Aa, Aa, Aa^Fpa, Aa^Fpa, Aa, Aa^Fpa, Aa^Fpa, Aa, Aa^Fpa, Ai, Ai, Rd, Gs, Aa, Aa^Fpa, Ha, Ha, Aa^Fpa, Aa, Aa, Aa, Gs, Aa^Fpa, Aa^Fpa, Aa^Fpa, Aa^Fpa, Aa^Fpa, Ha, Aa^Fpa, Aa^Fpa, Aa^Fpa, Aa^Fpa, Aa, Aa
Aa, Aa, Aa^Fpa, Aa^Fpa, Aa, Aa^Fpa, Aa^Fpa, Aa, Aa^Fpa, Ai, Ai, Rd, Re, Aa, Aa^Fpa, Ha, Ha, Aa^Fpa, Aa, Aa, Aa, Gs, Aa^Fpa, Aa^Fpa, Aa^Fpa, Aa^Fpa, Ha, Ha^Fpa, Ha, Aa^Fpa, Aa^Fpa, Aa^Fpa, Aa, Aa
Aa, Aa, Aa, Aa^Fpa, Aa, Aa, Aa, Aa, Aa, Aa, Ai, Ai, Rd, Aa, Aa, Aa^Fpa, Aa^Fpa, Aa^Fpa, Aa^Fpa, Aa^Fpa, Aa^Fpa, Aa^Fpa, Aa^Fpa, Aa^Fpa, Aa, Ha^Fpa, Aa^Fpa, Ha, Ha^Fpa, Ha^Fpa, Aa^Fpa, Aa, Ai, Ai
Aa^Fpa, Aa^Fpa, Aa^Fpa, Aa^Fpa, Aa^Fpa, Aa^Fpa, Aa^Fpa, Aa^Fpa, Aa^Fpa, Aa^Fpa, Aa^Fpa, Aa, Aa, Rd, Aa, Aa^Fpa, Aa^Fpa, Ai, Ai, Aa^Fpa, Aa, Aa^Fpa, Ha, Ha, Aa, Aa, Ha, Aa, Aa, Aa^Fpa, Aa^Fpa, Ai, Aa^Fpa, Aa^Fpa
Aa^Fpa, Aa^Fpa, Ha, Ha, Ha, Aa^Fpa, Ha, Aa, Aa^Fpa, Ha, Ha^Fpa, Ha, Aa, Re, Aa, Aa^Fpa, Aa^Fpa, Ai, Aa^Fpa, Aa^Fpa, Gs, Aa, Ha, Ha, Aa^Fpa, Aa, Ww, Ha, Ai, Ha, Ww, Ai, Aa^Fpa, Aa^Fpa
Aa^Fpa, Aa^Fpa, Aa, Ms, Ai, Ha, Ha, Ha, Ha, Aa^Fpa, Ha, Ha^Fpa, Aa, Rd, Aa, Aa, Aa^Fpa, Aa^Fpa, Aa, Aa^Fpa, Aa^Fpa, Aa, Aa^Fpa, Aa^Fpa, Ww, Ww, Aa, Ai, Ww, Ww, Aa^Fpa, Aa^Fpa, Aa, Aa
Aa^Fpa, Aa^Fpa, Ha^Fpa, Ha, Ai, Ai, Ha, Ha^Fpa, Ha, Aa^Fpa, Ha, Aa^Fpa, Aa, Rd, Aa, Aa, Aa^Fpa, Aa^Fpa, Aa, Aa, Aa^Fpa, Aa^Fpa, Ai, Aa^Fpa, Ww, Aa, Aa^Fpa, Aa^Fpa, Ha, Ai, Aa, Aa, Aa, Aa
Aa^Fpa, Aa^Fpa, Aa, Ha, Ha, Ha, Aa^Fpa, Gs, Ha, Aa^Fpa, Aa^Fpa, Aa^Fpa, Aa, Rd, Re, Aa, Aa^Fpa, Aa^Fpa, Aa, Gs, Aa^Fpa, Ai, Ww, Ww, Ha, Aa, Ha, Aa^Fpa, Aa^Fpa, Aa^Fpa, Aa^Fpa, Aa, Aa^Fpa, Aa^Fpa
Aa^Fpa, Aa^Fpa, Aa^Fpa, Aa^Fpa, Ha, Ha, Aa, Aa, Ms, Aa^Fpa, Aa^Fpa, Aa^Fpa, Aa^Fpa, Re, Rd, Aa, Aa^Fpa, Aa^Fpa, Aa^Fpa, Aa^Fpa, Aa, Ai, Ww, Ai, Aa^Fpa, Ha, Ha^Fpa, Ha, Aa^Fpa, Aa^Fpa, Aa, Aa^Fpa, Aa, Aa
Aa, Aa, Ha, Ha, Ha, Aa^Fpa, Ha, Aa, Aa^Fpa, Ha, Aa^Fpa, Aa, Aa^Fpa, Aa, Rd, Aa, Ai, Ai, Ww, Ww, Ww, Ww, Ai, Ai, Ha, Ha, Ha, Ha, Aa, Aa, Aa, Aa^Fpa, Aa, Aa
Aa, Aa, Aa^Fpa, Aa^Fpa, Aa^Fpa, Aa^Fpa, Ha, Ha^Fpa, Aa, Aa^Fpa, Aa^Fpa, Aa^Fpa, Aa, Aa, Ww^Bw|, Ww, Ww, Ww, Ai, Aa^Fpa, Aa^Fpa, Aa, Aa^Fpa, Aa^Fpa, Ha, Ms, Ha, Aa^Fpa, Aa^Fpa, Ha^Fpa, Aa^Fpa, Gg, Aa^Fpa, Aa^Fpa
Aa, Aa, Aa^Fpa, Gs, Aa^Fpa, Ha, Ha, Ha, Aa, Aa, Aa^Fpa, Aa, Ww, Ww, Rd, Gs^Es, Aa, Ai, Aa^Fpa, Aa^Fpa, Aa, Aa^Fpa, Aa^Fpa, Aa^Fpa, Aa^Fpa, Ha, Aa^Fpa, Aa^Fpa, Ha, Ha, Ha, Aa^Fpa, Aa^Fpa, Aa^Fpa
Aa, Aa, Aa, Aa^Fpa, Aa^Fpa, Aa^Fpa, Ha^Fpa, Ha^Fpa, Aa^Fpa, Aa^Fpa, Ai, Ww, Aa^Fpa, Aa, Aa, Rd, Gs, Aa, Aa^Fpa, Aa^Fpa, Ai, Ai, Aa^Fpa, Aa^Fpa, Ha, Aa^Fpa, Aa^Fpa, Aa^Fpa, Ha, Ms, Ha, Aa^Fpa, Aa^Fpa, Aa^Fpa
Aa, Aa, Aa^Fpa, Aa, Aa^Fpa, Aa^Fpa, Aa^Fpa, Ha, Ai, Ha, Ww, Aa, Aa, Aa, Aa, Rd, Gs, Aa, Aa^Fpa, Gs, Ai, Ai, Aa^Fpa, Ha, Ms, Ha, Aa^Fpa, Aa^Fpa, Aa^Fpa, Ha, Aa^Fpa, Aa^Fpa, Aa^Fpa, Aa^Fpa
Re, Re, Rd, Aa, Aa, Aa^Fpa, Ai, Aa^Fpa, Ww, Ww, Ai, Aa^Fpa, Aa^Fpa, Aa^Fpa, Rd, Re, Aa, Aa, Aa^Fpa, Aa^Fpa, Aa^Fpa, Aa^Fpa, Aa^Fpa, Ha, Ha, Ha, Aa^Fpa, Aa^Fpa, Aa^Fpa, Aa^Fpa, Ai, Aa^Fpa, Aa^Fpa, Aa^Fpa
Aa, Aa, Aa, Rd, Ai^Bw\, Ai, Ai, Ww, Aa^Fpa, Ai, Aa^Fpa, Aa^Fpa, Aa^Fpa, Aa, Rd, Gs, Aa, Aa, Aa^Fpa, Aa^Fpa, Aa, Aa, Aa^Fpa, Aa^Fpa, Ha, Ha^Fpa, Ha, Ha, Aa^Fpa, Ai, Ai, Aa^Fpa, Aa^Fpa, Aa^Fpa
Aa, Aa, Ww, Ww, Gs, Rd, Re, Aa^Fpa, Aa^Fpa, Aa^Fpa, Aa, Aa^Fpa, Aa, Aa^Fpa, Aa, Rd, Re, Aa, Aa, Aa^Fpa, Aa^Fpa, Aa, Ha, Aa^Fpa, Ha, Ha, Ha, Ha, Aa^Fpa, Aa, Aa, Aa^Fpa, Aa^Fpa, Aa^Fpa
Ai, Ai, Aa, Aa^Fpa, Aa, Aa, Gs, Rd, Aa, Aa^Fpa, Aa, Aa, Aa^Fpa, Aa^Fpa, Aa, Aa, Rd, Gs^Es, Aa, Aa^Fpa, Aa^Fpa, Aa^Fpa, Ha, Ha, Aa, Ha^Fpa, Aa, Ha, Ha, Aa^Fpa, Ha, Ha^Fpa, Aa^Fpa, Aa^Fpa
Ww, Ww, Aa, Aa, Aa^Fpa, Aa, Gs, Rd, Rd, Aa, Aa, Ha^Fpa, Ha, Aa, Ha, Aa, Rd, Aa, Aa, Aa^Fpa, Ha, Aa^Fpa, Aa, Aa^Fpa, Aa, Aa, Aa^Fpa, Ha, Aa^Fpa, Aa^Fpa, Aa^Fpa, Aa^Fpa, Aa, Aa
Aa^Fpa, Aa^Fpa, Aa^Fpa, Aa, Aa^Fpa, Aa^Fpa, Aa, Gs, Rd, Gs, Ha, Ha, Ms, Ms, Cud, Ha, Rd, Gs, Aa, Aa^Fpa, Ha, Ha, Aa, Aa, Aa^Fpa, Aa^Fpa, Aa^Fpa, Aa^Fpa, Aa, Aa, Aa, Aa, Rd, Rd
Gs, Gs, Gs, Gs, Ha^Fpa, Aa, Ha, Ha, Ha, Rd, Rr, Cud, Ha, Ha, Ha, Rr, Cud, Ha, Aa, Aa^Fpa, Aa^Fpa, Aa^Fpa, Aa^Fpa, Aa^Fpa, Aa, Aa, Rd, Aa, Rd, Re, Re, Rd, Gs, Gs
Gs, Gs^Es, Ha, Ha, Ha, Ha, Ha, Ha, Ms, Cud, Rr, Aa^Vaa, Aa, Gs, Rr, Rr, Ms, Ha, Ha, Aa^Fpa, Aa^Fpa, Aa^Fpa, Aa, Aa, Re, Rd, Gs^Es, Rd, Aa, Re, Aa, Aa, Aa, Aa
Gs, Gs, Ha, Ms, Ha, Ms, Ms, Ms, Ha, Ha, Gs, Rr, Rr, Rr, Gd, Ha^Vaa, Ms, Ms, Ha, Aa, Aa, Aa, Gs, Aa, Rd, Gs, Aa^Fpa, Aa, Aa^Fpa, Aa, Aa^Fpa, Aa^Fpa, Aa^Fpa, Aa^Fpa
Ha, Ha, Ha, Ms, Ms, Ms, Ha, Ms, Ha, Aa, Gs, Gd, Rr, Rr, Rr, Ha, Ha, Ms, Ha, Aa, Aa, Gs, Re, Rd, Aa, Aa^Fpa, Aa, Aa^Fpa, Ha, Aa^Fpa, Ha, Ha, Ha, Ha
Ms, Ms, Ai, Ms, Ha, Ms, Ha, Ha, Aa, Aa^Vaa, Rr, Rr, Aa, Gd, Ha, Rr, Rr, Cud, Rd, Rd, Rd, Rd, Aa, Aa, Aa^Fpa, Aa^Fpa, Aa^Fpa, Aa^Fpa, Ha, Ha, Ha, Ms, Ha, Ha
Ha, Ha, Ai, Ha, Ha, Ha, Ha^Vaa, Aa, Gd^Es, Rr, Gd, Gd^Es, Aa, Aa, Ha, Ha, Aa^Vaa, Rr, Ha, Aa, Gs, Aa^Fpa, Aa^Fpa, Aa, Aa^Fpa, Aa^Fpa, Ai, Aa^Fpa, Aa, Aa^Fpa, Aa, Ha, Aa^Fpa, Aa^Fpa
Ms, Ms, Ms, Ms, Ha, Ha, Cud, Gs, Rr, Rr, Gs, Gs, Aa^Vaa, Ha, Ha, Ms, Ms, Cud, Ha, Gs, Gs, Aa^Fpa, Aa, Aa, Aa, Aa^Fpa, Ai, Ai, Ai, Aa, Ai, Ai, Ai, Ai
Mm^Xm, Ha, Mm^Xm, Ha, Ms, Cud, 1 Kud, Cud, Gs, Gs, Ai, Ai, Ai, Ha, Ha, Ms, Ha, Ms, Ha, Aa, Aa, Aa^Fpa, Aa^Fpa, Aa^Fpa, Aa^Fpa, Aa^Fpa, Ha^Fpa, Ha^Fpa, Ha^Fpa, Ai, Ha, Aa^Fpa, Ai, Ai
Mm^Xm, Mm^Xm, Mm^Xm, Xu, Ur, Cud, Cud, Cud, Ha, Ha^Vaa, Ha, Ai, Aa, Aa, Ha, Ha, Ms, Ms, Ha, Ha, Aa, Aa, Gs, Aa^Fpa, Aa^Fpa, Aa, Ha^Fpa, Ha, Ms, Ha, Aa^Fpa, Ai, Aa^Fpa, Aa^Fpa
Mm^Xm, Mm^Xm, Mm^Xm, Xu, Xu, Ms, Ms, Ms, Ha, Ms, Ha, Ms, Ms, Ms, Ha, Ms, Ha, Ha, Ms, Ha, Ha, Gs, Gs^Es, Aa, Aa, Aa, Aa^Fpa, Ha, Ha, Ha, Ha, Ai, Ai, Ai
Mm^Xm, Mm^Xm, Mm^Xm, Mm^Xm, Mm^Xm, Ms, Ms, Ms, Ms, Ms, Ms, Ms, Ms, Ms, Ms, Ms, Ms, Ha, Ha, Ms, Ha, Aa, Aa, Aa, Aa^Fpa, Aa, Aa^Fpa, Aa^Fpa, Ha^Fpa, Aa^Fpa, Ha^Fpa, Aa^Fpa, Aa^Fpa, Aa^Fpa
Mm^Xm, Mm^Xm, Mm^Xm, Mm^Xm, Mm^Xm, Ms, Ms, Ms, Ms, Ms, Ms, Ms, Ms, Ms, Ms, Ms, Ms, Ha, Ha, Ms, Ha, Aa, Aa, Aa, Aa^Fpa, Aa, Aa^Fpa, Aa^Fpa, Ha^Fpa, Ha^Fpa, Ha^Fpa, Aa^Fpa, Aa^Fpa, Aa^Fpa
