Rr, Rr, Uu, Xu, Xu, Xu, Xu, Xu, Xu, Xu, Xu, Xu, Xu, Xu, Xu, Xu, Xu, Xu, Xu, Xu, Xu, Xu, Uu, Rr, Uu, Uu
Rr, Rr, Uu, Xu, Xu, Xu, Xu, Xu, Xu, Xu, Xu, Xu, Xu, Xu, Xu, Xu, Xu, Xu, Xu, Xu, Xu, Xu, Uu, Rr, Uu, Uu
Rr, Rr, Rr, Uu, Xu, Xu, Xu, Xu, Xu, Xu, Xu, Xu, Xu, Xu, Xu, Xu, Xu, Xu, Xu, Xu, Xu, Xu, Uu, Rr, Uu, Uu
Rr, Rr, Rr, Uu, Xu, Xu, Xu, Xu, Xu, Xu, Xu, Xu, Xu, Xu, Xu, Xu, Xu, Xu, Xu, Xu, Uu, Uu, Rr, Rr, Uu, Uu
Uu, Uu, Uu, Rr, Xu, Xu, Xu, Xu, Xu, Xu, Uu, Cud, Uu, Xu, Xu, Xu, Xu, Xu, Uu, Uu, Rr, Rr, Uu, Uu, Xu, Xu
Xu, Xu, Rr, Rr, Xu, Xu, Xu, Xu, Xu, Xu, Uu, Uu, Uu, Xu, Xu, Xu, Xu, Xu, Uu, Rr, Uu, Uu, Uu, Xu, Xu, Xu
Xu, Xu, Rr, Uu, Uu, Xu, Uu, Xu, Uu, Uu, Cud, Uu, Cud, Uu, Uu, Xu, Xu, Uu, Uu^Vud, Rr, Uu^Vud, Uu, Xu, Xu, Xu, Xu
Xu, Uu^Vud, Rr, Uu^Vud, Rr, Uu, Uu^Vud, Uu, Cud, Cud, Uu, Uu, Uu, Cud, Cud, Uu, Uu, Uu, Rr, 1 Rr, Uu, Uu, Xu, Xu, Xu, Xu
Xu, Xu, Uu, Rr, Uu^Vud, Rr, Rr, Cud, Uu, Uu^Vud, Cud, Cud, Cud, Uu^Vud, Uu, Cud, Rr, Rr, Uu^Vud, Uu, Xu, Xu, Xu, Xu, Xu, Xu
Xu, Xu, Xu, Uu, Uu, Uu, Cud, Rr, Cud, Cud, Cud, Kud, Cud, Cud, Cud, Rr, Cud, Uu, Uu, Uh, Xu, Xu, Xu, Xu, Xu, Xu
Xu, Xu, Xu, Uu, Uu, Uu, Cud, Uu, Cud, Kud, Cud, Cud, Cud, Kud, Cud, Uu, Cud, Uu, Xu, Xu, Xu, Xu, Xu, Xu, Xu, Xu
Xu, Xu, Xu, Xu, Uu, Uu, Cud, Uu^Vud, Cud, Cud, Cud, 2 Kud, Cud, Cud, Cud, Uu^Vud, Cud, Uu, Xu, Xu, Xu, Xu, Xu, Xu, Xu, Xu
Xu, Xu, Xu, Uh, Uu, Uu, Cud, Uu, Cud, Kud, Cud, Cud, Cud, Kud, Cud, Uu, Cud, Uu, Xu, Xu, Xu, Xu, Xu, Xu, Xu, Xu
Xu, Xu, Uh, Uh, Uu, Uu, Rr, Rr, Uu, Cud, Cud, Kud, Cud, Cud, Uu, Rr, Rr, Uu^Vud, Uu, Xu, Xu, Xu, Xu, Xu, Xu, Xu
Xu, Xu, Uu, Uu, Rr, Rr, Uu, Cud, Cud, Uu^Vud, Uu, Cud, Uu, Uu^Vud, Cud, Cud, Uu, Rr, Rr, Uu, Xu, Xu, Xu, Xu, Xu, Xu
Uh, Uh, Uu, Uu^Vud, Rr, Uu^Vud, Uu, Uu, Uu, Cud, Cud, Rr, Cud, Cud, Uu, Uu, Uu, Uu^Vud, Rr, Uu, Uu, Xu, Xu, Xu, Xu, Xu
Uu, Uu, Rr, Rr, Uu, Uu, Xu, Uu, Uu, Uu, Uu, Rr, Uu, Uu, Uu, Uu, Uu, Uu, Rr, Uu^Vud, Uu, Uu, Xu, Xu, Xu, Xu
Uu, Uu^Vud, Rr, Uu^Vud, Uh, Xu, Xu, Xu, Xu, Uu, Uu, Rr, Rr, Uu^Vud, Uu, Uu, Xu, Uu, Uu^Vud, Rr, Uu, Uu, Uu, Xu, Xu, Xu
Rr, Rr, Uu^Vud, Uu, Uh, Xu, Xu, Xu, Xu, Uh, Uu, Uu^Vud, Rr, Uu, Uu, Xu, Xu, Uu, Uu, Rr, Rr, Uu, Uu, Xu, Xu, Xu
Uu, Uu, Uh, Uh, Xu, Xu, Xu, Xu, Xu, Uh, Uu, Uu, Rr, Uu^Vud, Uu, Xu, Xu, Uh, Uu, Uu, Rr, Uu, Uu, Uu, Uu, Uu
Uu, Uu, Uh, Uh, Xu, Xu, Xu, Xu, Xu, Xu, Uu, Uu^Vud, Rr, Uu, Uu, Xu, Xu, Xu, Uh, Uu, Uu, Rr, Rr, Rr, Rr, Rr
Uh, Uh, Xu, Xu, Xu, Xu, Xu, Xu, Xu, Xu, Xu, Uu, Uu, Rr, Uu^Vud, Uh, Xu, Xu, Uh, Uh, Uh, Uu, Uu, Uu, Uu, Uu
Xu, Xu, Xu, Xu, Xu, Xu, Xu, Xu, Xu, Xu, Xu, Uu, Uu^Vud, Rr, Rr, Uh, Xu, Xu, Xu, Uh, Xu, Xu, Xu, Xu, Xu, Xu
Xu, Xu, Xu, Xu, Xu, Xu, Xu, Xu, Xu, Xu, Xu, Uh, Uh, Uu, Rr, Uu, Xu, Xu, Xu, Xu, Xu, Xu, Xu, Xu, Xu, Xu
Xu, Xu, Xu, Xu, Xu, Xu, Xu, Xu, Xu, Xu, Xu, Uh, Uh, Uu, Rr, Uu, Xu, Xu, Xu, Xu, Xu, Xu, Xu, Xu, Xu, Xu
Xu, Xu, Xu, Xu, Xu, Xu, Xu, Xu, Xu, Xu, Xu, Uh, Uh, Uu, Rr, Uu, Xu, Xu, Xu, Xu, Xu, Xu, Xu, Xu, Xu, Xu
