border_size=1
usage=map

Ha          ,Ha          , Ha          , Mm          , Mm          , Mm          , Ha          , Mm          , Mm          , Xu          , Uu          , Xu          , Mm          , Mm          , Mm          , Mm          , Mm          , Ha          , Aa^Fpa      , Aa          , Aa          , Aa          , Ha          , Ha     , Mm          , Mm          , Mm          , Ha          , Ha          , Gg          , Aa^Fpa      , Aa^Fpa      , Ha          , Ha          , Mm          , Mm          , Mm          , Ha          , Ha          , Aa          , Aa          , Aa          
Ha          ,Ha          , Ha          , Mm          , Mm          , Mm          , Ha          , Mm          , Mm          , Xu          , Uu          , Xu          , Mm          , Mm          , Mm          , Mm          , Mm          , Ha          , Aa^Fpa      , Aa          , Aa          , Aa          , Ha          , Ha^Vhha     , Mm          , Mm          , Mm          , Ha          , Ha          , Gg          , Aa^Fpa      , Aa^Fpa      , Ha          , Ha          , Mm          , Mm          , Mm          , Ha          , Ha          , Aa          , Aa          , Aa          
Ha          ,Ha          , Mm          , Mm          , Xu          , Mm          , Ha          , Ha          , Mm          , Xu          , Mm          , Re          , Mm          , Mm          , Mm          , Mm          , Aa          , Gg          , Gg          , Gg          , Ha          , Ha          , Mm          , Mm          , Mm          , Mm          , Mm          , Mm          , Mm          , Ha          , Ha          , Ha          , Mm          , Ha          , Mm          , Mm          , Xu          , Mm          , Mm          , Ha          , Ha          , Ha          
Mm          ,Mm          , Mm          , Xu          , Uu          , Xu          , Mm          , Mm          , Mm          , Mm          , Mm          , Re          , Mm          , Mm          , Ha          , Ha          , Ha          , Ha          , Ha          , Ha          , Ha          , Mm          , Ha          , Mm          , Mm          , Mm          , Ha          , Mm          , Ha          , Ha          , Aa          , Ha          , Ha          , Mm          , Mm          , Xu          , Uu          , Xu          , Mm          , Mm          , Mm          , Mm          
Mm          ,Mm          , Mm          , Xu          , Re          , Mm          , Mm          , Ha          , Ha          , Ha          , Re          , Re          , Mm          , Ha          , Ha          , Mm          , Mm          , Mm          , Mm          , Mm          , Ha          , Ha          , 3 Ke        , Ce          , Ha          , Mm          , Ha          , Ha          , Gg          , Gg          , Aa          , Aa          , Ha          , Mm          , Mm          , Mm          , Xu          , Xu          , Mm          , Mm          , Ha          , Ha          
Mm          ,Mm          , Mm          , Mm          , Re          , Mm          , Mm          , Mm          , Ha          , Gg          , Re          , Ha          , Ha          , Mm          , Mm          , Mm          , Mm          , Ha          , Ha          , Ha          , Aa          , Ce          , Ce          , Ce          , Ha          , Mm          , Ha          , Aa          , Aa^Fpa      , Aa^Fpa      , Ha          , Ha          , Mm          , Mm          , Mm          , Mm          , Mm          , Mm          , Ha          , Ha          , Aa          , Aa          
Mm          ,Mm          , Mm          , Mm          , Mm          , Re          , Re          , Mm          , Mm          , Mm          , Ha          , Re          , Gg          , Ha          , Ha^Vhha     , Mm          , Mm          , Ha          , Gg          , Gg          , Aa          , Aa          , Aa^Fpa      , Aa          , Gg          , Ha          , Gg          , Aa          , Aa^Fpa      , Aa^Fpa      , Ha          , Mm          , Mm          , Mm          , Ha          , Ha          , Mm          , Ha          , Ha          , Aa^Vea      , Aa          , Aa          
Mm          ,Mm          , Ha          , Mm          , Ha          , Ha          , Re          , Ha          , Mm          , Ha          , Ha          , Re          , Aa          , Gg          , Gg          , Ha          , Mm          , Ha          , Ha          , Aa          , Aa          , Gg          , Aa^Fpa      , Aa^Fpa      , Aa^Fpa      , Gg          , Aa^Fpa      , Aa^Fpa      , Aa^Fpa      , Aa^Fpa      , Aa^Fpa      , Ha          , Ha          , Ha          , Gg          , Ha          , Ha          , Mm          , Ha          , Aa          , Aa          , Aa          
Ha          ,Ha          , Ha          , Ha          , Gg          , Aa^Fpa      , Re          , Aa^Vea      , Ha          , Mm          , Ha          , Re          , Aa^Fpa      , Aa^Fpa      , Aa^Fpa      , Ha          , Ha          , Ha          , Mm          , Ha          , Ha          , Gg          , Gg          , Aa^Fpa      , Aa^Fpa      , Aa^Fpa      , Aa^Fpa      , Aa^Fpa      , Aa^Fpa      , Aa^Fpa      , Aa^Fpa      , Aa^Vea      , Ha          , Aa          , Aa          , Aa          , Aa          , Ha          , Aa          , Aa^Fpa      , Aa^Fpa      , Aa^Fpa      
Ha          ,Ha          , Mm          , Ha          , Aa          , Aa^Fpa      , Aa^Fpa      , Re          , Re          , Ha          , Re          , Re          , Aa^Fpa      , Aa^Fpa      , Aa^Fpa      , Aa          , Ha          , Ha          , Mm          , Mm          , Mm          , Ha          , Gg          , Gg          , Gg          , Gg          , Aa^Fpa      , Aa^Fpa      , Aa^Fpa      , Gg          , Gg          , Ha          , Mm          , Ha          , Gg          , Ha          , Aa          , Gg          , Aa^Fpa      , Aa^Fpa      , Aa^Fpa      , Aa^Fpa      
Ha          ,Ha          , Mm          , Ha          , Ha          , Aa          , Gg          , Gg          , Ha          , Re          , Re          , Ha          , Gg          , Aa^Fpa      , Gg          , Ha          , Ha          , Mm          , Mm          , Mm          , Mm          , Ha          , Ha          , Gg          , Ha          , Gg          , Gg          , Aa^Fpa      , Gg          , Aa^Fpa      , Ha          , Mm          , Mm          , Ha          , Aa          , Aa          , Aa^Fpa      , Aa^Fpa      , Aa^Fpa      , Aa^Fpa      , Aa^Fpa      , Aa^Fpa      
Ha          ,Ha          , Mm          , Mm          , Mm          , Ha          , Aa^Fpa      , Gg          , Ha          , Mm          , Mm          , Re          , Re          , Aa          , Ha          , Ha          , Mm          , Mm          , Xu          , Xu          , Xu          , Mm          , Mm          , Ha          , Mm          , Ha          , Ha          , Gg          , Ha          , Gg          , Ha          , Mm          , Mm          , Ha          , Aa          , Aa          , Aa          , Aa^Fpa      , Aa^Fpa      , Aa^Fpa      , Aa^Fpa      , Aa^Fpa      
Mm          ,Mm          , Mm          , Mm          , Mm          , Ha          , Aa^Fpa      , Aa^Vea      , Gg          , Ha          , Mm          , Mm          , Mm          , Re          , Re          , Mm          , Uu          , Xu          , Uu          , Uu^Vud      , Uu          , Xu          , Uu          , Mm          , Mm          , Mm          , Mm          , Ha          , Mm          , Ha          , Ha          , Ha          , Ha          , Ha          , Ha          , Aa^Vea      , Gg          , Gg          , Aa^Fpa      , Aa^Fpa      , Aa^Fpa      , Aa^Fpa      
Mm          ,Mm          , Mm          , Mm          , Ha          , Ha          , Gg          , Aa^Fpa      , Aa          , Ha          , Ha          , Mm          , Mm          , Mm          , Xu          , Re          , Re          , Uu          , Uu          , Uu          , Uu          , Uu          , Uu          , Uu          , Xu          , Mm          , Mm          , Mm          , Mm          , Mm          , Ha          , Ha          , Gg          , Ha          , Mm          , Ha          , Ha          , Gg          , Gg          , Gg          , Aa          , Aa          
Mm          ,Mm          , Mm          , Mm          , Mm          , Ha          , Gg          , Aa^Fpa      , Aa          , Aa          , Ha          , Mm          , Mm          , Xu          , Uu^Vud      , Uu          , Uu          , Re          , Re          , Uu^Vud      , Uu          , Uu          , Uu          , Uu          , Uu^Vud      , Xu          , Mm          , Mm          , Mm          , Ha^Vhha     , Ha          , Gg          , Gg          , Ha          , Mm          , Mm          , Ha          , Gg          , Gg          , Aa          , Aa          , Aa          
Mm          ,Mm          , Ha          , Mm          , Mm          , Ha          , Gg          , Ha          , Ha          , Aa          , Gg          , Ha          , Mm          , Xu          , Uu          , Uu          , Uu^Vud      , Uu          , Re          , Re          , Re          , Uu          , Uu^Vud      , Uu          , Uu          , Xu          , Mm          , Mm          , Ha          , Ha          , Gg          , Gg          , Aa          , Ha          , Ha          , Mm          , Mm          , Ha          , Ha          , Ha          , Ha          , Ha          
Ha          ,Ha          , Aa          , Ha          , Ha          , Ha          , Gg          , Ha          , Gg          , Aa          , Aa^Fpa      , Ha          , Ha          , Uu          , Uu          , Uu          , Uu          , Re          , Cud         , Cud         , Cud         , Re          , Re          , Uu          , Re          , Uu          , Re          , Ha          , Gg          , Gg          , Aa^Fpa      , Aa^Fpa      , Aa^Fpa      , Aa          , Ha          , Mm          , Mm          , Mm          , Mm          , Mm          , Mm          , Mm          
Aa          ,Aa          , Aa          , Gg          , Aa          , Aa          , Aa          , Gg          , Aa^Vea      , Aa^Fpa      , Aa^Fpa      , Aa^Fpa      , Mm          , Uu          , Uu          , Uu          , Uu          , Re          , Cud         , 1 Kud       , Cud         , Re          , Uu          , Re          , Uu          , Re          , Mm          , Re          , Re          , Gg          , Aa^Fpa      , Aa^Fpa      , Aa^Fpa      , Aa          , Ha          , Mm          , Mm          , Mm          , Mm          , Mm          , Ha          , Ha          
Aa          ,Aa          , Aa^Fpa      , Aa^Fpa      , Aa^Fpa      , Aa          , Ha          , Ha          , Aa          , Aa          , Ha          , Mm          , Mm          , Xu          , Uu          , Uu          , Uu^Vud      , Re          , Re          , Cud         , Re          , Re          , Uu^Vud      , Uu          , Uu          , Xu          , Mm          , Aa^Fpa      , Gg          , Re          , Re          , Aa^Fpa      , Aa          , Ha          , Mm          , Mm          , Mm          , Mm          , Mm          , Mm          , Aa^Vea      , Aa      
Gg          ,Gg          , Aa^Fpa      , Aa^Fpa      , Aa^Fpa      , Aa          , Ha          , Ha          , Gg          , Aa          , Ha          , Mm          , Mm          , Xu          , Uu^Vud      , Uu          , Re          , Re          , Ai          , Re          , Ai          , Ai          , Ai          , Ai          , Uu^Vud      , Xu          , Mm          , Ha          , Ha          , Gg          , Re          , Aa^Fpa      , Gg          , Ha          , Mm          , Mm          , Mm          , Mm          , Ha          , Ha          , Gg          , Gg          
Gg          ,Gg          , Gg          , Aa^Fpa      , Aa^Fpa      , Aa^Fpa      , Gg          , Gg          , Ha          , Ha          , Mm          , Mm          , Mm          , Xu          , Xu          , Uu          , Re          , Uu          , Ai          , Ai          , Ai          , Ai          , Ai          , Ai          , Xu          , Xu          , Mm          , Mm          , Mm          , Ha          , Re          , Gg          , Gg          , Ha          , Ha          , Ha          , Mm          , Mm          , Ha          , Ha          , Gg          , Gg          
Ha          ,Ha          , Ha          , Gg          , Aa^Fpa      , Aa^Fpa      , Aa^Fpa      , Gg          , Ha          , Ha          , Mm          , Mm          , Mm          , Mm          , Mm          , Xu          , Re          , Uu          , Uu          , Ai          , Ai          , Ai          , Ai          , Xu          , Mm          , Mm          , Mm          , Mm          , Mm          , Ha          , Ha          , Re          , Gg          , Gg          , Aa          , Ha          , Aa^Fpa      , Mm          , Aa^Fpa      , Aa^Fpa      , Aa^Fpa      , Aa^Fpa      
Mm          ,Mm          , Ha          , Gg          , Gg          , Aa^Fpa      , Gg          , Aa^Fpa      , Ha          , Mm          , Mm          , Mm          , Ha          , Mm          , Ha          , Mm          , Re          , Uu          , Xu          , Uu^Vud      , Xu          , Ai          , Ai          , Mm          , Mm          , Mm          , Mm          , Mm          , Mm          , Mm          , Ha          , Re          , Gg          , Aa          , Aa          , Aa^Fpa      , Aa^Fpa      , Ha          , Aa^Fpa      , Aa^Fpa      , Aa^Fpa      , Aa^Fpa      
Mm          ,Mm          , Mm          , Ha          , Aa^Fpa      , Gg          , Ha          , Gg          , Ha          , Ha          , Ha          , Ha          , Ha          , Ha          , Ha          , Re          , Ha          , Mm          , Mm          , Xu          , Mm          , Mm          , Ww          , Ww          , Ha          , Ha          , Ha          , Ha          , Ha          , Mm          , Re          , Re          , Ha          , Aa          , Ha          , Aa^Fpa      , Ha          , Ha          , Ha^Vhha     , Aa^Fpa      , Aa^Fpa      , Aa^Fpa      
Mm          ,Mm          , Mm          , Mm          , Ha          , Ha          , Ha          , Aa^Vea      , Re          , Re          , Re          , Re          , Re          , Re          , Re          , Re          , Gg          , Ha          , Mm          , Mm          , Mm          , Mm          , Ww          , Ww          , Gg          , Gg          , Gg          , Gg          , Gg          , Re          , Gg          , Gg          , Ha          , Ha          , Mm          , Ha          , Mm          , Mm          , Ha          , Aa^Fpa      , Ha          , Ha          
Mm          ,Mm          , Mm          , Mm          , Ha          , Gg          , Ha          , Re          , Ha          , Mm          , Mm          , Ha          , Gg          , Ha          , Ha          , Gg          , Gg          , Ha          , Mm          , Mm          , Ha          , Ha          , Ww          , Ww          , Gg          , Gg          , Ha          , Gg          , Re          , Re          , Gg          , Gg          , Gg          , Ha          , Mm          , Mm          , Mm          , Mm          , Ha          , Ha          , Mm          , Mm          
Mm          ,Mm          , Mm          , Mm          , Ha          , Gg          , Gg          , Re          , Ha          , Mm          , Mm          , Ha          , Ha          , Ha          , Mm          , Ha          , Gg          , Ha          , Ha          , Mm          , Ha          , Ha          , Ww          , Ww          , Gg          , Ha          , Ha          , Re          , Aa^Fpa      , Aa^Fpa      , Aa^Fpa      , Gg          , Ha          , Ha          , Ha          , Mm          , Mm          , Mm          , Mm          , Mm          , Ha          , Ha          
Ha          ,Ha          , Ha          , Ha          , Ha          , Gg          , Ce          , Re          , Ha          , Ha          , Mm          , Mm          , Mm          , Mm          , Mm          , Ha          , Gg          , Gg          , Ha          , Ha          , Ww          , Ww          , Ww          , Aa^Fpa      , Gg          , Ha          , Gg          , Re          , Aa^Fpa      , Aa^Fpa      , Aa^Fpa      , Gg          , Ha          , Ha          , Mm          , Mm          , Mm          , Mm          , Mm          , Mm          , Ha          , Ha          
Gg          ,Gg          , Gg          , Gg          , Gg          , Ce          , 2 Ke        , Ce          , Ha          , Mm          , Mm          , Mm          , Mm          , Mm          , Ha          , Ha          , Gg          , Gg          , Gg          , Gg          , Ww          , Ww          , Aa^Fpa      , Aa^Fpa      , Aa^Fpa      , Gg          , Gg          , Re          , Gg          , Aa^Fpa      , Aa^Fpa      , Aa^Fpa      , Ha          , Mm          , Mm          , Mm          , Mm          , Mm          , Mm          , Mm          , Ha          , Ha          
Gg          ,Gg          , Aa^Fpa      , Gg          , Re          , Ce          , Ha          , Ce          , Ha          , Mm          , Mm          , Mm          , Mm          , Mm          , Ha          , Ha          , Gg          , Gg          , Gg          , Gg          , Ww          , Ww          , Ww          , Aa^Fpa      , Aa^Fpa      , Aa^Fpa      , Gg          , Re          , Re          , Gg          , Gg          , Ce          , Ce          , Mm          , Ha          , Mm          , Mm          , Mm          , Mm          , Ha          , Ha          , Ha          
Aa^Fpa      ,Aa^Fpa      , Aa^Fpa      , Re          , Ha          , Ha          , Mm          , Ha          , Ha^Vhha     , Ha          , Ha          , Ha          , Ha          , Mm          , Ha          , Ha          , Ha          , Ha          , Gg          , Gg          , Aa^Fpa      , Ww          , Ww          , Aa^Fpa      , Aa          , Aa          , Aa          , Gg          , Gg          , Re          , Ce          , 4 Ke        , Aa^Fpa      , Ha^Vhha     , Gg          , Ha          , Ha          , Mm          , Mm          , Mm          , Ha          , Ha          
Aa^Fpa      ,Aa^Fpa      , Aa^Fpa      , Re          , Ha          , Ha          , Mm          , Mm          , Mm          , Ha          , Mm          , Mm          , Ha          , Ha          , Mm          , Ha^Vhha     , Mm          , Ha          , Gg          , Gg          , Ai          , Ai          , Ww          , Ai          , Ai          , Aa          , Gg          , Aa          , Gg          , Re          , Gg          , Ce          , Aa^Fpa      , Aa^Fpa      , Gg          , Gg          , Ha          , Mm          , Ha          , Ha          , Aa^Vea      , Aa      
Aa^Fpa      ,Aa^Fpa      , Re          , Re          , Gg          , Ha          , Mm          , Mm          , Mm          , Ha          , Ha          , Ha          , Mm          , Ha          , Mm          , Mm          , Ha          , Ha          , Aa          , Gg          , Ai          , Ai          , Ai          , Ww          , Ai          , Aa          , Aa          , Aa          , Gg          , Re          , Re          , Gg          , Gg          , Gg          , Aa          , Gg          , Gg          , Ha          , Gg          , Gg          , Aa^Fpa      , Aa^Fpa      
Re          ,Re          , Gg          , Gg          , Ha          , Ha^Vhha     , Ha          , Mm          , Mm          , Mm          , Mm          , Mm          , Mm          , Mm          , Mm          , Ha          , Aa          , Aa          , Aa^Fpa      , Gg          , Gg          , Ai          , Ai          , Ww          , Ha          , Ha          , Mm          , Aa          , Gg          , Gg          , Re          , Gg          , Aa          , Aa          , Aa          , Aa          , Gg          , Gg          , Aa^Fpa      , Aa^Fpa      , Aa^Fpa      , Aa^Fpa      
Gg          ,Gg          , Gg          , Gg          , Ha          , Ha          , Ha          , Ha          , Mm          , Mm          , Mm          , Mm          , Mm          , Mm          , Mm          , Ha          , Aa          , Aa          , Aa^Fpa      , Aa^Fpa      , Gg          , Aa          , Aa          , Ww          , Ww          , Mm          , Mm          , Ha          , Gg^Ve       , Gg          , Re          , Gg          , Gg          , Aa^Vea      , Aa          , Aa          , Aa          , Gg          , Gg          , Aa^Fpa      , Aa^Fpa      , Aa^Fpa      
Gg          ,Gg          , Gg          , Ha          , Ha          , Ha          , Mm          , Mm          , Mm          , Mm          , Mm          , Mm          , Mm          , Mm          , Ha          , Ha          , Aa          , Aa^Fpa      , Aa^Fpa      , Aa^Fpa      , Gg          , Aa          , Ww          , Ww          , Ww          , Mm          , Mm          , Ha          , Gg          , Gg          , Gg          , Re          , Gg          , Gg          , Gg          , Aa          , Aa          , Aa          , Aa^Fpa      , Gg          , Gg          , Gg          
Aa^Fpa      ,Aa^Fpa      , Gg          , Ha          , Ha          , Mm          , Mm          , Mm          , Mm          , Mm          , Ha          , Mm          , Mm          , Mm          , Mm          , Ha          , Ha          , Aa^Fpa      , Aa^Fpa      , Aa^Fpa      , Gg          , Ww          , Ww          , Ww          , Ha          , Mm          , Ha          , Gg          , Aa^Fpa      , Aa^Fpa      , Gg          , Re          , Gg          , Gg          , Gg          , Gg          , Gg          , Gg          , Aa^Fpa      , Gg          , Gg^Ve       , Gg       
Aa^Fpa      ,Aa^Fpa      , Gg          , Gg          , Ha          , Mm          , Mm          , Mm          , Ha          , Mm          , Ha          , Ha          , Ha          , Mm          , Mm          , Mm          , Ha          , Aa          , Aa^Fpa      , Aa^Fpa      , Gg          , Ww          , Ai          , Gg          , Gg          , Ha          , Gg          , Gg          , Gg          , Aa^Fpa      , Re          , Re          , Gg          , Gg          , Gg          , Gg          , Aa^Fpa      , Gg          , Aa          , Aa          , Gg          , Gg          
Aa^Fpa      ,Aa^Fpa      , Aa^Fpa      , Ha          , Mm          , Mm          , Mm          , Ha          , Ha^Vhha     , Ha          , Ha          , Ha          , Ha          , Mm          , Mm          , Mm          , Mm          , Ha          , Gg          , Gg          , Ww          , Ww          , Ai          , Ai          , Gg          , Gg          , Aa          , Aa          , Aa          , Gg          , Re          , Gg          , Gg          , Gg          , Gg          , Gg          , Aa^Fpa      , Aa^Fpa      , Aa          , Aa          , Aa          , Aa          
Aa^Fpa      ,Aa^Fpa      , Aa^Fpa      , Ha          , Mm          , Mm          , Mm          , Ha          , Ha     , Ha          , Ha          , Ha          , Ha          , Mm          , Mm          , Mm          , Mm          , Ha          , Gg          , Gg          , Ww          , Ww          , Ai          , Ai          , Gg          , Gg          , Aa          , Aa          , Aa          , Gg          , Re          , Gg          , Gg          , Gg          , Gg          , Gg          , Aa^Fpa      , Aa^Fpa      , Aa          , Aa          , Aa          , Aa          
