Gd, Aa, Aa^Fda, Aa^Fda, Aa, Aa, Aa, Ha, Ms, Ms, Ms, Ms, Xu, Xu, Xu, Xu, Xu, Xu, Xu, Ms, Ha, Ha, Ha, Ha, Ha, Aa, Ha, Ha, Ms, Ha, Ha, Aa, Aa, Aa
Aa, Aa^Fpa, Aa^Fpa, Ha, Aa, Aa, Ha, Ha, Ms, Ms, Ms, Xu, Xu, Xu, Xu, Xu, Xu, Xu, Xu, Xu, Xu, Xu, Xu, Ms, Xu, Ms, Ms, Ms, Ms, Ms, Ha, Ha, Ha, Aa
Aa, Aa^Fma, Aa^Fma, Ha, Ha, Ha, Ha, Ha, Ms, Ms, Xu, Xu, Xu, Xu, Xu, Xu, Xu, Xu, Xu, Xu, Xu, Xu, Xu, Xu, Xu, Xu, Xu, Xu, Ms, Ms, Ms, Ha, Ha, Aa
Aa, Aa^Fda, Aa^Fda, Aa^Fda, Ha, Ha, Ms, Ms, Ms, Xu, Xu, Xu, Uh, Xu, Xu, Xu, Xuc, Xuc, Uh, Xu, Xu, Xu, Xu, Xu, Xu, Xu, Xu, Xu, Xu, Ms, Ha, Ha, Ms, Ha
Aa^Fpa, Aa, Gd, Aa, Ha, Ha, Xu, Ms, Xu, Xu, Xu, Uh, Uh, Uh, Uu^Tf, Xuc, Uu^Edt, Uu, Xu, Uh, Uu, Xu, Xu, Xu, Xu, Xu, Xu, Xu, Xu, Ms, Ha, Ha, Ms, Ms
Aa^Fda, Aa^Fda, Gd, Aa, Gd, Xu, Xu, Xu, Xu, Xu, Cud, Cud, Rb, Tb^Tf, Uu, Uu^Em, Rb^Edt, Uu^Edt, Rb^Em, Xuc, Uu, Uu^Vu, Xuc, Xu, Xu, Xu, Xu, Xu, Xu, Xu, Xu, Xu, Xu, Ha
Ha, Gd, Aa^Fpa, Gd, Xu, Xu, Xuc, Xuc, Uu, Ce, Cud, Rb, Cud, Cud, Uu^Edt, Rb^Edt, Uu^Edt, Rb^Edt, Xu, Rb^Em, Uu^Tf, Uu, Uu, Uh, Uh, Xu, Xu, Xu, Xu, Xu, Xu, Xu, Xu, Ha
Ha, Ha, Ha, Aa^Fpa, Xu, Xu, Uh, Uh, Rb, Rb, Uu, Cud, Kud, Cud, Uu, Uu^Edt, Uu^Edt, Xuc, Xu, Xu, Tb^Tf, Uu, Uu, Uh, Uh, Xu, Xu, Xu, Xu, Xu, Xu, Xu, Xu, Ha
Ha, Ms, Ha, Ms, Xu, Xu, Uh, Uu, 1 Rb, Uu, Uu, Uu, Cud, Cud, Uu, Uu, Uu, Uu, Uu, Xuc, Uu^Vu, Uu, Rb^Em, Uu^Tf, Uh, Xu, Xu, Xu, Xu, Xu, Xu, Xu, Xu, Xu
Aa, Aa, Cea, Ms, Xu, Xu, Uu, Uu, Uu, Uu, Uu, Ce, Cud, Uh, Uh, Uh, Xu, Uu, Uh, Uu, Uu, Xu, Rb^Em, Tb^Tf, Uu^Tf, Tb^Tf, Uh, Xu, Xu, Xu, Xu, Xu, Xu, Xu
Aa, Cea, 2 Kea, Cea, Xu, Xu, Uu, Uu, Uh, Xom, Xu, Ce, Xu, Cud, Xu, Xu, Xu, Xu, Xu, Uh, Uu, Ur, Uu, Uu, Xu, Uu, Uh, Xu, Xu, Xu, Xu, Xu, Xu, Xu
Gd, Cea, Cea, Xu, Uu^Vud, Uu, Rb, Uu, Uh, Xu, Xu, Xu, Xu, Xu, Xu, Xu, Xu, Xu, Xuc, Uu^Em, Uu, Ur^Edt, Uu^Tf, Uu, Uu, Xu, Uu, Xu, Xu, Xu, Xu, Xu, Xu, Xu
Aa, Cea, Cea, Xu, Uu, Uu, Rb, Uu, Xu, Xu, Xu, Xu, Xu, Xu, Xu, Xu, Uh, Xu, Uu, Uu, Uh, Uh, Xu, Xu, Xu, Uu, Xu, Qxu, Qxu, Xu, Xuc, Xu, Xu, Xu
Gd, Aa, Cea, Uu, Re, Rb, Uh, Xu, Xu, Xu, Xu, Xu, Xu, Xu, Uh, Uh, Ur, Uu, Uu^Tf, Uu^Tf, Tb^Tf, Uh, Xu, Xu, Xuc, Xu, Uh, Uu^Tf, Uu^Tf, Tb^Tf, Uh, Xuc, Xu, Xu
Gd, Cea, Cea, Re, Uu^Vud, Uu, Xu, Xu, Xoa, Xu, Ql, Ql, Ql, Ql, Uu^Edb, Ur, Uu, Uu, Uu, Uu^Vu, Xu, Xu, Xu, Xuc, Uu, Uh, Uu, Uu^Em, Uu, Uu^Em, Uu^Em, Uh, Xu, Xu
Aa, Aa, Ha, Ha, Xu, Xu, Xoa, Xoa, Cud, Xu, Ql, Uh, Ql, Ql, Uu^Edb, Ur^Edb, Uh, Uh, Xu, Xu, Xu, Xu, Uh, Uh, Rb^Es, Rb, Uu, Ur, Ur^Es, Xu, Uu, Uu^Em, Xu, Xu
Aa^Fpa, Aa^Fpa, Xu, Xu, Xu, Xoa^Efs, Cud, Cud, Uu, Ql, Ql, Ql, Ql, Uu, Uu, Uu, Uh, Xu, Xu, Xu, Xu, Xu, Uh, Uh, Uu, Uh, Xu, Xu, Rd, Uu^Es, Uh, Uh, Xu, Xu
Ha, Ha^Fma, Xu, Xu, Uu, Cud, Uu^Vu, Uu, Ql, Ql, Xu, Xu, Xu, Xu, Uh, Uu, Uu, Uu^Vu, Xuc, Xu, Xu, Tb^Tf, Uu^Tf, Uu, Ql, Xu, Xu, Ql, Uu^Vu, Uu, Uh, Uh, Xu, Xu
Ha, Xu, Xu, Ql, Uu, Cud, Cud, Uu, Cud, Ql, Isa, Xoa, Xu, Xu, Uh, Uu, Uu^Edb, Ur, Ur, Ur, Ur, Uu^Tf, Uu, Uu, Xu, Xu, Ql, Ql, Uu, Uu, Uh, Xu, Xu, Xu
Ha, Ha, Xu, Xu, Uu, 3 Kud, Cud, Cud, Ql, Ql, Isa, Isa^Ebn, Xoa, Xu, Xu, Uu^Vu, Uu^Edb, Uu^Edb, Uh, Uu, Uu^Tf, Uu, Uu^Vu, Ql, Xu, Xu, Uh, Uh, Uu, Uu, Ql, Ql, Xu, Xu
Ha, Ms, Xu, Xu, Cud, Cud, Ql, Ql, Ql, Ql, Ql, Isa, Xu, Xu, Ql, Ql, Ql, Uu^Edb, Uh, Tb^Tf, Uh, Uu^Tf, Xu, Xu, Ql, Ql, Rd^Es, Uu^Tf, Uh, Xu, Xu, Xu, Xu, Xu
Ms, Ms, Xu, Xu, Xoa, Cud, Ql, Ql, Ql, Ql, Ql, Uu, Xu, Xu, Ql, Xu, Xu, Xu, Xu, Xu, Xu, Xu, Xu, Xu, Ql, Xu, Rd, Uh, Ql, Xu, Xu, Xu, Xu, Xu
Ha, Xu, Xu, Xoa^Efs, Cud, Cud, Cud, Uu, Xu, Ql, Ql, Ql, Xu, Xu, Ql, Xu, Xuc, Xu, Xu, Xu, Xu, Xu, Xuc, Xu, Uu, Rd, Uh, Uh, Xu, Xu, Xu, Xu, Ha^Fma, Xu
Aa, Xu, Xu, Xu, Xu, Xu, Xu, Xu, Xoa, Xu, Ql, Ql, Uh, Uh, Uu^Edt, Uu, Uu, Uh^Vu, Uh, Xu, Uu^Tf, Tb^Tf, Uu, Uu^Em, Uu^Tf, Uu, Uu^Tf, Xu, Xu, Xu, Xu, Ha^Fda, Ha^Fda, Ha
Aa, Ha^Fpa, Ha^Fpa, Xu, Xu, Xu, Xu, Xoa, Isa, Xu, Uu, Ql, Ql, Uu^Vu, Urb^Edt, Urb^Edt, Cud, Uh, Uu, Xuc, Cer, Uu^Em, Uu, Uh, Uh, Tb^Tf, Xuc, Xu, Xu, Xu, Ha, Ha^Fda, Ha, Ha
Ha, Ha, Ha, Xu, Xu, Xu, Xu, Xu, Uu, Uu, Uu, Uu, Ql, Uu, Urb, Ql, Urb, Ql, Uu, Ker, Ce, Uu, Uh, Uh, Wwg, Wwg, Xu, Xu, Xu, Xu, Aa^Fda, Aa, Aa^Fma, Aa^Fpa
Aa, Aa, Aa^Fpa, Ha^Fpa, Ha, Ha, Ha, Xu, Xu, Isa, Xu, Xu, Xu, Ql, Urb, Cud, Ql, Cud, Uh, Uu^Dr, Xuc, Uu, Xu, Xu, Xu, Xu, Xu, Xu, Ha, Aa, Aa^Fda, Aa, Aa, Aa^Fpa
Aa, Aa^Fpa, Aa^Fpa, Ha, Ms, Ms, Ms, Ha, Xu, Xu, Xu, Xu, Xu, Ql, Uh, Urb, Urb^Vu, Uu, Uh, Ql, Xu, Xu, Xu, Xu, Xu, Xu, Ha^Fma, Ha^Fma, Aa^Fda, Aa, Ha^Fpa, Ha^Fda, Aa^Fda, Ha
Ha^Fpa, Ha, Ms, Ha^Fda, Ha, Ha^Fpa, Ms, Ha, Xu, Xu, Xu, Xu, Ql, Uh, Uh, Urb, Ql, Ql, Ql, Ql, Xu, Xu, Xu, Xu, Xu, Ha, Aa^Fma, Aa^Fma, Aa^Fda, Aa^Fpa, Ms, Ms, Ha, Ms
Aa, Ha, Ha, Ms, Ha^Fpa, Ms, Ms, Ms, Xu, Xu, Xu, Xu, Ql, Uh, Uu, Ql, Xu, Xu, Xu, Xu, Xu, Xu, Xu, Xu, Xu, Ms, Ms, Ms, Aa^Fda, Ms, Ms, Ms, Ha, Ms
Aa, Aa^Fda, Aa^Fda, Ha^Fda, Ms, Ms, Ms, Ms, Xu, Xu, Xu, Xu, Xu, Uu, Uu, Xu, Xu, Xu, Xu, Xu, Xu, Xu, Xu, Xu, Ha, Ms, Ha^Fpa, Aa^Fda, Ms, Ms, Ms, Ms, Ms, Ha
Ha, Aa^Fda, Ha, Ms, Ms, Ms, Ms, Ms, Xu, Xu, Xu, Xu, Xu, Uu, Uu, Xu, Xu, Xu, Xu, Xu, Xu, Xu, Xu, Xu, Ha, Ha, Ms, Ms, Aa^Fpa, Ms, Aa^Fpa, Ha^Fpa, Aa^Fpa, Ms
