border_size=1
usage=map

Wot         , Wot         , Wot         , Wot         , Wwt         , Ds          , Hd          , Hd          , Hd          , Hd          , Hd          , Hd          , Hd          , Hd          , Hd          , Hd          , Md          , Md          , Md          , Hd          , Hd          , Dd          , Dd          , Dd          , Dd          , Dd          , Dd          , Dd          , Dd          , Dd          , Dd          , Dd          , Dd          , Dd          , Dd          , Dd          , Dd          , Dd          , Md          , Md          , Md          , Md          , Md          , Md          , Md          
Wot         , Wot         , Wot         , Wot         , Wwt         , Ds          , Ds          , Dd^Vdt      , Hd          , Hd          , Hd          , Hd          , Hd          , Hd          , Wwt         , Hd          , Hd          , Md          , Hd          , Hd          , Dd          , Dd          , Ds          , Ds          , Ds          , Dd          , Ds          , Dd          , Dd          , Dd          , Dd          , Dd          , Hd          , Hd          , Wwt         , Hd          , Dd          , Dd^Vda      , Dd          , Hd          , Hd          , Hd          , Hd          , Md          , Md          
Wwt         , Wot         , Wwt         , Wwt         , Wwt         , Wwt         , Dd          , Hd          , Hd          , Hd          , Dd^Do       , Hd          , Hd          , Hd          , Hd          , Hd          , Dd          , Dd^Vda      , Dd          , Dd          , Wwt         , Wwt         , Wwt         , Wwt         , Wwt         , Ds          , Wwt         , Ds          , Ds          , Dd^Vdt      , Ds          , Dd          , Dd          , Dd          , Dd          , Dd          , Ds          , Dd          , Dd          , Dd          , Dd          , Dd          , Hd          , Hd          , Md          
Ds          , Wwt         , Wwt         , Wwt         , Wwt         , Wwt         , Wwt         , Dd          , Dd          , Dd          , Dd          , Gs          , Dd          , Hd          , Dd          , Dd          , Wwt         , Dd^Do       , Wwt         , Wwt         , Wwt         , Wwt         , Wwt         , Wwt         , Wwt         , Wwt         , Wwt         , Wwf         , Wwf         , Ds          , Ds          , Ds          , Ds          , Dd          , Dd          , Dd          , 4 Dd        , Dd          , Dd          , Dd          , Dd^Dc       , Dd          , Dd          , Dd          , Ds          
Ds          , Ds          , Dd          , Dd^Vda      , Ds          , Wwt         , Wwt         , Wwt         , Wwt         , Wwt         , Wwt         , Wwt         , Wwt         , Dd          , Dd          , Wwt         , Wwt         , Wwt         , Wwt         , Wwt         , Wwt         , Wwt         , Wwt         , Wwt         , Wwr         , Wwt         , Wwf         , Wwf         , Wwf         , Wwt         , Wwt         , Wwt         , Wwt         , Ds          , Ds          , Dd          , Dd^Vdt      , Dd          , Dd          , Dd          , Dd          , Dd          , Ds          , Dd^Vdt      , Dd          
Dd          , Hd          , Dd          , Dd          , Ds          , Wwt         , Wwt         , Wwt         , Wwt         , Wwt         , Wwt         , Wwt         , Wwt         , Wwt         , Wwf         , Wwf         , Wwf         , Wwt         , Wwt         , Wwt         , Wwt         , Wwt         , Wwt         , Wwt         , Wwr         , Wwr         , Wwr         , Wwr         , Wwt         , Wwt         , Wwt         , Wwt         , Wwt         , Wwt         , Ds          , Dd          , Ds          , Dd          , Dd          , Dd          , Dd          , Dd          , Gs          , Hd          , Dd          
Md          , Dd^Do       , Gs          , Gs          , Ds          , Wwt         , Wwt         , Wwt         , Wwt         , Wwf         , Wwf         , Wwt         , Wwt         , Wwt         , Wwf         , Wwf         , Wwr         , Wwt         , Wwt         , Ww^Vm       , Wwt         , Ww^Vm       , Wwt         , Wwt         , Wwf         , Ww          , Ww          , Wwr         , Ds          , Wwt         , Wwt         , Ww^Vm       , Wwt         , Wwt         , Wwt         , Ds          , Ds          , Dd          , Wwt         , Wwt         , Gs          , Dd          , Md          , Dd^Do       , Dd          
Md          , Md          , Dd          , Dd          , Dd          , Wwt         , Wwt         , Wwr         , Wwr         , Wwt         , Wwt         , Wwt         , Wwt         , Wwt         , Wwt         , Wwr         , Wwr         , Wwt         , Wwt         , Wwt         , Wwt         , Wwt         , Wwt         , Wwt         , Wwf         , Ww          , Ww          , Ww          , Ds          , Ds          , Wwt         , Wwf         , Wwt         , Wwt         , Wwt         , Ds          , Dd          , Ds          , Wwt         , Wwt         , Wwt         , Hd          , Md          , Md          , Dd          
Md          , Md          , Md          , Wwt         , Wwt         , Ds          , Wwt         , Wwt         , Wwr         , Wwt         , Ds          , Wwf         , Wwf         , Wwt         , Wwt         , Wwr         , Wwt         , Wwt         , Ds          , Ds          , Wwt         , Wwt         , Wwt         , Wwt         , Wwf         , Wwf         , Wwf         , Wwf         , Wwt         , Wwt         , Wwt         , Wwt         , Wwf         , Wwt         , Wwf         , Ds          , Gg          , Ds          , Dd^Vda      , Gs^Ft       , Ds          , Hd          , Ds          , Hd          , Md          
Md          , Hd          , Dd          , Dd          , Dd          , Wwt         , Wwt         , Wwr         , Wwt         , Ds          , Ds          , Wwf         , Wwf         , Wwf         , Ww^Vm       , Wwt         , Ds          , Ds          , Chw         , Chw         , 1 Khw       , Chw         , Chw         , Wwt         , Wwt         , Wwt         , Ww^Vm       , Wwt         , Wwt         , Wwt         , Wwt         , Wwt         , Wwt         , Wwf         , Wwf         , Gg          , Gs          , Ds          , Gg          , Ds          , Ds          , Ds          , Md          , Hd          , Dd          
Hd          , Hd          , Dd          , Dd^Do       , Dd          , Wwt         , Wwt         , Wwr         , Wwt         , Wwt         , Wwt         , Wwf         , Wwt         , Wwt         , Wwt         , Wwt         , Wwt         , Ds          , Ds          , Chw         , Wwt         , Chw         , Wwt         , Wwt         , Wwt         , Wwt         , Wwt         , Wwt         , Wwt         , Wwt         , Wwt         , Wwt         , Wwt         , Wwt         , Wwt         , Ds          , Ds          , Gs          , Ds          , Gg          , Ds          , Hd          , Hd          , Hd          , Dd          
Dd          , Dd          , Gs          , Dd^Vdt      , Ds          , Wwt         , Wwf         , Wwr         , Wwt         , Wwt         , Wwt         , Wwt         , Wwt         , Wwt         , Wwt         , Wwt         , Wwt         , Wwt         , Ds          , Ds          , Ds          , Wwt         , Wwt         , Wwt         , Wwt         , Wwt         , Wwt         , Wwt         , Wwt         , Wwt         , Wwt         , Wwt         , Wwt         , Wwt         , Wwt         , Ds          , Ds          , Gs          , Gs          , Gs          , Ds          , Ds          , Gs^Ft       , Dd          , Gs          
Wwt         , Gs          , Gs          , Gs          , Ds          , Ds          , Wwt         , Wwt         , Wwt         , Wwt         , Wwt         , Wwt         , Wwt         , Wwt         , Wwt         , Wwt         , Wwt         , Wwt         , Wwt         , Wwt         , Wwt         , Wwt         , Wwt         , Wwt         , Wwt         , Wwt         , Wwr         , Wwt         , Wwt         , Wwt         , Wwf         , Wwf         , Wwf         , Wwt         , Wwf         , Ds          , Ds          , Ds          , Ds          , Gs          , Ds          , Ds          , Gs^Ft       , Gs^Ft       , Hh          
Gs^Ft       , Wwt         , Wwt^Bw|     , Gg          , Gg          , Ds          , Wwt         , Wwt         , Wwt         , Wwt         , Wwt         , Wwt         , Wwr         , Wwr         , Wwr         , Wwt         , Wwt         , Wwt         , Wwt         , Ww^Vm       , Wwt         , Ww^Vm       , Wwt         , Wwt         , Wwr         , Wwr         , Wwr         , Wwr         , Wwr         , Wwf         , Wwf         , Ww          , Ss^Vm       , Wwf         , Gg          , Gs          , Gs          , Gs          , Gs          , Gs^Ft       , Gs          , Gs          , Ss^Vhs      , Hh          , Hh          
Gs^Ft       , Gs^Ft       , Gg^Efm      , Wwt         , Wwt         , Wwt         , Ds          , Wwt         , Wwt         , Wwt         , Wwt         , Wwt         , Wwt         , Wwr         , Wwt         , Wwt         , Wwt         , Wwt         , Wwf         , Wwf         , Wwf         , Wwt         , Wwt         , Wwt         , Wwt         , Wwt         , Wwt         , Wwf         , Wwf         , Wwf         , Ww          , Wwf         , Ss          , Ss          , Gg^Efm      , Gg          , Gg          , Gg          , Hh^Fms      , Gs          , Hh          , Hh          , Mm          , Mm          , Mm          
Gs^Ft       , Gs^Ft       , Ss          , Gg^Vc       , Wwt         , Gg          , Gs          , Ds          , Wwt         , Wwt         , Wwt         , Wwt         , Wwr         , Wwr         , Wwr         , Wwr         , Wwf         , Wwf         , Wwt         , Wwt         , Wwt         , Wwt         , Wwt         , Wwt         , Wwt         , Wwt         , Wwf         , Wwt         , Wwf         , Wwf         , Wwf         , Ss          , Ss          , Gg^Efm      , Gg          , Gg^Efm      , Hh          , Hh^Fp       , Hh          , Hh          , Wwt         , Hh          , Mm          , Mm          , Mm          
Gs^Ft       , Gs^Ft       , Gs^Ft       , Wwt         , Gs^Ft       , Gs          , Gs          , Ds          , Wwt         , Ww^Vm       , Wwt         , Wwt         , Wwt         , Wwr         , Wwt         , Wwt         , Wwt         , Wwf         , Wwt         , Wwt         , Wwt         , Ds          , Ds^Es       , Ds          , Wwt         , Wwf         , Wwf         , Wwf         , Wwf         , Wwf         , Wwf         , Wwt         , Wwt         , Gg^Efm      , Gg          , Gg^Vc       , Hh          , Hh          , Wwt         , Wwt         , Hh          , Wwt         , Mm          , Mm          , Mm          
Gs^Ft       , Gs^Ft       , Gs^Ft       , Gs          , Gs^Ft       , Gs          , Gs^Ft       , Gs^Ft       , Ds          , Wwt         , Wwf         , Wwf         , Wwf         , Wwt         , Wwt         , Wwt         , Wwt         , Wwt         , Wwt         , Wwt         , Wwt         , Ds          , Wwt         , Wwt         , Wwt         , Wwt         , Wwt         , Wwt         , Ds          , Wwf         , Ss          , Ss          , Gg          , Wwt         , Wwt         , Wwt         , Wwt         , Wwt         , Hh          , Hh          , Hh          , Mm          , Mm          , Mm          , Mm          
Gs^Ft       , Gs^Ft       , Wwt         , Wwt         , Gs^Ft       , Gs^Ft       , Gs^Ft       , Ss          , Gs          , Gs          , Gs^Ft       , Wwf         , Wwf         , Wwf         , Wwf         , Wwf         , Wwt         , Wwt         , Wwt         , Wwt         , Wwt         , Wwt         , Wwt         , Wwt         , Wwt         , Wwt         , Wwt         , Ss          , Gg          , Gg          , Gg          , Gg          , Hh          , Hh^Fp       , Hh          , Gg^Efm      , Hh          , Hh          , Hh^Fp       , Hh          , Hh          , Mm          , Mm          , Mm          , Mm          
Gs^Ft       , Gs^Ft       , Ss^Vhs      , Gg          , Gs^Ft       , Gs          , Ss          , Ss          , Gs^Ft       , Gs^Ft       , Gs^Ft       , Gs          , Gs          , Wwf         , Ds          , Wwf         , Wwt         , Wwt         , Ds          , Wwt         , Wwt         , Wwt         , Wwt         , Wwt         , Wwt         , Wwt         , Wwt         , Ss          , Ss          , Hh          , Hh          , Hh          , Hh^Fms      , Hh^Fp       , Hh          , Hh          , Hh          , Hh^Fp       , Hh^Fms      , Hh          , Mm          , Mm          , Mm          , Ha^Vhha     , Mm          
Gs^Ft       , Gs^Ft       , Ss          , Ss^Bw\      , Gs^Ft       , Ss          , Ss          , Gs^Ft       , Gs^Ft       , Gs^Ft       , Gs          , Gs^Ft       , Gs          , Gs          , Gs          , Ds          , Dd          , Ds          , Dd          , Ds          , Ds          , Ds          , Ds          , Ds          , Ss          , Wwt         , Wwt         , Wwt         , Wwt         , Ss          , Hh          , Hh^Fp       , Hh          , Hh          , Wwt         , Ss^Vm       , Hh          , Hh^Fp       , Hh          , Hh          , Hh          , Mm          , Mm^Xm       , Mm          , Mm          
Gs^Ft       , Gs^Ft       , Ss          , Ss^Bw|      , Gs^Ft       , Chs         , Ss          , Gs^Ft       , Gs^Ft       , Gs          , Gs          , Gs^Ft       , Ss^Bw/      , Gs          , Gg          , Gg          , Gg^Efm      , Dd          , Dd^Do       , Dd          , Gs          , Ds^Edpp     , Gs          , Gs          , Ss          , Ss          , Ss          , Ss          , Ss          , Wwt         , Wwt         , Gg          , Wwt         , Gg^Efm      , Wwt         , Wwt         , Wwt         , Hh          , Hh          , Hh          , Mm          , Mm          , Mm          , Mm          , Mm          
Gs^Ft       , Gs^Ft       , Ss          , Ss^Bw|      , Ss          , Ss          , Gs^Ft       , Gs^Ft       , Gs^Ft       , Gs^Ft       , Ss^Bw|      , Ss^Bw/      , Ss          , Gs^Ft       , Gs^Ft       , Gs^Ft       , Ss          , Ss          , Gs^Ft       , Gg          , Gs^Ft       , Gs          , Gs          , Gg^Efm      , Gg^Efm      , Ss          , Ss          , Ss^Vm       , Ss          , Ss          , Ss          , Wwt         , Ss          , Wwt         , Ss          , Ss          , Hh          , Wwt         , Hh          , Mm          , Mm          , Mm          , Mm          , Mm          , Mm          
Gs^Ft       , Gs^Ft       , Gs^Ft       , Chr         , Chr         , Ss          , Ss          , Gs^Ft       , Gs^Ft       , Gs^Ft       , Ss^Bw|      , Ss          , Ss          , Ss          , Ss          , Ss^Vm       , Ss          , Gs^Ft       , Gs^Ft       , Gs^Ft       , Gs^Ft       , Gs^Ft       , Gs^Ft       , Gs          , Gs          , Gg^Efm      , Gg^Efm      , Ss          , Hh          , Hh          , Gg^Efm      , Wwt         , Ss          , Cud         , Cud         , Cud         , Gg          , Wwt         , Wwt         , Mm          , Mm^Xm       , Mm          , Mm          , Mm          , Mm          
Gs^Ft       , Gs^Ft       , Gs^Ft       , Chr         , 3 Khr       , Chs         , Ss^Bw\      , Ss          , Ss          , Ss          , Ss^Bw/      , Ss          , Ss          , Ss          , Ss          , Ss          , Ss          , Gs^Ft       , Gs^Ft       , Gs^Ft       , Gs^Ft       , Gs^Ft       , Gs^Ft       , Wwt         , Wwt         , Gs          , Gg          , Hh^Fp       , Hh          , Gg          , Wwt         , Wwt         , Gg          , Cud         , Qxe         , 2 Kud       , Hh          , Mm          , Mm          , Mm          , Mm          , Mm          , Mm          , Mm          , Mm^Xm       
Gs^Ft       , Gs^Ft       , Gs^Ft       , Ss          , Chr         , Chs         , Gs^Ft       , Ss^Bw\      , Ss^Bw\      , Ss^Bw/      , Ss          , Ss^Bw\      , Wwt         , Ww^Vm       , Ss          , Ss          , Gs^Ft       , Gs^Ft       , Ss          , Gs^Ft       , Ss          , Gs^Ft       , Gs^Ft       , Wwt         , Wwt         , Wwt         , Wwt         , Gg          , Wwt         , Gg^Efm      , Wwt         , Gg          , Hh          , Gg          , Hh          , Hh          , Hh^Fp       , Mm          , Mm          , Mm          , Mm          , Mm          , Ha^Vhha     , Mm          , Mm^Xm       
Gs^Ft       , Gs^Ft       , Gs^Ft       , Ss          , Ss          , Ss          , Ss          , Ss          , Gs^Ft       , Gs^Ft       , Ss          , Ss          , Ss          , Ss          , Gs^Ft       , Gs^Ft       , Gs^Ft       , Gs^Ft       , Gs^Ft       , Gg^Vc       , Ss          , Ss          , Gs^Ft       , Wwt         , Wwt         , Wwt         , Hh          , Wwt         , Wwt         , Wwt         , Hh          , Hh          , Mm          , Hh^Fp       , Mm          , Hh^Fp       , Mm          , Mm          , Mm          , Mm          , Mm^Xm       , Mm^Xm       , Mm^Xm       , Mm^Xm       , Mm^Xm       
Gs^Ft       , Gs^Ft       , Gs^Ft       , Gs^Ft       , Gs^Ft       , Ss^Vhs      , Gs^Ft       , Gs^Ft       , Gs^Ft       , Gs^Ft       , Chs         , Chs         , Ss          , Ss          , Gs^Ft       , Gs^Ft       , Gs^Ft       , Gs^Ft       , Gs^Ft       , Gs^Ft       , Gs^Ft       , Gs^Ft       , Gs^Ft       , Gs^Ft       , Gs^Ft       , Gs          , Gs          , Ss^Vm       , Mm          , Wwt         , Mm          , Mm          , Mm          , Mm          , Mm^Xm       , Mm          , Mm          , Mm          , Mm          , Mm          , Mm^Xm       , Mm^Xm       , Mm^Xm       , Mm^Xm       , Mm^Xm       
Gs^Ft       , Gs^Ft       , Gs^Ft       , Gs^Ft       , Gs^Ft       , Gs^Ft       , Gs^Ft       , Gs^Ft       , Gs^Ft       , Gs^Ft       , Gs^Ft       , Gs^Ft       , Gs^Ft       , Gs^Ft       , Gs^Ft       , Gs^Ft       , Gs^Ft       , Gs^Ft       , Gs^Ft       , Gs^Ft       , Gs^Ft       , Gs^Ft       , Gs^Ft       , Gs^Ft       , Gs^Ft       , Gs^Ft       , Gs          , Mm          , Mm          , Mm^Xm       , Mm          , Mm^Xm       , Mm^Xm       , Mm^Xm       , Mm^Xm       , Mm^Xm       , Mm          , Mm          , Mm          , Mm          , Mm^Xm       , Mm^Xm       , Mm^Xm       , Mm^Xm       , Mm^Xm       
