border_size=1
usage=map

Wo          , Wo          , Wo          , Wo          , Wo          , Wo          , Wo          , Wo          , Wo          , Wo          , Wwt         , Wwt         , Wwt         , Wwt         , Ds          , Ds          , Wwt         , Hd          , Md          , Md^Xm       , Md^Xm       , Md^Xm       , Md^Xm       , Md^Xm       , Hd          , Md          , Wwr         , Wo          , Wo          , Wo          , Wo          , Wo          , Wo          , Wo          , Wo          
Wo          , Wo          , Ds          , Wwr         , Wwt         , Wo          , Wo          , Wo          , Wo          , Wo          , Wwt         , Wwt         , Wwt         , Wwt         , Wwt         , Dd^Vda      , Wwt         , Hd          , Wwt         , Md          , Hd          , Md          , Hd          , Md          , Wwr         , Wwr         , Wwr         , Wwt         , Wo          , Wo          , Wo          , Wo          , Wo          , Wo          , Wo          
Wo          , Ww^Vm       , Wwr         , Wwr         , Wwt         , Wwr         , Wwr         , Wo          , Wo          , Wo          , Wo          , Ww^Vm       , Wo          , Wwt         , Wwt         , Dd          , Wwt         , Wwt         , Hd          , Wwt         , Wwt         , Wwt         , Gs^Ft       , Gs^Ft       , Wwt         , Wwr         , Ww^Vm       , Wwr         , Wo          , Wo          , Wo          , Wo          , Wo          , Wo          , Wo          
Wo          , Wo          , Wo          , Wwr         , Dd          , Dd          , Chw         , Wwt         , Wwt         , Wo          , Wo          , Wo          , Wo          , Wo          , Wo          , Wwt         , Wwr         , Hd          , Md          , Md^Xm       , Md^Xm       , Gs^Vht      , Wwt         , Gs^Ft       , Wwt         , Wwt         , Wo          , Wo          , Wo          , Wo          , Wo          , Wo          , Wo          , Wo          , Wo          
Wo          , Wo          , Wo          , Wwr         , Dd          , 2 Khw       , Chw         , Dd          , Wwt         , Wo          , Wo          , Wo          , Wo          , Wo          , Wo          , Wwt         , Wwr         , Dd          , Hd          , Md^Xm       , Md          , Hd          , Wwr         , Wwt         , Wwt         , Wo          , Wo          , Wo          , Wo          , Wo          , Wo          , Wo          , Wo          , Wo          , Wo          
Wo          , Wo          , Wo          , Wwt         , Wwt         , Dd          , Dd          , Dd          , Wwt         , Wo          , Wo          , Wo          , Wo          , Wo          , Wo          , Wwt         , Wwt         , Dd^Do       , Wwr         , Dd          , Wwr         , Wwr         , Wwr         , Wwr         , Wwt         , Wo          , Wo          , Wo          , Wo          , Wo          , Wo          , Wo          , Wo          , Wo          , Wo          
Wo          , Wo          , Wo          , Wo          , Wo          , Wwt         , Wwt         , Wwt         , Wo          , Wo          , Wo          , Wo          , Wo          , Wo          , Wo          , Wo          , Wo          , Wwt         , Wwt         , Wwr         , Wwt         , Wwr         , Ww          , Wwr         , Wwt         , Wo          , Wo          , Wo          , Wo          , Wo          , Wo          , Wo          , Wo          , Wo          , Wo          
Wo          , Wo          , Wo          , Wo          , Wo          , Wo          , Wo          , Wo          , Wo          , Wo          , Wo          , Wo          , Wo          , Wo          , Wo          , Wo          , Wo          , Wo          , Wo          , Wwt         , Wwt         , Dd          , Dd          , Dd^Dc       , Dd          , Wwt         , Wwt         , Wo          , Wo          , Wo          , Wo          , Wo          , Wo          , Wo          , Wo          
Wo          , Wo          , Wo          , Wo          , Wwt         , Wo          , Wo          , Wo          , Ww^Vm       , Wo          , Wo          , Wo          , Wo          , Wo          , Wo          , Wo          , Wo          , Wo          , Wo          , Wo          , Wo          , Wwt         , Wwr         , Wwr         , Wwr         , Dd^Vda      , Wwt         , Wwt         , Wwt         , Wo          , Wo          , Wo          , Wo          , Wo          , Wo          
Wo          , Wo          , Wo          , Wwt         , Wwr         , Wwt         , Wwr         , Wwt         , Wwr         , Wwt         , Wwt         , Wo          , Wo          , Wo          , Wo          , Wo          , Wo          , Wo          , Wo          , Wo          , Wo          , Wo          , Wwt         , Wwr         , Wwr         , Wwt         , Dd          , Wwt         , Wwt         , Wwt         , Wwt         , Wo          , Wo          , Wo          , Wo          
Wo          , Wo          , Wwt         , Wwr         , Wwr         , Wwr         , Ds          , Wwr         , Dd          , Wwr         , Wwr         , Wo          , Wo          , Wo          , Wo          , Wo          , Ww^Vm       , Wo          , Wo          , Wo          , Wo          , Wo          , Wwt         , Wwt         , Wwt         , Dd          , Gs^Ft       , Wwt         , Wwt         , Ds          , Ds          , Wwt         , Wo          , Wo          , Wo          
Wo          , Wo          , Wwt         , Wwr         , Wwr         , Ds          , Gs^Ft       , Gs^Ft       , Mm^Xm       , Wwr         , Wwr         , Wwt         , Wo          , Wo          , Wo          , Wwt         , Wwr         , Wwr         , Wo          , Wo          , Wo          , Wwt         , Wwt         , Wwr         , Dd          , Gs^Ft       , Wwt         , Gs^Ft       , Ds          , Ds          , Chw         , Wwt         , Wo          , Wo          , Wo          
Wo          , Wo          , Wo          , Wwr         , Wwr         , Ds          , Gs^Ft       , Mm^Xm       , Hh          , Gs^Ft       , Wwr         , Wwt         , Wwt         , Wo          , Wo          , Wo          , Wo          , Wwr         , Wo          , Wo          , Wo          , Wo          , Wo          , Wwr         , Wwt         , Dd          , Dd          , Ds          , Ds          , Ds          , 1 Khw       , Wwt         , Wo          , Wo          , Wo          
Wo          , Wo          , Wo          , Wwt         , Wwt         , Wwr         , Dd^Vda      , Gs^Ft       , Dd          , Wwr         , Wwr         , Wwr         , Wwt         , Wo          , Wo          , Wo          , Wo          , Wo          , Wwt         , Wo          , Wwt         , Wo          , Wo          , Wo          , Wo          , Wwt         , Chw         , Chw         , Chw         , Chw         , Wwr         , Wwr         , Wo          , Wo          , Wo          
Wo          , Wo          , Wo          , Wo          , Wo          , Wwr         , Wwr         , Dd^Do       , Wwr         , Wwr         , Wwt         , Wwt         , Wo          , Wo          , Wo          , Wo          , Wwt         , Wwt         , Wwr         , Wwr         , Wwr         , Wwt         , Wo          , Wo          , Wo          , Wo          , Wo          , Wwr         , Wwr         , Wwr         , Wwr         , Wo          , Wo          , Wo          , Wo          
Wo          , Wo          , Wo          , Wo          , Wo          , Wo          , Wo          , Wwt         , Wo          , Wo          , Wo          , Wo          , Wo          , Wo          , Wo          , Wo          , Wo          , Wwr         , Dd          , Ss^Vhs      , Ss          , Wwt         , Wwt         , Wo          , Wo          , Wo          , Ww^Vm       , Wwt         , Wwr         , Wwt         , Wo          , Wo          , Wo          , Wo          , Wo          
Wo          , Wo          , Wo          , Wo          , Wo          , Wo          , Wo          , Wo          , Wo          , Wo          , Wo          , Wo          , Wo          , Wo          , Wo          , Wo          , Wo          , Wwt         , Dd          , Dd          , Dd          , Wwt         , Wwt         , Wo          , Wo          , Wwt         , Wwt         , Wwt         , Wwt         , Wo          , Wo          , Wo          , Wo          , Wo          , Wo          
