border_size=1
usage=map

Xu          ,Xu          , Xu          , Xu          , Xu          , Xu          , Xu          , Xu          , Xu          , Xu          , Rd          , Xu          , Re          , Xu          , Rd          , Xu          , Re          , Xu          , Re          , Xu          , Xu          , Xu          , Xu          , Xu          , Xu          , Xu          , Xu          , Xu          , Xu          , Xu          , Xu          , Xu          , Xu          , Xu          , Xu          , Xu          , Xu          , Xu          , Xu          , Xu          , Xu          , Xu          
Xu          ,Xu          , Xu          , Xu          , Xu          , Xu          , Xu          , Xu          , Xu          , Xu          , Rd          , Xu          , Re          , Xu          , Rd          , Xu          , Re          , Xu          , Re          , Xu          , Xu          , Xu          , Xu          , Xu          , Xu          , Xu          , Xu          , Xu          , Xu          , Xu          , Xu          , Xu          , Xu          , Xu          , Xu          , Xu          , Xu          , Xu          , Xu          , Xu          , Xu          , Xu          
Xu          ,Xu          , Xu          , Xu          , Uu          , Kh          , Cud         , Xu          , Uu          , Xu          , Re          , Rd          , Re          , Rd          , Re          , Re          , Re          , Rd          , Re          , Xu          , Uu          , Xu          , Xu          , Xu          , Xu          , Xu          , Xu          , Xu          , Xu          , Xu          , Xu          , Xu          , Re          , Wwf         , Ww          , Xu          , Xu          , Xu          , Xu          , Xu          , Xu          , Xu          
Xu          ,Xu          , Uu          , Uu          , Xu          , Cud         , Uu          , Xu          , Uu          , Xu          , Re          , Chr         , Re          , Re          , Ch          , Re          , Rd          , Chr         , Re          , Xu          , Uu          , Uu          , Cud         , Cud         , Uu          , Xu          , Xu          , Wwf         , Wwf         , Ww          , Ww          , Wwf         , Xu          , Xu          , Xu          , Ww          , Wwf         , Xu          , Xu          , Xu          , Xu          , Xu          
Xu          ,Xu          , Uu          , Xu          , Xu          , Cud         , Uu          , Uu          , Uu          , Xu          , Rd          , Re          , Re          , Chr         , Kh          , Chr         , Re          , Rd          , Re          , Xu          , Xu          , Uu          , Cud         , Kh          , Xu          , Uu          , Xu          , Wwf         , Xu          , Xu          , Xu          , Xu          , Ww          , Xu          , Xu          , Xu          , Wwf         , Xu          , Xu          , Xu          , Xu          , Xu          
Xu          ,Xu          , Uu          , Xu          , Xu          , Cud         , Xu          , Xu          , Xu          , Xu          , Re          , Rd          , Re          , Chr         , Ch          , Chr         , Re          , Re          , Rd          , Xu          , Xu          , Cud         , Xu          , Xu          , Uu          , Uu          , Xu          , Ww          , Ww          , Xu          , Xu          , Wo          , Ww          , Ww          , Ww          , Xu          , Ww          , Xu          , Xu          , Xu          , Xu          , Xu          
Xu          ,Xu          , Uu          , Xu          , Xu          , Xu          , Xu          , Xu          , Xu          , Xu          , Re          , Chr         , Re          , Re          , Re          , Rd          , Re          , Chr         , Re          , Xu          , Xu          , Xu          , Xu          , Uu          , Xu          , Xu          , Xu          , Xu          , Wwf         , Xu          , Xu          , Wo          , Ww          , Ww          , Xu          , Ww          , Ww          , Xu          , Xu          , Xu          , Xu          , Xu          
Xu          ,Xu          , Xu          , Uu          , Xu          , Xu          , Xu          , Xu          , Re          , Xu          , Xu          , Re          , Xu          , Rd          , Re          , Re          , Xu          , Re          , Xu          , Xu          , Xu          , Xu          , Xu          , Xu          , Rr          , Rr          , Xu          , Wwf         , Wwf         , Xu          , Xu          , Xu          , Xu          , Xu          , Ww          , Wwf         , Xu          , Xu          , Xu          , Xu          , Xu          , Xu          
Xu          ,Xu          , Xu          , Xu          , Uu          , Uu          , Re          , Ww          , Xu          , Uu          , Xu          , Xu          , Xu          , Xu          , Rd          , Xu          , Xu          , Xu          , Xu          , Xu          , Xu          , Xu          , Xu          , Rr          , Rr          , Rr          , Cud         , Xu          , Xu          , Wwf         , Ww          , Xu          , Xu          , Xu          , Ww          , Xu          , Xu          , Xu          , Xu          , Xu          , Xu          , Xu          
Xu          ,Xu          , Xu          , Xu          , Re          , Xu          , Xu          , Xu          , Xu          , Uu          , Xu          , Xu          , Xu          , Cud         , Rd          , Cud         , Xu          , Xu          , Xu          , Xu          , Rr          , Rr          , Xu          , Rr          , Rr          , Rr          , Cud         , Xu          , Xu          , Xu          , Ww          , Xu          , Xu          , Xu          , Wwf         , Xu          , Xu          , Xu          , Xu          , Xu          , Xu          , Xu          
Xu          ,Xu          , Re          , Re          , Xu          , Xu          , Chr         , Uu          , Uu          , Uu          , Uu          , Xu          , Xu          , Re          , Rd          , Re          , Xu          , Xu          , Xu          , Rr          , Rr          , Rr          , Xu          , Rr          , Rr          , Cud         , 2 Kud       , Xu          , Ww          , Ww          , Chw         , Xu          , Xu          , Xu          , Wwf         , Xu          , Xu          , Xu          , Xu          , Xu          , Xu          , Xu          
Xu          ,Xu          , Uu          , Xu          , Xu          , Xu          , Kh          , Re          , Re          , Uu          , Uu          , Xu          , Xu          , Re          , Rd          , Rd          , Xu          , Xu          , Cud         , Rr          , Cud         , Rr          , Xu          , Rr          , Rr          , Cud         , Cud         , Xu          , Ww          , Chw         , Kh          , Xu          , Xu          , Xu          , Xu          , Ww          , Ww          , Xu          , Xu          , Xu          , Xu          , Xu          
Xu          ,Xu          , Uu          , Xu          , Xu          , Xu          , Ww          , Chw         , Xu          , Uu          , Xu          , Xu          , Xu          , Re          , Re          , Re          , Xu          , Xu          , Xu          , Rr          , Xu          , Xu          , Xu          , Rr          , Rr          , Rr          , Cud         , Xu          , Ww^Vm       , Chw         , Xu          , Xu          , Xu          , Xu          , Xu          , Xu          , Wwf         , Xu          , Xu          , Xu          , Xu          , Xu          
Xu          ,Xu          , Xu          , Re          , Ww          , Xu          , Xu          , Xu          , Uu          , Uu          , Xu          , Xu          , Xu          , Rd          , Xu          , Re          , Xu          , Xu          , Xu          , Rr          , Rr          , Cud         , Xu          , Xu          , Xu          , Rr          , Xu          , Xu          , Xu          , Xu          , Xu          , Xu          , Xu          , Xu          , Xu          , Xu          , Wwf         , Wwf         , Ww          , Xu          , Xu          , Xu          
Xu          ,Xu          , Xu          , Xu          , Xu          , Ww          , Xu          , Xu          , Xu          , Xu          , Xu          , Xu          , Xu          , Rd          , Xu          , Rd          , Xu          , Xu          , Xu          , Xu          , Cud         , Rr          , Rr          , Xu          , Cud         , Xu          , Xu          , Xu          , Xu          , Xu          , Xu          , Xu          , Xu          , Xu          , Xu          , Xu          , Ww          , Xu          , Xu          , Ww          , Xu          , Xu          
Xu          ,Xu          , Xu          , Xu          , Re          , Re          , Xu          , Cud         , Xu          , Rr          , Rr          , Cud         , Xu          , Rr          , Xu          , Rr          , Rr          , Xu          , Xu          , Xu          , Xu          , Xu          , Xu          , Rr          , Rr          , Xu          , Rr          , Xu          , Xu          , Xu          , Xu          , Xu          , Xu          , Xu          , Ww          , Ww          , Xu          , Xu          , Xu          , Ww          , Xu          , Xu          
Xu          ,Xu          , Xu          , Xu          , Uu          , Xu          , Rr          , Rr          , Rr          , Xu          , Xu          , Rr          , Xu          , Rr          , Rr          , Rr          , Xu          , Rr          , Rr          , Xu          , Xu          , Xu          , Xu          , Cud         , Xu          , Rr          , Rr          , Xu          , Xu          , Xu          , Xu          , Xu          , Xu          , Xu          , Wwf         , Xu          , Xu          , Xu          , Ww          , Ww          , Xu          , Xu          
Xu          ,Xu          , Xu          , Xu          , Re          , Xu          , Xu          , Xu          , Rr          , Xu          , Cud         , Rr          , Cud         , Xu          , Xu          , Rr          , Rr          , Xu          , Xu          , Rr          , Rr          , Xu          , Xu          , Xu          , Xu          , Xu          , Rr          , Xu          , Xu          , Xu          , Rr          , Rr          , Rr          , Xu          , Xu          , Re          , Wwf         , Xu          , Xu          , Xu          , Xu          , Xu          
Xu          ,Xu          , Uu          , Re          , Xu          , Xu          , Rr          , Rr          , Xu          , Rr          , Rr          , Rr          , Xu          , Xu          , Cud         , Xu          , Xu          , Rr          , Rr          , Xu          , Xu          , Rr          , Xu          , Xu          , Rr          , Rr          , Rr          , Rr          , Xu          , Xu          , Rr          , Xu          , Xu          , Rr          , Rr          , Xu          , Xu          , Ww          , Xu          , Xu          , Xu          , Xu          
Xu          ,Xu          , Re          , Xu          , Cud         , Rr          , Xu          , Xu          , Rr          , Xu          , Cud         , Rr          , Rr          , Rr          , Rr          , Rr          , Rr          , Xu          , Xu          , Rr          , Rr          , Rr          , Xu          , Rr          , Xu          , Xu          , Cud         , Rr          , Rr          , Rr          , Xu          , Xu          , 8 Kh        , Rr          , Ch          , Rr          , Xu          , Ww          , Xu          , Xu          , Xu          , Xu          
Xu          ,Xu          , Re          , Xu          , Xu          , Rr          , Xu          , Rr          , Xu          , Rr          , Rr          , Rr          , Xu          , Cud         , Rr          , Xu          , Xu          , Rr          , Xu          , Rr          , Rr          , Rr          , Xu          , Rr          , Xu          , Xu          , Rr          , Rr          , Cud         , Xu          , Xu          , Xu          , Xu          , Ch          , Xu          , Xu          , Wwf         , Wwf         , Xu          , Xu          , Xu          , Xu          
Xu          ,Xu          , Xu          , Uu          , Uu          , Xu          , Cud         , Rr          , Xu          , Xu          , Cud         , Rr          , Xu          , Xu          , Xu          , Rr          , Rr          , Xu          , Xu          , Cud         , Rr          , Cud         , Xu          , Rr          , Rr          , Xu          , Cud         , Rr          , Xu          , Xu          , Xu          , Xu          , Wo          , Xu          , Ww          , Ww          , Xu          , Xu          , Xu          , Xu          , Xu          , Xu          
Xu          ,Xu          , Xu          , Xu          , Re          , Xu          , Rr          , Rr          , Xu          , Xu          , Rr          , Rr          , Rr          , Rr          , Rr          , Xu          , Xu          , Rr          , Xu          , Rr          , Rr          , Rr          , Xu          , Cud         , Rr          , Xu          , Rr          , Rr          , Cud         , Xu          , Xu          , Wo          , Wo          , Ww          , Ww          , Ww          , Ww          , Xu          , Xu          , Xu          , Xu          , Xu          
Xu          ,Xu          , Xu          , Xu          , Ww          , Xu          , Xu          , Xu          , Rr          , Rr          , Cud         , Rr          , Cud         , Xu          , Xu          , Rr          , Rr          , Xu          , Xu          , Rr          , Rr          , Rr          , Xu          , Xu          , Rr          , Xu          , Cud         , Rr          , Xu          , Xu          , Xu          , Wo          , Ww          , Ww          , Ww          , Ww          , Ww          , Xu          , Xu          , Xu          , Xu          , Xu          
Xu          ,Xu          , Xu          , Xu          , Re          , Re          , Xu          , Rr          , Xu          , Xu          , Rr          , Rr          , Xu          , Xu          , Rr          , Xu          , Rr          , Rr          , Xu          , Cud         , Rr          , Cud         , Xu          , Cud         , Rr          , Xu          , Rr          , Rr          , Cud         , Xu          , Xu          , Xu          , Ww          , Ww          , Ww          , Ww          , Wwf         , Xu          , Xu          , Xu          , Xu          , Xu          
Xu          ,Xu          , Re          , Uu          , Xu          , Xu          , Cud         , Rr          , Xu          , Xu          , Rr          , Rr          , Xu          , Xu          , Rr          , Rr          , Cud         , Rr          , Xu          , Rr          , Rr          , Rr          , Xu          , Rr          , Rr          , Xu          , Cud         , Rr          , Xu          , Xu          , Xu          , Ww          , Xu          , Ww          , Xu          , Wwf         , Wwf         , Xu          , Xu          , Xu          , Xu          , Xu          
Xu          ,Xu          , Re          , Xu          , Xu          , Xu          , Cud         , Rr          , Xu          , Xu          , Rr          , Rr          , Rr          , Xu          , Xu          , Cud         , 7 Kud       , Cud         , Xu          , Rr          , Rr          , Rr          , Xu          , Ch          , Ch          , Xu          , Rr          , Rr          , Cud         , Xu          , Xu          , Wwf         , Xu          , Xu          , Uu          , Xu          , Xu          , Uu          , Uu          , Xu          , Xu          , Xu          
Xu          ,Xu          , Uu          , Xu          , Xu          , Xu          , Xu          , Rr          , Rr          , Xu          , Xu          , Rr          , Rr          , Rr          , Rr          , Xu          , Xu          , Xu          , Xu          , Cud         , Rr          , Cud         , Xu          , 9 Kh        , Xu          , Xu          , Rr          , Rr          , Xu          , Xu          , Xu          , Wwf         , Xu          , Uu          , Uu          , Uu          , Xu          , Xu          , Uu          , Uu          , Xu          , Xu          
Xu          ,Xu          , Re          , Xu          , Xu          , Xu          , Xu          , Xu          , Rr          , Rr          , Cud         , Xu          , Xu          , Rr          , Rr          , Rr          , Rr          , Xu          , Xu          , Rr          , Rr          , Rr          , Xu          , Xu          , Rr          , Rr          , Xu          , Xu          , Ww^Vm       , Xu          , Ww          , Ww          , Xu          , Uu          , Xu          , Xu          , Uu^Vu       , Xu          , Xu          , Re          , Xu          , Xu          
Xu          ,Xu          , Re          , Xu          , Rr          , Uu^Vu       , Rr          , Xu          , Cud         , Cud         , Cud         , 6 Kud       , Xu          , Xu          , Xu          , Rr          , Rr          , Rr          , Rr          , Rr          , Rr          , Rr          , Rr          , Rr          , Xu          , Xu          , Xu          , Xu          , Xu          , Ww          , Xu          , Xu          , Xu          , Xu          , Rr          , Rr          , Rr          , Uu^Vu       , Xu          , Re          , Xu          , Xu          
Xu          ,Xu          , Re          , Xu          , Ch          , Rr          , Ch          , Xu          , Xu          , Xu          , Xu          , Xu          , Xu          , Xu          , Xu          , Xu          , Rr          , Rr          , Rr          , Rr          , Ce          , Rr          , Rr          , Rr          , Rr          , Xu          , Xu          , Xu          , Xu          , Xu          , Xu          , Xu          , Xu          , Ch          , Ch          , Rr          , Rr          , Rr          , Xu          , Uu          , Xu          , Xu          
Xu          ,Xu          , Xu          , Xu          , 4 Kh        , Rr          , Rr          , Rr          , Rr          , Rr          , Rr          , Rr          , Rr          , Rr          , Rr          , Rr          , Rr          , Rr          , Rr          , Ce          , Ke          , Ce          , Rr          , Rr          , Rr          , Rr          , Rr          , Rr          , Rr          , Rr          , Rr          , Rr          , Rr          , Rr          , Rr          , Rr          , Rr          , Rr          , Xu          , Re          , Xu          , Xu          
Xu          ,Xu          , Rr          , Xu          , Ch          , Rr          , Ch          , Rr          , Xu          , Rr          , Xu          , Rr          , Xu          , Rr          , Xu          , Rr          , Rr          , Rr          , Rr          , Ce          , Ce          , Ce          , Rr          , Rr          , Rr          , Rr          , Xu          , Rr          , Xu          , Rr          , Xu          , Rr          , Xu          , Rr          , Ch          , Rr          , Rr          , Ch          , Xu          , Re          , Xu          , Xu          
Xu          ,Xu          , Rr          , Xu          , Rr          , Rr          , Rr          , Xu          , Xu          , Xu          , Xu          , Xu          , Xu          , Xu          , Xu          , Xu          , Rr          , Rr          , Rr          , Rr          , Rr          , Rr          , Rr          , Rr          , Xu          , Xu          , Xu          , Xu          , Xu          , Xu          , Xu          , Xu          , Xu          , Ch          , Xu          , Rr          , Ch          , 3 Kh        , Xu          , Re          , Xu          , Xu          
Xu          ,Xu          , Rr          , Xu          , Xu          , Uu^Vu       , Xu          , Xu          , Xu          , Xu          , Xu          , Xu          , Xu          , Xu          , Rr          , Rr          , Xu          , Xu          , Xu          , Rr          , Rr          , Rr          , Xu          , Rr          , Rr          , Xu          , Xu          , Xu          , Xu          , Xu          , Xu          , Xu          , Xu          , Xu          , Uu          , Xu          , Xu          , Xu          , Xu          , Uu          , Xu          , Xu          
Xu          ,Xu          , Cud         , Rr          , Xu          , Xu          , Xu          , Xu          , Xu          , Xu          , Xu          , Xu          , Rr          , Rr          , Xu          , Xu          , Xu          , Xu          , Xu          , Cud         , Rr          , Cud         , Xu          , Xu          , Xu          , Rr          , Rr          , Xu          , Xu          , Xu          , Xu          , Xu          , Uu          , Uu          , Xu          , Xu          , Xu          , Xu          , Xu          , Re          , Re          , Re          
Xu          ,Xu          , Xu          , Rr          , Rr          , Xu          , Cud         , Xu          , Rr          , Cud         , Rr          , Rr          , Xu          , Xu          , Rr          , Xu          , Xu          , Xu          , Xu          , Rr          , Rr          , Rr          , Xu          , Xu          , Xu          , Xu          , Xu          , Rr          , Rr          , Xu          , Xu          , Xu          , Uu          , Xu          , Xu          , Xu          , Rd          , Re          , Re          , Xu          , Rd          , Rd          
Xu          ,Xu          , Xu          , Rr          , Cud         , Rr          , Rr          , Rr          , Xu          , Rr          , Xu          , Rr          , Rr          , Rr          , Rr          , Rr          , Xu          , Xu          , Xu          , Rr          , Rr          , Rr          , Xu          , Xu          , Xu          , Xu          , Xu          , Xu          , Rd          , Xu          , Xu          , Uu          , Uu          , Uu          , Xu          , Rd          , Xu          , Xu          , Rd          , Xu          , Re          , Re          
Xu          ,Xu          , Xu          , Rr          , Xu          , Xu          , Rr          , Cud         , Xu          , Rr          , Xu          , Rr          , Rr          , Rr          , Cud         , Rr          , Xu          , Xu          , Xu          , Rr          , Rr          , Rr          , Xu          , Xu          , Xu          , Xu          , Xu          , Xu          , Rd          , Xu          , Xu          , Xu          , Xu          , Xu          , Re          , Rd          , Xu          , Rd          , Xu          , Xu          , Re          , Re          
Xu          ,Xu          , Xu          , Rr          , Xu          , Xu          , Rr          , Xu          , Xu          , Rr          , Xu          , Rr          , Rr          , Cud         , 5 Kud       , Cud         , Xu          , Xu          , Xu          , Rr          , 1 Rr        , Rr          , Xu          , Xu          , Xu          , Xu          , Xu          , Xu          , Rd          , Xu          , Rd          , Rd          , Rd          , Rd          , Xu          , Xu          , Xu          , Rd          , Re          , Re          , Xu          , Xu          
Xu          ,Xu          , Xu          , Rr          , Xu          , Xu          , Xu          , Xu          , Xu          , Rr          , Xu          , Xu          , Xu          , Cud         , Xu          , Xu          , Xu          , Xu          , Xu          , Rr          , Rr          , Rr          , Xu          , Xu          , Xu          , Xu          , Xu          , Xu          , Xu          , Rd          , Xu          , Xu          , Xu          , Xu          , Xu          , Xu          , Xu          , Xu          , Xu          , Xu          , Xu          , Xu          
Xu          ,Xu          , Xu          , Rr          , Xu          , Xu          , Xu          , Xu          , Xu          , Rr          , Xu          , Xu          , Xu          , Cud         , Xu          , Xu          , Xu          , Xu          , Xu          , Rr          , Rr          , Rr          , Xu          , Xu          , Xu          , Xu          , Xu          , Xu          , Xu          , Rd          , Xu          , Xu          , Xu          , Xu          , Xu          , Xu          , Xu          , Xu          , Xu          , Xu          , Xu          , Xu          
