border_size=1
usage=map

Ww, Ww, Ww, Mm, Mm, Mm, Mm, Mm, Mm, Mm, Mm, Mm, Mm, Mm, Mm, Mm, Mm, Mm, Mm, Mm, Mm, Mm, Mm, Mm, Hhd, Gll^Fp, Gll^Fp, Rp, Gll^Fp, Gll^Fp, Mm, Mm
Ww^Es, Ww, Ww, Mm, Mm, Mm, Mm, Mm, Mm, Mm, Mm, Mm, Mm, Mm, Mm, Mm, Mm, Mm, Mm, Mm, Mm, Mm, Mm, Mm, Hhd^Fp, Gll^Fp, Gs^Fms, Rp, Gd^Fet, Gll^Fp, Mm, Mm
Mm, Mm, Mm, Mm, Mm, Mm, Mm, Mm, Mm, Mm, Mm, Mm, Mm, Mm, Mm, Mm, Mm, Mm, Mm, Mm, Mm, Mm, Mm, Hhd, Hhd^Fp, Gll^Fp, Rp, Rp, Gll^Fp, Hhd^Fp, Mm, Mm
Mm, Mm, Mm, Mm, Mm, Mm, Hhd^Vo, Mm, Mm, Mm, Mm, Mm, Mm, Mm, Mm, Mm, Mm, Mm, Gd, Mm, Mm, Mm, Mm, Hhd, Hhd, Gll^Fp, Rp, Gll^Fp, Hhd^Fp, Hhd, Mm, Mm
Mm, Mm, Mm, Mm, Mm, Mm, Mm, Mm, Hhd, Mm, Mm, Hhd^Vo, Mm, Mm, Mm, Gs, Gd, Gd^Vo, Gd, Ce, 2 Ke, Ce, Gg, Gg, Gg^Efm, Gs, Rp, Gll^Fp, Gd^Vo, Hhd, Mm, Mm
Mm, Mm, Mm, Mm, Mm, Mm, Mm, Mm, Hhd^Vo, Hhd, Mm, Mm, Mm, Mm, Mm, Hhd, Gd^Vo, Hhd, Hhd, Ce, Hh, Hh, Hh, Hh, Gg, Rr, Gd, Gd, Mm, Mm, Mm, Mm
Mm, Mm, Mm, Mm, Mm, Mm, Mm, Hhd, Mm, Hhd^Fp, Gs^Fms, Gll^Fp, Gg, Gg, Gs, Gd, Gd, Gd, Gg, Gg, Ce, Ce, Gg, Gg, Rr, Rr, Gd^Vo, Hhd, Mm, Mm, Mm, Mm
Mm, Mm, Mm, Mm, Hhd^Vo, Mm, Mm, Mm, Mm, Ww^Es, Gd, Gd, Gd, Gg, Gg, Gs, Gg, Gg, Gg, Gg, Ce, 1 Ke, Gg, Rr, Gd, Gd, Hhd, Hhd, Mm, Mm, Mm, Mm
Mm, Mm, Mm, Mm, Mm, Mm, Mm, Mm, Mm, Mm, Mm, Gd^Vo, Gd^Fp, Gll^Fp, Gll^Fp, Gll^Fp, Gg, Ww, Ww, Ww, Ww, Ww^Bw/, Rr, Rr, Ss, Ss, Hh, Hh, Mm, Mm, Mm, Mm
Mm, Mm, Mm, Mm, Mm, Mm, Hhd^Vo, Mm, Mm, Mm, Mm, Gd^Fp, Gs^Fet, Gll^Fp, Gs^Fms, Gg, Gg, Ww, Ww, Ww, Ww, Ww, Ww, Ww, Ww, Ww, Mm, Mm, Mm, Mm, Mm, Mm
Mm, Mm, Mm, Mm, Mm, Mm, Mm, Mm, Mm, Mm, Mm, Gs^Fms, Gll^Fp, Gll^Fp, Gd^Vo, Gs, Gg, Ww, Ww, Ww, Hh, Hh, Hh, Hh, Ww, Ww, Ww, Ww, Ww, Ww, Ww, Ww
Mm, Mm, Mm, Mm, Mm, Mm, Mm, Mm, Mm, Mm, Gd^Vo, Gll^Fp, Gs^Fms, Gd, Gd, Gg, Ww, Ww, Ww, Hh, Hh, Mm, Mm, Hh^Vhh, Mm, Mm, Mm, Mm, Mm, Mm, Mm, Mm
Mm, Mm, Mm, Mm, Mm, Mm, Mm, Hh, Hhd, Gd^Fp, Gd^Fms, Gll^Fp, Gg^Es, Gd, Ww, Ww, Ww, Gg, Rr, Hh, Hh, Mm, Mm, Mm, Mm, Mm, Mm, Mm, Mm, Mm, Mm, Mm
Mm, Mm, Mm, Mm, Mm, Mm, Mm, Mm, Mm, Hhd, Hhd, Gll^Fp, Gg, Ww, Ww, Ww, Gg, Gg^Es, Rr, Hh, Mm, Mm, Mm, Mm^Vhh, Mm, Mm, Mm, Mm, Mm, Mm, Mm, Mm
Mm, Mm, Mm, Mm, Gll^Fp, Gll^Fp, Gll^Fp, Gll^Fp, Gd^Vo, Gd, Gg, Ww, Ww, Ww, Ww, Ww, Rr, Rr, Hh, Mm, Mm, Mm, Mm, Mm, Mm, Mm, Mm, Mm, Mm, Mm, Mm, Mm
Mm, Mm, Mm, Mm, Gg^Fet, Gs^Fms, Gd^Fp, Ww, Ww, Ww, Ww, Ww, Gg^Es, Re, Ww, Ww, Rr, Hh, Hh, Mm, Mm, Mm, Mm, Mm, Mm^Vhh, Mm, Mm, Mm, Mm, Mm, Mm, Mm
Mm, Mm, Mm, Mm, Mm, Gd^Fms, Gd^Vo, Ww, Ww, Gs^Fms, Gd^Vo, Gd^Fp, Gs^Fms, Ww, Mm, Hh, Mm, Mm, Mm, Mm, Mm, Mm, Mm, Mm, Hh^Vhh, Mm, Mm, Mm, Mm, Mm, Mm, Mm
Mm, Mm, Mm, Mm, Hh, Hh, Ww, Ww, Ww, Gll^Fp, Gd^Fms, Ww, Ww, Ww, Mm, Cud, Cud, Cud, Cud, Mm, Mm, Mm, Mm, Mm, Mm, Hh, Hh, Mm, Mm, Mm, Mm, Mm
Mm, Mm, Hh, Hh, Hh, Ww, Ww, Ww, Gd^Vo, Gll^Fp, Ww, Ww, Mm, Mm, Mm, Cud, 3 Kud, Cud, Cud, Mm, Mm, Mm, Mm, Mm, Mm, Mm, Hh, Hh^Fp, Mm, Mm, Mm, Mm
Mm, Mm, Hh, Hh, Ww, Ww, Ww, Re, Gll^Fp, Gd^Fms, Ww, Ww, Mm, Mm, Mm, Cud, Cud, Cud, Cud, Mm, Mm, Mm, Mm, Mm^Vhh, Mm, Hh, Hh, Hh, Mm, Mm, Mm, Mm
Mm, Mm, Hh, Hh, Ww, Ww, Ww, Gs^Fms, Gll^Fp, Ww, Ww, Mm, Mm, Mm, Hh^Fp, Hh^Fp, Hh^Fp, Hh^Fp, Hh^Fp, Hh^Fp, Hh^Fp, Mm, Mm, Mm, Hh^Fp, Hh, Mm, Mm, Mm, Mm, Mm, Mm
Hh^Fp, Gll^Fp, Gs^Fms, Ww, Ww, Ww^Es, Ww, Ww, Ww, Ww, Hh^Fp, Hh^Fp, Hh^Fp, Hh^Fp, Hh^Fp, Hh^Fp, Hh^Fp, Hh^Fp, Hh^Fp, Hh^Fp, Hh^Fp, Hh^Fp, Hh^Fp, Mm, Hh, Hh, Mm, Mm, Mm, Mm, Mm, Mm
Hh^Fp, Gll^Fp, Gd^Vo, Ww, Ww, Ww, Ww, Gg, Gll^Fp, Hh^Fp, Hh^Fp, Mm, Mm, Mm, Mm, Mm, Mm, Mm, Mm, Mm, Mm, Mm, Mm, Hh^Vhh, Hh, Mm, Mm, Mm, Mm, Mm, Mm, Mm
Hh^Fp, Gd^Fp, Gd^Fp, Gd, Gs, Ww, Ww, Ww, Re, Hh, Gll^Fp, Hh, Gll^Fp, Hh, Hh, Mm, Mm, Mm, Mm, Mm, Mm, Mm, Mm, Mm, Hh, Hh, Hh, Mm, Mm, Mm, Mm, Mm
Hh^Fp, Gs^Fms, Gs^Fms, Gll^Fp, Gd, Gg, Gg, Ww, Ww, Ww, Re, Re, Gll^Fp, Gll^Fp, Gll^Fp, Hh, Hh, Hh, Mm, Mm, Mm, Gll^Fp, Gll^Fp, Gll^Fp, Mm, Mm, Mm, Mm, Mm, Mm, Mm, Mm
Mm, Mm, Mm, Mm, Hhd^Vo, Mm, Hh, Ww, Ww, Ww, Ww, Ww, Ww, Gg, Re, Re, Hh^Vhh, Gg, Hh, Hh, Hh, Mm, Mm, Mm, Mm, Mm, Mm^Vhh, Mm, Mm, Mm, Mm, Mm
Mm, Mm, Mm, Mm, Hhd, Mm, Mm, Hh, Hh, Gll^Fp, Ww, Ww^Es, Ww, Ww, Ww, Gg, Gg, Hh, Hh, Mm, Mm, Mm, Mm, Mm, Mm, Mm, Mm, Mm, Mm, Mm, Mm, Mm
Mm, Mm, Mm, Mm, Hhd, Mm, Mm, Mm, Mm, Gll^Fp, Gll^Fp, Gll^Fp, Gg, Gg, Ww, Ww, Ww, Ww, Ww, Mm, Mm, Mm, Mm, Mm, Mm, Mm, Mm, Mm, Mm, Mm, Mm, Mm
Mm, Mm, Mm, Hhd, Mm, Mm, Mm, Mm, Mm, Mm, Mm, Mm, Hh, Gg, Wwf, Ww, Ww, Wwr, Ww, Mm, Mm, Mm, Mm, Mm, Mm, Mm, Hh, Mm, Mm, Mm, Mm, Mm
Mm, Mm, Hhd, Hhd, Mm, Mm, Mm, Mm, Mm, Mm, Mm, Hh, Hh, Gll^Fp, Re, Wwf, Ww, Ww, Ww, Mm, Mm, Mm, Mm, Mm, Mm, Mm, Mm, Mm, Hh^Fp, Mm, Mm, Mm
Mm, Mm, Hhd, Mm, Mm, Mm, Mm, Mm, Mm, Mm, Mm, Hh, Hh, Gll^Fp, Re, Gs, Wwf, Ww, Ww, Ww, Mm, Mm, Mm, Mm^Vhh, Mm, Mm, Mm, Mm, Hh^Fp, Mm, Mm, Mm
Co, Co, Co, Co, Mm, Mm, Mm, Mm, Mm, Mm, Mm, Hh, Hh, Gll^Fp, Re, Gd^Vo, Gs^Fp, Hh, Ww, Ww, Ww^Es, Ww, Mm, Mm, Mm, Mm, Mm, Mm, Mm, Mm, Mm, Mm
Co, 4 Ko, Co, Mm, Mm, Mm, Mm, Hh^Fp, Hh^Fp, Hh^Fp, Hh^Fp, Hh^Fp, Gll^Fp, Gs, Re, Gd^Fp, Hh, Hh, Mm, Ww, Ww, Ww, Mm, Mm, Mm, Mm, Hh, Mm, Mm, Mm, Mm, Mm
Co, Co, Co, Co, Mm, Mm, Mm, Mm, Mm, Mm, Mm, Mm, Mm, Gd, Re, Gg, Hh, Hh, Hh, Mm, Ww, Ww, Ww, Mm^Vhh, Mm, Hh, Mm, Mm, Mm, Mm, Mm, Mm
Mm, Mm, Mm, Mm, Mm, Mm, Mm, Mm, Mm, Mm, Mm, Mm, Mm, Gd^Vo, Re, Gg, Gg, Hh, Hh, Mm, Ww, Ww, Ww, Mm, Hh, Hh, Hh^Vhh, Mm, Hh, Mm, Mm, Mm
Mm, Mm, Hh, Mm, Mm, Mm, Mm, Mm, Mm, Mm, Mm, Mm, Hhd, Hhd, Hh, Re, Re, Gg, Gg, Hh, Ww, Ww, Ww, Hh, Gg, Gll^Fp, Gll^Fp, Mm, Hh, Gs^Fp, Gs^Fp, Gs^Fp
Mm, Mm, Hh, Mm, Hhd^Vo, Mm, Mm, Mm, Mm, Mm, Mm, Mm, Mm, Mm, Mm, Hh, Hh, Re, Re, Gll^Fp, Ww, Ww, Wwr, Hh, Gll^Fp, Gs^Fms, Gll^Fp, Mm, Wwf, Gs^Fms, Gs^Fms, Gs^Fp
Mm, Mm, Mm, Mm, Mm, Mm, Mm, Mm, Mm, Mm, Mm, Mm, Mm, Mm, Mm, Mm, Hh, Gll^Fp, Gll^Fp, Re, Wwf, Ww, Ww, Ww, Re, Gs^Fms, Gll^Fp, Mm, Wwf, Gs^Fms, Hh, Hh
Hh, Hh, Mm, Mm, Mm, Mm, Mm, Mm, Mm, Mm, Mm, Mm, Mm, Mm, Hh, Mm, Hh, Hh, Gll^Fp, Ds, Ww, Wwf, Wwf, Re, Gs^Fms, Re, Re, Mm, Mm, Wwf, Hh, Hh
Mm, Mm, Mm, Mm, Mm, Mm, Mm, Mm, Hhd^Vo, Mm, Mm, Mm, Hh, Hh, Hh, Hh, Gg^Em, Gg, Gg, Ww, Ww, Ww, Wwf, Gg^Efm, Gs^Fms, Gll^Fp, Gs^Fms, Re, Wwf^Bw\, Wwf, Gs^Fp, Gs^Fp
Mm, Mm, Mm, Mm, Mm, Mm, Mm, Mm, Mm, Mm, Mm, Mm, Mm, Gll^Fp, Gll^Fp, Gll^Fp, Gll^Fp, Gs^Fms, Gs^Fds, Ww, Ww, Ww, Gg, Wwf, Wwf, Wwf, Wwf, Wwf, Mm, Re, Re, Gg
Mm, Mm, Mm, Mm, Mm, Mm, Mm, Mm, Mm, Mm, Mm, Mm, Mm, Gll^Fp, Gs^Fds, Gs^Fms, Gs^Fms, Gs^Fms, Gs^Fds, Ww, Ww, Ww, Gg, Gs^Fms, Gs^Fms, Gs^Fms, Hh^Fms, Hh^Fms, Mm, Mm, Gg, Re
