border_size=1
usage=map

Mm          , Mm          , Mm          , Mm          , Mm          , Mm          , Mm          , Mm          , Mm          , Mm          , Mm          , Hhd^Fp      , Hhd^Fp      , Hhd^Fp      , Gll^Fp      , Gg          , Gd          , Hhd         , Hh          , Hh          , Mm          , Mm          , Mm          , Mm          , Mm          , Mm          , Mm          , Mm          , Mm          , Mm          , Mm          , Mm          , Mm          , Mm          , Mm          , Mm          , Mm          , Mm          
Mm          , Mm          , Mm          , Mm          , Mm          , Mm          , Gg^Ve       , Mm          , Mm          , Mm          , Mm          , Hhd^Fp      , Hhd^Fp      , Hhd^Fp      , Gll^Fp      , Gg          , Gd          , Hhd         , Hh          , Hh          , Mm          , Mm          , Mm          , Mm          , Mm          , Mm          , Mm          , Mm          , Mm          , Mm          , Mm          , Mm          , Mm          , Mm          , Mm          , Mm          , Mm          , Mm          
Mm          , Mm          , Mm          , Mm          , Mm          , Mm          , Mm          , Mm          , Mm          , Mm          , Mm          , Hhd^Fp      , Hhd^Fp      , Gll^Fp      , Gg^Ve       , Gg          , Gd          , Hhd         , Hhd         , Hhd         , Hhd         , Hh          , Hhd         , Mm          , Mm          , Mm          , Mm          , Mm          , Mm          , Mm          , Mm          , Mm          , Mm          , Mm          , Mm          , Mm          , Mm          , Mm          
Mm          , Mm          , Mm          , Mm          , Mm          , Hhd         , Hhd         , Hhd         , Hh          , Mm          , Gg^Ve       , Hhd^Fp      , Gll^Fp      , Gg          , Gg          , Gg^Ve       , Hd          , Hd          , Ww          , Wwf         , Ww          , Hhd         , Hd          , Hhd         , Hhd         , Gd          , Gg^Efm      , Gg          , Gg          , Mm          , Mm          , Mm          , Mm          , Mm          , Mm          , Mm          , Mm          , Mm          
Hhd         , Hhd         , Hd          , Hhd         , Hd          , Hd          , Ww          , Ww          , Ww          , Ww          , Ww          , Ww          , Ww          , Ww          , Ww          , Ww          , Ww          , Ww          , Ww          , Ww          , Ww          , Ww          , Ww          , Hd          , Gd          , Gd          , Gg          , Gg          , Gg          , Gg          , Gg          , Gg          , Hh          , Hh          , Hhd         , Mm          , Mm          , Mm          
Ds          , Ds          , Ds          , Ds          , Ww          , Ww          , Ww          , Ww          , Ww          , Gll^Fp      , Gll^Fp      , Ww          , Ww          , Ww          , Ww          , Ww          , Ww          , Ww          , Ww          , Ww          , Ww          , Ww          , Ww          , Ww          , Ww          , Ww          , Ww          , Ds          , Ds          , Gg          , Ds          , Gg          , Gg          , Hh          , Hhd         , Mm          , Mm          , Mm          
Ww          , Ww          , Ww          , Ww          , Ww          , Ww          , Ww          , Ww          , Ds          , Gll^Fp      , Hhd^Fp      , Gll^Fp      , Gll^Fp      , Gg          , Ww          , Ww          , Ww          , Ww          , Ww          , Ww          , Ww          , Ww          , Ww          , Ww          , Ww          , Ww          , Ww          , Ww          , Ww          , Ww          , Ww          , Ww          , Ww          , Ww          , Hd          , Hhd         , Hd          , Hd          
Wwr         , Ww          , Ww          , Ww          , Ww          , Ww          , Ww          , Ww          , Ww          , Ww          , Gd          , Hhd^Fp      , Gll^Fp      , Gg          , Ww          , Ww          , Ww          , Ww          , Ww          , Ww          , Ww          , Ww          , Gg          , Gg          , Gg^Efm      , Ww          , Ww          , Ww          , Ww          , Ww          , Ww          , Ww          , Ww          , Ww          , Ww          , Ww          , Ww          , Ww          
Wo          , Wo          , Wo          , Ww          , Ww          , Ww          , Ww          , Ww          , Ww          , Gg          , Gg^Efm      , Gd          , Gg          , Ww          , Ww          , Ww          , Ww          , Ww          , Ww          , Ww          , Ww          , Hh          , Gd          , Gd          , Gg          , Ww          , Ww          , Ww          , Ww          , Ww          , Wo          , Wo          , Wo          , Wo          , Wo          , Wo          , Wo          , Wo          
Ww          , Ww          , Ww          , Ww          , Ww          , Ww          , Ww          , Ww          , Ww          , Ww          , Ww          , Ww          , Ww          , Ww          , Ww          , Ww          , Ww          , Ww          , Ww          , Ww          , Ww          , Ww          , Gll^Fp      , Gll^Fp      , Ww          , Ww          , Ww          , Ww          , Ww          , Ww          , Ww          , Ww          , Ww          , Ww          , Ww          , Ww          , Ww          , Ww          
Ww          , Ww          , Ww          , Ww          , Ww          , Ww          , Ww          , Ww          , Ww          , Ww          , Ww          , Ww          , Ww          , Ww          , Ww          , Ww          , Ww          , Ww          , Ww          , Ww          , Ww          , Ww          , Ww          , Ww          , Ww          , Ww          , Ww          , Ww          , Ww          , Hd          , Hd          , Hd          , Hhd         , Hd          , Hhd         , Hd          , Hd          , Hd          
Mm          , Gg^Ve       , Hhd         , Hd          , Hhd         , Ww          , Ww          , Ww          , Ww          , Ww          , Ww          , Ww          , Ww          , Hh          , Hhd         , Hd          , Hhd         , Hh          , Ww          , Ww          , Ww          , Ww          , Ww          , Ww          , Ww          , Ww          , Hhd         , Hd          , Hhd         , Hhd         , Hhd         , Hhd         , Hh          , Hhd         , Hh          , Hhd         , Hhd         , Hhd         
Mm          , Mm          , Hh          , Hhd         , Hh          , Mm          , Mm          , Mm          , Hhd         , Hhd         , Hhd         , Hhd         , Hhd         , Hhd         , Gll^Fp      , Gll^Fp      , Gll^Fp      , Gll^Fp      , Gll^Fp      , Hhd^Fp      , Gll^Fp      , Mm          , Mm          , Mm          , Gll^Fp      , Hhd         , Mm          , Mm          , Mm          , Mm          , Mm          , Mm          , Mm          , Hh^Vhh      , Mm          , Mm          , Mm          , Mm          
Hhd^Fp      , Hhd^Fp      , Gll^Fp      , Hh          , Gg^Ve       , Gll^Fp      , Hhd^Fp      , Gll^Fp      , Gll^Fp      , Gll^Fp      , Gll^Fp      , Gll^Fp      , Gll^Fp      , Gll^Fp      , Hh^Fp       , Gll^Fp      , Gll^Fp      , Hhd^Fp      , Gll^Fp      , Gll^Fp      , Hhd^Fp      , Gll^Fp      , Hhd^Fp      , Mm          , Hhd         , Hhd         , Mm          , Mm          , Mm          , Mm          , Mm          , Mm          , Mm          , Mm          , Mm          , Mm          , Mm          , Mm          
Hhd^Fp      , Hhd^Fp      , Gll^Fp      , Gll^Fp      , Gll^Fp      , Gll^Fp      , Gll^Fp      , Gg          , Gll^Fp      , Gll^Fp      , Hh^Fp       , Mm          , Mm          , Mm          , Mm          , Mm          , Mm          , Mm          , Mm          , Mm          , Mm          , Mm          , Mm          , Hh^Vhh      , Hhd         , Mm          , Mm          , Mm          , Mm          , Mm          , Mm          , Mm^Vhm      , Mm          , Mm          , Mm          , Mm          , Mm          , Mm          
Hhd^Fp      , Hhd^Fp      , Gll^Fp      , Gg          , Gg          , Gll^Fp      , Gll^Fp      , Gll^Fp      , Hh^Fp       , Gll^Fp      , Gll^Fp      , Hh          , Hh^Fp       , Hh          , Hh          , Mm          , Mm          , Mm          , Mm          , Mm          , Mm          , Mm          , Mm          , Mm          , Hhd         , Hh          , Hh          , Mm          , Mm          , Mm          , Mm          , Mm          , Mm          , Hh          , Hh          , Mm          , Mm          , Mm          
Hhd^Fp      , Hhd^Fp      , Hhd^Fp      , Gll^Fp      , Gg          , Gg          , Gg          , Hhd         , Hhd         , Hhd         , Re          , Re          , Gll^Fp      , Gll^Fp      , Gll^Fp      , Hh          , Hh          , Hh          , Hhd         , Gll^Fp      , Gll^Fp      , Hhd^Fp      , Gll^Fp      , Hhd^Fp      , Mm          , Mm          , Mm          , Mm          , Mm          , Mm          , Mm          , Mm          , Hh          , Hh          , Mm          , Hh          , Mm          , Mm          
Mm          , Mm          , Mm          , Mm          , Gg^Ve       , Mm          , Hh          , Hh          , Hh          , Hh          , Hh          , Hh          , Gg          , Re          , Re          , Gg^Ve       , Re^Gvs      , Hh          , Hh          , Hhd         , Hhd         , Hhd         , Hhd         , Mm          , Mm          , Mm          , Mm          , Mm^Vhm      , Mm          , Mm          , Hh          , Hh          , Hh          , Mm          , Mm          , Mm          , Mm          , Mm          
Mm          , Mm          , Mm          , Mm          , Mm          , Mm          , Mm          , Hhd         , Hhd         , Hhd^Fp      , Hhd         , Hh          , Hh          , Hh          , Hh          , Re^Gvs      , Re^Gvs      , Hh          , Hh          , Hh          , Hh          , Mm          , Mm          , Mm          , Mm          , Mm          , Mm          , Mm          , Mm          , Mm          , Hh          , Hh          , Mm          , Mm          , Mm          , Mm          , Mm          , Mm          
Mm          , Mm          , Mm          , Mm          , Mm          , Hhd^Fp      , Gll^Fp      , Gll^Fp      , Gll^Fp      , Gll^Fp      , Gll^Fp      , Gll^Fp      , Gg          , Hh          , Hh          , Hh          , Hh          , Hh          , Hh          , Hh          , Hh          , Hh          , Hh          , Mm          , Mm          , Mm          , Mm          , Mm          , Mm          , Hh          , Mm          , Mm          , Mm          , Mm          , Mm          , Mm          , Mm          , Mm          
Mm          , Mm          , Mm          , Mm          , Gll^Fp      , Gll^Fp      , Hhd^Fp      , Gll^Fp      , Hhd^Fp      , Hhd^Fp      , Gll^Fp      , Mm          , Hh          , Gg          , Gg          , Gg          , Gg          , Hhd         , Hhd         , Mm          , Mm          , Mm          , Mm          , Mm          , Mm          , Mm          , Hh          , Mm          , Mm          , Mm          , Mm          , Mm          , Mm          , Mm          , Mm          , Mm          , Mm          , Mm          
Mm          , Mm          , Mm          , Mm          , Mm          , Mm          , Mm          , Mm          , Mm          , Gg          , Gg          , Gg          , Gg          , Gs          , Gg          , Gg          , Hhd^Fp      , Gll^Fp      , Hhd^Fp      , Gll^Fp      , Mm          , Mm          , Mm          , Mm          , Mm          , Mm          , Mm          , Mm          , Mm          , Mm          , Mm          , Mm          , Mm          , Mm          , Mm          , Mm          , Mm          , Mm          
Mm          , Mm          , Mm          , Mm          , Mm          , Mm          , Mm          , Mm          , Hh^Vhh      , Mm          , Gg          , Gg          , Gg          , Gg          , Gg          , Gg          , Gg          , Gg          , Gg          , Gg          , Gg          , Gg          , Gg          , Hh          , Mm          , Mm          , Mm          , Mm          , Gll^Fp      , Mm          , Mm          , Mm          , Mm          , Mm          , Mm          , Mm          , Mm          , Mm          
Hh          , Mm          , Mm          , Mm          , Mm          , Mm          , Mm          , Mm          , Hhd         , Hhd         , Hhd         , Hhd         , Hhd         , Hhd         , Gll^Fp      , Rp          , Gs^Vc       , Gll^Fp      , Gll^Fp      , Hh          , Hh          , Hh          , Hh          , Hh          , Hh          , Hh          , Hh          , Hhd         , Hhd         , Mm          , Mm          , Mm          , Mm          , Mm          , Mm          , Mm          , Mm          , Mm          
Hh          , Hh          , Hh          , Mm          , Mm          , Mm^Vhm      , Mm          , Gll^Fp      , Gll^Fp      , Hhd^Fp      , Gll^Fp      , Hhd^Fp      , Gll^Fp      , Gg          , Re          , Gll^Fp      , Hhd         , Hhd         , Mm          , Gll^Fp      , Hh^Fp       , Hh          , Hh          , Hh          , Hh          , Hh          , Hh          , Mm          , Mm          , Mm          , Mm          , Mm          , Ce          , Ce          , Ce          , Ce          , Mm          , Mm          
Hh          , Ce          , Ce          , Ce          , Mm          , Mm          , Mm          , Mm          , Mm          , Hhd         , Hhd         , Hhd         , Hhd         , Gll^Fp      , Gll^Fp      , Gll^Fp      , Gll^Fp      , Gll^Fp      , Gll^Fp      , Gll^Fp      , Gll^Fp      , Gll^Fp      , Hh          , Hh          , Mm          , Hh          , Mm          , Mm          , Mm          , Mm          , Mm          , Mm          , Ce          , 3 Ke        , Ce          , Ce          , Mm          , Mm          
Hh          , Ce          , 2 Ke        , Ce          , Mm          , Mm          , Mm          , Mm          , Mm          , Mm          , Mm          , Mm          , Gd          , Gg          , Gg^Efm      , Gg          , Gg          , Gg          , Gs          , Gll^Fp      , Gll^Fp      , Gll^Fp      , Gll^Fp      , Gll^Fp      , Gg^Efm      , Gg          , Gg          , Hh          , Hh          , Mm          , Mm          , Mm          , Ce          , Ce          , Ce          , Ce          , Mm          , Mm          
Hh          , Ce          , Ce          , Ce          , Mm          , Mm          , Mm          , Mm^Vhm      , Mm          , Mm          , Mm          , Mm          , Gll^Fp      , Hh^Fp       , Gll^Fp      , Gll^Fp      , Gll^Fp      , Gll^Fp      , Gll^Fp      , Gll^Fp      , Gll^Fp      , Gs^Vc       , Gll^Fp      , Gll^Fp      , Gll^Fp      , Gll^Fp      , Hh^Fp       , Mm          , Hh          , Gll^Fp      , Gll^Fp      , Gll^Fp      , Gll^Fp      , Mm          , Mm          , Mm          , Mm          , Mm          
Mm          , Hh          , Hh          , Mm          , Mm^Vhm      , Mm          , Mm          , Mm          , Mm          , Mm          , Gs^Vc       , Mm          , Mm          , Gll^Fp      , Gll^Fp      , Gll^Fp      , Gll^Fp      , Gll^Fp      , Gll^Fp      , Gll^Fp      , Gll^Fp      , Gll^Fp      , Gll^Fp      , Gll^Fp      , Gll^Fp      , Gll^Fp      , Gll^Fp      , Gs^Vc       , Gg          , Gll^Fp      , Gll^Fp      , Gll^Fp      , Gg^Fet      , Gll^Fp      , Gll^Fp      , Mm          , Mm          , Mm          
Mm          , Mm          , Mm          , Mm          , Mm          , Mm          , Mm          , Hh^Fp       , Gll^Fp      , Gll^Fp      , Gll^Fp      , Gs^Vc       , Gll^Fp      , Gll^Fp      , Gll^Fp      , Gs^Vc       , Gll^Fp      , Gll^Fp      , Gll^Fp      , Gll^Fp      , Gll^Fp      , Gll^Fp      , Gll^Fp      , Gll^Fp      , Gll^Fp      , Gll^Fp      , Gll^Fp      , Gll^Fp      , Gll^Fp      , Mm          , Hh          , Hh          , Hh          , Hh          , Hh          , Mm          , Mm          , Mm          
Hh          , Hh          , Mm          , Mm          , Mm          , Mm          , Gs^Vc       , Gll^Fp      , Gll^Fp      , Hh^Fp       , Gll^Fp      , Gll^Fp      , Gll^Fp      , Gll^Fp      , Gll^Fp      , Gll^Fp      , Gll^Fp      , Gll^Fp      , Ce          , Gll^Fp      , Gll^Fp      , Gll^Fp      , Gll^Fp      , Gll^Fp      , Gll^Fp      , Gll^Fp      , Gll^Fp      , Gll^Fp      , Gs^Vc       , Mm          , Mm          , Mm          , Mm          , Mm          , Mm          , Mm          , Mm          , Mm          
Mm          , Mm          , Mm          , Mm          , Mm          , Mm          , Mm          , Mm          , Hh^Fp       , Gll^Fp      , Ce          , Ce          , Ce          , Gll^Fp      , Gll^Fp      , Gll^Fp      , Gll^Fp      , Ce          , 1 Ke        , Ce          , Gll^Fp      , Gll^Fp      , Gll^Fp      , Gll^Fp      , Ce          , Ce          , Ce          , Gll^Fp      , Gll^Fp      , Gll^Fp      , Hh^Fp       , Hh^Fp       , Mm          , Mm          , Mm          , Mm          , Mm          , Mm          
Mm          , Mm          , Mm          , Mm          , Mm          , Mm          , Mm          , Hh          , Hh          , Hh^Fp       , Ce          , 6 Ke        , Ce          , Gll^Fp      , Gll^Fp      , Gll^Fp      , Gll^Fp      , Ce          , Gll^Fp      , Ce          , Gll^Fp      , Gll^Fp      , Gll^Fp      , Gll^Fp      , Ce          , 5 Ke        , Ce          , Gll^Fp      , Hh^Fp       , Mm          , Mm          , Mm          , Mm          , Mm          , Mm          , Mm          , Mm          , Mm          
Mm          , Mm          , Mm          , Mm          , Mm          , Mm          , Mm          , Hh          , Hh          , Gll^Fp      , Gll^Fp      , Gll^Fp      , Gll^Fp      , Gll^Fp      , Gll^Fp      , Gll^Fp      , Gll^Fp      , Gll^Fp      , Gll^Fp      , Gll^Fp      , Gll^Fp      , Gll^Fp      , Gll^Fp      , Gll^Fp      , Gll^Fp      , Gll^Fp      , Gll^Fp      , Gll^Fp      , Hh^Fp       , Mm          , Mm          , Mm          , Mm          , Mm          , Mm          , Mm          , Mm          , Mm          
