border_size=1
usage=map

Mm          , Mm          , Mm          , Mm          , Hd          , Mm          , Mm          , Mm          , Mm          , Mm          , Mm          , Mm          , Mm          , Mm          , Mm          , Mm          , Mm          , Mm          , Mm          , Mm          , Mm          , Mm          , Hd          , Mm          , Mm          , Mm          , Mm          , Mm          , Mm          , Mm          , Mm          , Mm          , Mm          , Mm          , Mm          , Mm          , Mm          , Mm          , Mm          , Mm          , Mm          , Mm          , Mm          , Mm          , Mm          , Mm          , Mm          , Mm          , Mm          , Mm          , Mm          , Mm          , Mm          , Mm          , Mm          , Mm          , Mm          , Mm          , Mm          , Mm          , Mm          , Mm          , Mm          , Mm          
Mm          , Mm          , Mm          , Mm          , Hd          , Hd          , Mm          , Mm          , Mm          , Mm          , Mm          , Mm          , Mm          , Mm          , Mm          , Mm          , Mm          , Mm          , Mm          , Mm          , Mm          , Mm          , Hd          , Mm          , Mm          , Mm          , Mm          , Mm          , Mm          , Mm          , Hd          , Hd          , Hd          , Mm          , Mm          , Mm          , Mm          , Mm          , Mm          , Mm          , Mm          , Mm          , Mm          , Hd          , Hd          , Hd          , Mm          , Mm          , Mm          , Mm          , Mm          , Mm          , Mm          , Mm          , Mm          , Mm          , Mm          , Mm          , Mm          , Mm          , Mm          , Mm          , Mm          , Mm          
Mm          , Mm          , Mm          , Mm          , Mm          , Hd          , Hd          , Mm          , Mm          , Mm          , Mm          , Mm          , Mm          , Mm          , Mm^Vhm      , Mm          , Mm          , Mm          , Mm          , Mm          , Mm          , Hd          , Mm          , Mm          , Mm          , Mm          , Mm          , Hd          , Mm          , Hd          , Ww          , Ww          , Hd          , Hd          , Hd          , Mm          , Mm          , Mm          , Mm          , Mm          , Mm          , Mm          , Mm          , Hd          , Mm          , Mm          , Mm          , Mm          , Mm          , Mm^Vhm      , Mm          , Mm          , Mm          , Mm          , Mm          , Mm          , Mm          , Mm          , Mm          , Ce          , Ce          , Ce          , Mm          , Mm          
Mm          , Mm          , Mm          , Mm          , Mm          , Mm          , Hhd         , Hhd         , Hhd         , Hhd         , Hhd         , Hhd         , Mm          , Mm          , Mm          , Mm          , Mm          , Mm          , Mm          , Mm          , Hd          , Hd          , Mm          , Mm          , Mm          , Mm          , Mm          , Hd          , Ww          , Ww          , Ww          , Ww          , Ww          , Ww          , Hd          , Mm          , Hd          , Mm          , Hd          , Mm          , Hd          , Hd          , Hd          , Hd          , Hd          , Mm          , Hd          , Mm          , Hd          , Hd          , Hd          , Mm          , Hd          , Mm          , Mm          , Hd          , Hd          , Hd          , Mm          , Ce          , 4 Ke        , Ce          , Mm          , Mm          
Mm          , Mm          , Mm          , Mm          , Mm          , Mm          , Hhd         , Hhd         , Hhd         , Hhd         , Hhd         , Hhd         , Mm          , Mm          , Mm          , Mm          , Mm          , Mm          , Hhd         , Mm          , Mm          , Mm          , Mm          , Mm          , Mm          , Mm          , Hd          , Hd          , Ww          , Ww          , Wo          , Wo          , Ww          , Ww          , Ds^Es       , Hd          , Mm          , Hd          , Mm          , Mm          , Mm          , Mm          , Mm          , Mm          , Mm          , Hd          , Mm          , Mm          , Mm          , Hd          , Hd          , Hd          , Mm          , Hd          , Mm          , Hd          , Mm          , Mm          , Mm          , Mm          , Ce          , Mm          , Mm          , Mm          
Mm          , Mm          , Mm          , Mm          , Mm          , Mm          , Hhd         , Hhd         , Ce          , Ce          , Ce          , Ce          , Mm          , Mm          , Mm          , Mm          , Gs^Fp       , Hh^Fp       , Hh^Fp       , Hhd         , Mm          , Mm          , Mm          , Mm          , Mm          , Mm          , Hd          , Ds          , Ww          , Ww          , Wo          , Wo          , Wo          , Ww          , Ww          , Hd          , Mm          , Mm          , Mm          , Mm          , Mm          , Mm          , Mm          , Mm          , Mm          , Mm          , Mm          , Mm          , Mm          , Mm          , Hd          , Mm          , Mm          , Mm          , Mm          , Mm          , Mm          , Mm          , Mm          , Mm          , Mm          , Mm          , Mm          , Mm          
Mm          , Mm          , Mm          , Mm          , Mm          , Mm          , Hhd         , Hhd         , Ce          , 2 Ke        , Ce          , Ce          , Mm          , Mm          , Mm          , Mm          , Hh^Fp       , Gs^Fp       , Gs^Fp       , Mm          , Mm          , Mm          , Mm          , Mm          , Mm          , Hd          , Hd          , Ds          , Ww          , Ww          , Ww          , Wo          , Ww          , Ww          , Ww          , Mm          , Mm          , Mm          , Mm          , Mm          , Mm          , Mm          , Mm          , Mm          , Mm          , Mm          , Mm          , Mm          , Hd          , Hd          , Mm          , Mm          , Mm          , Mm          , Mm          , Mm          , Mm          , Mm          , Mm          , Hd          , Mm          , Mm          , Mm          , Mm          
Mm          , Mm          , Mm          , Mm          , Mm          , Hhd         , Hhd         , Ce          , Ce          , Ce          , Ce          , Mm          , Mm          , Mm          , Mm          , Mm          , Gs^Fp       , Gs^Fp       , Gs^Fp       , Gs^Fp       , Hh^Fp       , Mm          , Mm          , Mm          , Hd          , Hd          , Hhd^Fp      , Gd^Fp       , Gs^Fp       , Ww          , Ww          , Ww          , Ww          , Ww          , Ww          , Hh^Fp       , Gs^Fp       , Hh^Fp       , Gs^Fp       , Gs^Fp       , Gs^Em       , Gs^Fp       , Mm          , Mm          , Mm          , Mm          , Mm          , Mm          , Mm          , Mm          , Mm          , Mm          , Mm          , Mm          , Mm          , Mm          , Mm          , Mm          , Mm          , Hd          , Mm          , Mm          , Mm          , Mm          
Mm          , Mm          , Mm          , Mm          , Mm          , Hhd         , Hhd         , Hhd         , Hhd         , Hhd         , Hhd         , Gd          , Mm          , Mm          , Mm          , Mm          , Hh^Fp       , Gs^Fp       , Gs^Fp       , Gs^Fp       , Gs^Fp       , Mm          , Mm          , Mm          , Mm          , Mm          , Gs^Fp       , Gs^Fp       , Gs^Fp       , Hh^Fp       , Gs^Fp       , Ww          , Ds          , Ww          , Gs^Fp       , Gs^Fp       , Gs^Fp       , Gs^Fp       , Gs^Fp       , Gs^Fp       , Gs^Fp       , Gs^Fp       , Gs^Fp       , Gs^Fp       , Hh^Fp       , Mm          , Mm          , Hhd         , Mm          , Mm          , Mm          , Mm          , Mm          , Mm          , Mm          , Mm          , Mm          , Mm          , Mm          , Hd          , Mm          , Mm          , Mm          , Mm          
Mm          , Mm          , Mm          , Mm          , Mm          , Mm          , Hhd         , Hhd         , Gd          , Hhd         , Gd          , Gd          , Hhd         , Hhd         , Mm          , Mm          , Hh^Fp       , Gs^Fp       , Hh^Fp       , Gs^Fp       , Gs^Fp       , Hh^Fp       , Gs^Fp       , Hh^Fp       , Gs^Fp       , Gs^Fp       , Gd^Fp       , Gs^Fp       , Hh^Fp       , Gs^Fp       , Gs^Fp       , Gs^Fp       , Gs^Fp       , Gs^Fp       , Gs^Fp       , Gs^Fp       , Hh^Fp       , Hh^Fp       , Gs^Fp       , Hh^Fp       , Gs^Fp       , Gs^Fp       , Gs^Fp       , Gs^Fp       , Gs^Fp       , Gs^Fp       , Gs^Fp       , Gd^Fp       , Mm          , Mm          , Mm          , Mm          , Mm          , Mm          , Mm          , Mm          , Mm          , Mm          , Hd          , Hd          , Mm          , Mm          , Mm          , Mm          
Mm          , Mm          , Hd          , Hd          , Hd          , Mm          , Hd          , Hd          , Gd          , Gd          , Gd          , Gd          , Hhd^Vhh     , Mm          , Mm          , Mm          , Gs^Fp       , Gs^Fp       , Gs^Fp       , Gs^Fp       , Gs^Fp       , Gs^Fp       , Gs^Fp       , Gs^Fp       , Gd^Fp       , Gd^Fp       , Hhd^Fdf     , Gd^Fp       , Hhd^Fdf     , Hh^Fp       , Gs^Fp       , Gs^Fp       , Gs^Fp       , Gs^Fp       , Gs^Fp       , Gs^Fp       , Gs^Fp       , Gs^Fp       , Gs^Fp       , Gs^Fp       , Hh^Fp       , Gs^Fp       , Hh^Fp       , Gs^Fp       , Hh^Fp       , Gs^Fp       , Gs^Fp       , Gs^Fp       , Mm          , Mm          , Mm          , Mm          , Mm          , Mm^Vhm      , Mm          , Mm          , Mm          , Hd          , Mm          , Mm          , Mm          , Mm          , Mm          , Mm          
Mm          , Hd          , Mm          , Mm          , Mm          , Hd          , Hhd         , Hhd         , Hhd         , Hhd         , Hhd         , Gd          , Gd          , Hhd         , Mm          , Mm          , Hh^Fp       , Gs^Fp       , Gs^Fp       , Gs^Fp       , Gs^Fp       , Gs^Fp       , Gg^Ve       , Gd^Fp       , Hhd^Fdf     , Hhd^Fdf     , Hhd^Fdf     , Hhd^Fdf     , Hhd^Fdf     , Gd^Fp       , Gs^Fp       , Hh^Fp       , Gs^Fp       , Hh^Fp       , Hh^Fp       , Gs^Fp       , Gs^Fp       , Gs^Fp       , Gs^Fp       , Gs^Fp       , Hh^Fp       , Hhd         , Hhd         , Hh^Fp       , Hh^Fp       , Hh^Fp       , Hh^Fp       , Hh^Fp       , Hh^Fp       , Hh^Fp       , Mm          , Mm          , Mm          , Mm          , Mm          , Mm          , Hd          , Hd          , Mm          , Mm          , Mm^Vhm      , Mm          , Mm          , Mm          
Mm          , Hd          , Mm          , Mm          , Mm          , Mm          , Hhd         , Hhd         , Hhd         , Hhd         , Hhd         , Hhd         , Gd          , Gd          , Mm          , Hh^Fp       , Gs^Fp       , Gs^Fp       , Gs^Fp       , Gs^Fp       , Gs^Fp       , Ww          , Ww^Es       , Ww          , Ww          , Ww          , Ww          , Ww          , Ww          , Ww          , Ww^Es       , Mm          , Mm          , Hh          , Hh          , Hh          , Ch          , Ch          , Ch          , Gs^Fp       , Hhd         , Hhd         , Hhd         , Hhd         , Hhd         , Hhd         , Hhd         , Hhd         , Hhd         , Hhd         , Hhd         , Hhd         , Mm          , Mm          , Mm          , Mm          , Hd          , Mm          , Mm          , Mm          , Mm          , Mm          , Mm          , Mm          
Mm          , Mm          , Mm          , Mm          , Mm          , Mm          , Mm          , Mm          , Mm          , Mm          , Mm          , Mm          , Hhd         , Gd          , Gs          , Gg          , Gs          , Gg          , Gg          , Gg          , Gd          , Hhd^Fdf     , Gs          , Ww          , Ww          , Wo          , Wo          , Ww          , Wo          , Ww          , Ww          , Ww          , Ww          , Ww          , Ww          , Ww          , Ch          , 3 Kh        , Ch          , Mm          , Mm          , Mm          , Mm          , Mm          , Mm          , Mm          , Mm          , Mm          , Mm          , Mm          , Mm          , Hhd         , Hhd         , Mm          , Hd          , Hd          , Mm          , Mm          , Mm          , Mm          , Mm          , Mm          , Mm          , Mm          
Mm          , Mm          , Mm          , Mm          , Mm          , Mm          , Mm          , Mm          , Mm          , Mm          , Mm          , Hhd         , Hh          , Hh          , Hh          , Gs          , Hh          , Gd          , Gd          , Gs^Fp       , Gs^Fp       , Hhd^Fdf     , Ww^Es       , Ww          , Ww          , Wo          , Wo          , Wo          , Wo          , Wo          , Wo          , Ww          , Wo          , Ww          , Ww          , Ww          , Ch          , Ch          , Ch          , Hh^Fms      , Hh^Fms      , Hh^Fms      , Hh^Fms      , Hhd         , Gg^Ve       , Mm          , Mm          , Mm          , Mm          , Mm          , Mm          , Mm          , Hhd         , Hd          , Mm          , Mm          , Mm          , Mm          , Mm          , Mm          , Mm          , Mm          , Mm          , Mm          
Mm          , Mm          , Mm          , Mm          , Mm          , Mm          , Mm          , Mm          , Mm          , Mm          , Mm          , Hhd         , Hh          , Hh          , Hhd         , Hh          , Hhd^Fdw     , Hhd^Fdw     , Hhd^Fdw     , Hhd^Fdw     , Gs^Fp       , Gd^Fp       , Hhd^Fdf     , Hhd^Fdf     , Ww          , Ww          , Ww^Es       , Ww          , Ww          , Wo          , Wo          , Wo          , Wo          , Wo          , Ww          , Ww          , Hhd^Fdf     , Hh          , Re          , Gs          , Gd          , Hh^Fp       , Hh^Fp       , Hh^Fp       , Hh^Fp       , Hh^Fp       , Hh^Fp       , Hh^Fp       , Hh^Fp       , Hh^Fp       , Hh^Fp       , Hh^Fp       , Hhd         , Hhd         , Mm          , Mm          , Mm          , Mm          , Mm          , Mm          , Mm          , Mm          , Mm          , Mm          
Mm          , Mm          , Mm          , Mm          , Mm          , Mm^Vhm      , Mm          , Mm          , Mm          , Mm          , Hhd         , Hh          , Hh          , Hh          , Hhd^Fms     , Hhd^Fdw     , Hhd^Fdw     , Hhd^Fdw     , Hhd^Fp      , Gs^Fp       , Gs^Fp       , Gd^Fp       , Gd^Fp       , Hhd^Fdf     , Hhd^Fdf     , Hhd^Fdf     , Gs^Fp       , Ww          , Ww          , Ww          , Ww          , Ww          , Ww          , Ww          , Ww          , Ww          , Hhd^Fdf     , Hh^Fp       , Re          , Re          , Gd          , Hhd         , Hhd         , Hh^Fms      , Hh^Fms      , Hhd         , Hh^Fms      , Hhd         , Hh^Fp       , Hh^Fp       , Hh^Fp       , Hh^Fp       , Hh^Fp       , Hh^Fp       , Hh^Fp       , Hh^Fp       , Mm          , Mm          , Mm          , Mm          , Mm          , Mm          , Mm          , Mm          
Mm          , Mm          , Mm          , Mm          , Mm          , Mm          , Mm          , Mm          , Hd          , Hd          , Hhd         , Hhd         , Hhd         , Hh^Fms      , Hh^Fms      , Hhd^Fp      , Gs^Fp       , Hhd^Fp      , Gs^Fp       , Gs^Fp       , Hh^Fp       , Gs^Fp       , Gs^Fp       , Gd^Fp       , Gd^Fp       , Gd^Fp       , Gs^Fp       , Re          , Re          , Hhd^Fdf     , Ww          , Ww          , Ww          , Ww          , Ww^Es       , Ww          , Hhd^Fdf     , Hhd^Fdf     , Re          , Re          , Gs^Fp       , Hh^Fp       , Gs^Fp       , Hhd         , Hhd         , Hh^Fp       , Hh^Fms      , Hhd         , Hh^Fms      , Hhd         , Hhd         , Hh^Fp       , Hh^Fp       , Hh^Fp       , Hh^Fp       , Hh^Fp       , Hh^Fp       , Mm          , Mm          , Mm          , Mm          , Mm          , Mm          , Mm          
Mm          , Mm          , Mm          , Mm          , Mm          , Mm          , Mm          , Hd          , Mm          , Mm          , Mm          , Mm          , Mm          , Mm          , Mm          , Mm          , Mm          , Mm          , Mm          , Mm          , Gd^Ve       , Gg          , Gg          , Gg          , Gg          , Re          , Re          , Re          , Re          , Re          , Re          , Re          , Re          , Re          , Re          , Re          , Re          , Re          , Re          , Ww          , Ww          , Mm          , Mm          , Mm          , Mm          , Mm          , Mm          , Mm          , Mm          , Mm          , Mm          , Mm          , Mm          , Mm          , Mm          , Mm          , Mm          , Hd          , Hd          , Mm          , Mm          , Mm          , Mm          , Mm          
Hd          , Mm          , Hd          , Hd          , Mm          , Hd          , Mm          , Mm          , Mm          , Mm          , Mm^Vhm      , Mm          , Mm          , Hhd         , Hhd         , Hhd         , Hhd         , Hhd         , Hhd         , Hhd         , Gd          , Gs          , Gg          , Gg          , Re          , Re          , Gg^Vh       , Gg          , Gg          , Gg          , Gg          , Gg          , Gg          , Gg          , Gg          , Gg          , Gg          , Gg^Vh       , Gg          , Ww          , Ww          , Ww          , Ww          , Mm          , Mm          , Mm          , Mm          , Mm          , Mm          , Mm          , Mm          , Mm          , Mm          , Mm          , Mm          , Mm          , Mm          , Mm          , Mm          , Hd          , Hd          , Mm          , Mm          , Mm          
Mm          , Hd          , Mm          , Mm          , Mm          , Mm          , Mm          , Mm          , Mm          , Mm          , Mm          , Hhd         , Hhd         , Hhd         , Hh          , Hh          , Hh          , Gd          , Gs          , Gd          , Gs          , Gg          , Re          , Re          , Hh          , Hh          , Hh          , Hh          , Hh          , Gs          , Hh          , Gg          , Gs          , Gg          , Hh          , Hh          , Hh          , Gg          , Hh          , Gg          , Gs          , Gg          , Gd          , Hd          , Mm          , Mm          , Mm          , Mm          , Mm          , Mm          , Mm          , Mm          , Mm          , Mm          , Mm          , Mm          , Mm          , Mm          , Mm          , Mm          , Mm          , Hd          , Hd          , Mm          
Mm          , Mm          , Mm          , Mm          , Mm          , Mm          , Mm          , Mm          , Mm          , Mm          , Hhd         , Hhd         , Hh          , Hh          , Gg          , Hh          , Gs          , Gs          , Hh          , Hh          , Hh          , Re          , Re          , Hh          , Hh          , Hh          , Hh          , Hh          , Hh          , Hh          , Hh          , Hh          , Gg^Vh       , Hh          , Hh          , Hh          , Hh          , Hh          , Hh          , Hh          , Hh          , Gd          , Gd          , Hd          , Hd          , Hd          , Hd          , Hd          , Mm          , Mm          , Mm          , Mm          , Mm          , Mm          , Mm          , Mm          , Mm          , Mm          , Mm          , Mm          , Mm          , Hd          , Mm          , Mm          
Mm          , Mm          , Mm          , Mm          , Mm          , Mm          , Mm          , Mm          , Mm          , Hhd         , Hhd         , Hh          , Gg          , Gg          , Gs          , Gs          , Gg          , Gg          , Hh          , Hh          , Re          , Re          , Hhd         , Hh          , Hhd         , Hh          , Hh          , Hh          , Hh          , Hh          , Hh^Fp       , Hh^Fp       , Hh^Fp       , Hh^Fp       , Hh^Fp       , Hh          , Hh          , Hh          , Hhd         , Hhd         , Hhd         , Hhd         , Hhd         , Gd          , Gg^Vh       , Hd          , Hd          , Hd          , Hd          , Hd          , Hd          , Mm          , Hd          , Mm          , Mm          , Mm^Vhm      , Mm          , Mm          , Mm          , Mm          , Mm          , Mm          , Mm          , Mm          
Mm          , Mm          , Mm          , Mm          , Mm          , Mm          , Mm          , Mm          , Mm          , Hhd         , Hhd         , Gd          , Gs          , Gs          , Hh          , Hh          , Hh          , Hh          , Hh          , Hh          , Re          , Re          , Hhd         , Hhd         , Mm          , Hhd         , Hhd         , Hh^Fp       , Hh^Fp       , Hh^Fp       , Hh^Fp       , Hh^Fp       , Hh^Fp       , Hh^Fp       , Hh          , Hh          , Hh          , Hhd         , Hd          , Mm          , Mm          , Mm          , Mm          , Mm          , Mm          , Mm          , Mm          , Hd          , Mm          , Mm          , Mm          , Hd          , Mm          , Hd          , Hd          , Hd          , Hd          , Mm          , Mm          , Mm          , Mm          , Mm          , Mm          , Mm          
Mm          , Mm          , Mm          , Mm          , Mm          , Mm          , Mm          , Mm          , Hd          , Hhd         , Hhd         , Gd          , Gd          , Gg          , Hh          , Hh          , Mm          , Mm          , Hh^Fp       , Hh^Fp       , Re          , Re          , Hhd         , Mm          , Hhd         , Hh^Fp       , Hh^Fp       , Hh^Fp       , Hh^Fp       , Hh^Fp       , Hh^Fp       , Hh^Fp       , Hh^Fp       , Hh^Fp       , Hh^Fp       , Hh          , Hhd         , Hhd         , Mm          , Hd          , Hd          , Mm          , Mm          , Mm          , Hd          , Hd          , Mm          , Mm          , Mm          , Mm          , Mm          , Hd          , Hd          , Mm          , Mm          , Mm          , Mm          , Hd          , Hd          , Mm          , Mm          , Mm          , Mm          , Mm          
Mm          , Mm          , Mm          , Mm          , Hd          , Hd          , Hd          , Hd          , Mm          , Hhd         , Hhd         , Hhd         , Hhd         , Gg^Vh       , Hh          , Hh          , Hh          , Hh          , Hh          , Hh^Fp       , Hh^Fp       , Re          , Re          , Hhd         , Ce          , Hhd         , Hh^Fp       , Hh^Fp       , Hh^Fp       , Hh^Fp       , Hh^Fp       , Hh^Fp       , Hh^Fp       , Hh^Fp       , Hh^Fp       , Hh^Fp       , Hh^Fp       , Hh^Fp       , Mm          , Mm          , Mm          , Hd          , Hd          , Hd          , Mm          , Mm          , Mm          , Mm          , Mm          , Mm          , Mm          , Mm          , Hd          , Mm          , Mm          , Mm          , Mm          , Mm          , Mm          , Hd          , Hd          , Hd          , Mm          , Mm          
Mm          , Mm          , Mm          , Mm          , Hd          , Mm          , Mm^Vhm      , Mm          , Mm          , Mm          , Mm          , Hhd         , Hhd         , Hhd         , Hhd         , Hhd         , Hhd         , Hh          , Hh          , Ce          , Ce          , Ce          , Re          , Re          , Ce          , Ce          , Ce          , Hh^Fp       , Hhd         , Hhd         , Hh^Fp       , Hh^Fp       , Hh^Fp       , Hh^Fp       , Hh^Fp       , Hh^Fp       , Mm          , Mm          , Mm          , Mm          , Mm          , Mm          , Hd          , Mm          , Mm          , Mm          , Mm          , Mm          , Mm          , Mm          , Mm          , Mm          , Hd          , Hd          , Mm          , Mm          , Mm          , Mm          , Mm          , Mm          , Mm          , Hd          , Hd          , Mm          
Mm          , Mm          , Hd          , Hd          , Mm          , Mm          , Mm          , Mm          , Mm          , Mm          , Mm          , Mm          , Hhd         , Hhd         , Hhd         , Hhd         , Hhd         , Hhd         , Hh          , Ce          , 1 Ke        , Ce          , Re          , Re          , Ce          , 5 Ke        , Ce          , Hhd         , Hhd         , Mm          , Mm          , Mm          , Gll^Ve      , Hh^Fp       , Hh^Fp       , Hh^Fp       , Mm          , Mm          , Mm          , Mm          , Mm          , Mm          , Hd          , Mm          , Mm          , Mm          , Mm          , Mm          , Mm          , Mm          , Mm          , Mm^Vhm      , Mm          , Hd          , Mm          , Mm          , Mm          , Mm          , Mm          , Mm          , Mm          , Mm          , Mm^Vhm      , Hd          
Hd          , Hd          , Mm          , Mm          , Mm          , Mm          , Mm          , Mm          , Mm          , Mm          , Mm          , Mm          , Mm          , Mm          , Mm          , Mm          , Mm          , Mm          , Hh          , Hh          , Ce          , Hh          , Re          , Re          , Mm          , Mm          , Mm          , Hhd         , Hhd         , Hhd         , Hhd         , Hhd         , Hhd         , Hhd         , Hhd         , Mm          , Mm          , Mm          , Mm          , Mm          , Mm          , Mm          , Hd          , Mm          , Mm          , Mm          , Mm          , Mm          , Mm          , Mm          , Mm          , Mm          , Mm          , Hd          , Hd          , Mm          , Mm          , Mm          , Mm          , Mm          , Mm          , Mm          , Mm          , Mm          
Mm          , Mm          , Mm          , Mm          , Mm          , Mm          , Mm          , Mm          , Mm          , Mm          , Mm          , Mm          , Mm          , Mm          , Mm          , Mm          , Mm          , Mm          , Hhd         , Hhd         , Hhd         , Hhd         , Re          , Re          , Mm          , Mm          , Mm          , Hhd         , Hhd         , Hhd         , Hhd         , Hhd         , Hhd         , Hhd         , Hhd         , Mm          , Mm          , Mm          , Mm          , Mm          , Mm          , Mm          , Mm          , Hd          , Mm          , Mm          , Mm          , Mm          , Mm          , Mm          , Mm          , Mm          , Mm          , Hd          , Mm          , Mm          , Mm          , Mm          , Mm          , Mm          , Mm          , Mm          , Mm          , Mm          
