Md, Md, Md, Md, Hd, Md, Md, Md, Md, Md, Md, Md, Md, Md, Md, Md, Md, Md, Md, Md, Md, Md, Hd, Md, Md, Md, Md, Md, Md, Md, Md, Md, Md, Md, Md, Md, Md, Md, Md, Md, Md, Md, Md, Md, Md, Md, Md, Md, Md, Md, Md, Md, Md, Md, Md, Md, Md, Md, Md, Md, Md, Md, Md, Md
Md, Md, Md, Md, Hd, Hd, Md, Md, Md, Md, Md, Md, Md, Md, Md, Md, Md, Md, Md, Md, Md, Md, Hd, Md, Md, Md, Md, Md, Md, Md, Hd, Hd, Hd, Md, Md, Md, Md, Md, Md, Md, Md, Md, Md, Hd, Hd, Hd, Md, Md, Md, Md, Md, Md, Md, Md, Md, Md, Md, Md, Md, Md, Md, Md, Md, Md
Md, Md, Md, Md, Md, Hd, Hd, Md, Md, Md, Md, Md, Md, Md, Mm^Vhh, Md, Md, Md, Md, Md, Md, Hd, Md, Md, Md, Md, Md, Hd, Md, Hd, Wwt, Wwt, Hd, Hd, Hd, Md, Md, Md, Md, Md, Md, Md, Md, Hd, Md, Md, Md, Md, Md, Mm^Vhh, Md, Md, Md, Md, Md, Md, Md, Md, Md, Ce, Ce, Ce, Md, Md
Md, Md, Md, Md, Md, Md, Hhd, Hhd, Hhd, Hhd, Hhd, Hhd, Md, Md, Md, Md, Md, Md, Md, Md, Hd, Hd, Md, Md, Md, Md, Md, Hd, Wwt, Wwt, Wwt, Wwt, Wwt, Wwt, Hd, Md, Hd, Md, Hd, Md, Hd, Hd, Hd, Hd, Hd, Md, Hd, Md, Hd, Hd, Hd, Md, Hd, Md, Md, Hd, Hd, Hd, Md, Ce, 7 Ke, Ce, Md, Md
Md, Md, Md, Md, Md, Md, Hhd, Hhd, Hhd, Hhd, Hhd, Hhd, Md, Md, Md, Md, Md, Md, Hhd, Md, Md, Md, Md, Md, Md, Md, Hd, Hd, Wwt, Wwt, Wot, Wot, Wwt, Wwt, Ds^Es, Hd, Md, Hd, Md, Md, Md, Md, Md, Md, Md, Hd, Md, Md, Md, Hd, Hd, Hd, Md, Hd, Md, Hd, Md, Md, Md, Md, Ce, Md, Md, Md
Md, Md, Md, Md, Md, Md, Hhd, Hhd, Ce, Ce, Ce, Ce, Md, Md, Md, Md, Gs^Fp, Hh^Fp, Hh^Fp, Hhd, Md, Md, Md, Md, Md, Md, Hd, Ds, Wwt, Wwt, Wot, Wot, Wot, Wwt, Wwt, Hd, Md, Md, Md, Md, Md, Md, Md, Md, Md, Md, Md, Md, Md, Md, Hd, Md, Md, Md, Md, Md, Md, Md, Md, Md, Md, Md, Md, Md
Md, Md, Md, Md, Md, Md, Hhd, Hhd, Ce, 5 Ke, Ce, Ce, Md, Md, Md, Md, Hh^Fp, Gs^Fp, Gs^Fp, Md, Md, Md, Md, Md, Md, Hd, Hd, Ds, Wwt, Wwt, Wwt, Wot, Wwt, Wwt, Wwt, Md, Md, Md, Md, Md, Md, Md, Md, Md, Md, Md, Md, Md, Hd, Hd, Md, Md, Md, Md, Md, Md, Md, Md, Md, Hd, Md, Md, Md, Md
Md, Md, Md, Md, Md, Hhd, Hhd, Ce, Ce, Ce, Ce, Md, Md, Md, Md, Md, Gs^Fp, Gs^Fp, Gs^Fp, Gs^Fp, Hh^Fp, Md, Md, Md, Hd, Hd, Hhd^Fp, Gd^Fp, Gs^Fp, Wwt, Wwt, Wwt, Wwt, Wwt, Wwt, Hh^Fp, Gs^Fp, Hh^Fp, Gs^Fp, Gs^Fp, Gs^Em, Gs^Fp, Md, Md, Md, Md, Md, Md, Md, Md, Md, Md, Md, Md, Md, Md, Md, Md, Md, Hd, Md, Md, Md, Md
Md, Md, Md, Md, Md, Hhd, Hhd, Hhd, Hhd, Hhd, Hhd, Gd, Md, Md, Md, Md, Hh^Fp, Gs^Fp, Gs^Fp, Gs^Fp, Gs^Fp, Md, Md, Md, Md, Md, Gs^Fp, Gs^Fp, Gs^Fp, Hh^Fp, Gs^Fp, Wwt, Ds, Wwt, Gs^Fp, Gs^Fp, Gs^Fp, Gs^Fp, Gs^Fp, Gs^Fp, Gs^Fp, Gs^Fp, Gs^Fp, Gs^Fp, Hh^Fp, Md, Md, Hhd, Md, Md, Md, Md, Md, Md, Md, Md, Md, Md, Md, Hd, Md, Md, Md, Md
Md, Md, Md, Md, Md, Md, Hhd, Hhd, Gd, Hhd, Gd, Gd, Hhd, Hhd, Md, Md, Hh^Fp, Gs^Fp, Hh^Fp, Gs^Fp, Gs^Fp, Hh^Fp, Gs^Fp, Hh^Fp, Gs^Fp, Gs^Fp, Gd^Fp, Gs^Fp, Hh^Fp, Gs^Fp, Gs^Fp, Gs^Fp, Gs^Fp, Gs^Fp, Gs^Fp, Gs^Fp, Hh^Fp, Hh^Fp, Gs^Fp, Hh^Fp, Gs^Fp, Gs^Fp, Gs^Fp, Gs^Fp, Gs^Fp, Gs^Fp, Gs^Fp, Gd^Fp, Md, Md, Md, Md, Md, Md, Md, Md, Md, Md, Hd, Hd, Md, Md, Md, Md
Md, Md, Hd, Hd, Hd, Md, Hd, Hd, Gd, Gd, Gd, Gd, Hhd^Vhh, Md, Md, Md, Gs^Fp, Gs^Fp, Gs^Fp, Gs^Fp, Gs^Fp, Gs^Fp, Gs^Fp, Gs^Fp, Gd^Fp, Gd^Fp, Hhd^Fdf, Gd^Fp, Hhd^Fdf, Hh^Fp, Gs^Fp, Gs^Fp, Gs^Fp, Gs^Fp, Gs^Fp, Gs^Fp, Gs^Fp, Gs^Fp, Gs^Fp, Gs^Fp, Hh^Fp, Gs^Fp, Hh^Fp, Gs^Fp, Hh^Fp, Gs^Fp, Gs^Fp, Gs^Fp, Md, Md, Md, Md, Md, Mm^Vhh, Md, Md, Md, Hd, Md, Md, Md, Md, Md, Md
Md, Hd, Md, Md, Md, Hd, Hhd, Hhd, Hhd, Hhd, Hhd, Gd, Gd, Hhd, Md, Md, Hh^Fp, Gs^Fp, Gs^Fp, Gs^Fp, Gs^Fp, Gs^Fp, Gg^Ve, Gd^Fp, Hhd^Fdf, Hhd^Fdf, Hhd^Fdf, Hhd^Fdf, Hhd^Fdf, Gd^Fp, Gs^Fp, Hh^Fp, Gs^Fp, Hh^Fp, Hh^Fp, Gs^Fp, Gs^Fp, Gs^Fp, Gs^Fp, Gs^Fp, Hh^Fp, Hhd, Hhd, Hh^Fp, Hh^Fp, Hh^Fp, Hh^Fp, Hh^Fp, Hh^Fp, Hh^Fp, Md, Md, Md, Md, Md, Md, Hd, Hd, Md, Md, Mm^Vhh, Md, Md, Md
Md, Hd, Md, Md, Md, Md, Hhd, Hhd, Hhd, Hhd, Hhd, Hhd, Gd, Gd, Md, Hh^Fp, Gs^Fp, Gs^Fp, Gs^Fp, Gs^Fp, Gs^Fp, Wwt, Wwt^Es, Wwt, Wwt, Wwt, Wwt, Wwt, Wwt, Wwt, Wwt^Es, Mm, Mm, Hh, Hh, Hh, Ch, Ch, Ch, Gs^Fp, Hhd, Hhd, Hhd, Hhd, Hhd, Hhd, Hhd, Hhd, Hhd, Hhd, Hhd, Hhd, Md, Md, Md, Md, Hd, Md, Md, Md, Md, Md, Md, Md
Md, Md, Md, Md, Md, Md, Md, Md, Md, Md, Md, Md, Hhd, Gd, Gs, Gg, Gs, Gg, Gg, Gg, Gd, Hhd^Fdf, Gs, Wwt, Wwt, Wot, Wot, Wwt, Wot, Wwt, Wwt, Wwt, Wwt, Wwt, Wwt, Wwt, Ch, 6 Kh, Ch, Mm, Mm, Mm, Mm, Mm, Mm, Mm, Mm, Mm, Mm, Mm, Mm, Hhd, Hhd, Md, Hd, Hd, Md, Md, Md, Md, Md, Md, Md, Md
Md, Md, Md, Md, Md, Md, Md, Md, Md, Md, Md, Hhd, Hh, Hh, Hh, Gs, Hh, Gd, Gd, Gs^Fp, Gs^Fp, Hhd^Fdf, Wwt^Es, Wwt, Wwt, Wot, Wot, Wot, Wot, Wot, Wot, Wwt, Wot, Wwt, Wwt, Wwt, Ch, Ch, Ch, Hh^Fms, Hh^Fms, Hh^Fms, Hh^Fms, Hhd, Gg^Ve, Mm, Mm, Mm, Mm, Mm, Mm, Mm, Hhd, Hd, Md, Md, Md, Md, Md, Md, Md, Md, Md, Md
Md, Md, Md, Md, Md, Md, Md, Md, Md, Md, Md, Hhd, Hh, Hh, Hhd, Hh, Hhd^Fdw, Hhd^Fdw, Hhd^Fdw, Hhd^Fdw, Gs^Fp, Gd^Fp, Hhd^Fdf, Hhd^Fdf, Wwt, Wwt, Wwt^Es, Wwt, Wwt, Wot, Wot, Wot, Wot, Wot, Wwt, Wwt, Hhd^Fdf, Hh, Re, Gs, Gd, Hh^Fp, Hh^Fp, Hh^Fp, Hh^Fp, Hh^Fp, Hh^Fp, Hh^Fp, Hh^Fp, Hh^Fp, Hh^Fp, Hh^Fp, Hhd, Hhd, Md, Md, Md, Md, Md, Md, Md, Md, Md, Md
Md, Md, Md, Md, Md, Mm^Vhh, Md, Md, Md, Md, Hhd, Hh, Hh, Hh, Hhd^Fms, Hhd^Fdw, Hhd^Fdw, Hhd^Fdw, Hhd^Fp, Gs^Fp, Gs^Fp, Gd^Fp, Gd^Fp, Hhd^Fdf, Hhd^Fdf, Hhd^Fdf, Gs^Fp, Wwt, Wwt, Wwt, Wwt, Wwt, Wwt, Wwt, Wwt, Wwt, Hhd^Fdf, Hh^Fp, Re, Re, Gd, Hhd, Hhd, Hh^Fms, Hh^Fms, Hhd, Hh^Fms, Hhd, Hh^Fp, Hh^Fp, Hh^Fp, Hh^Fp, Hh^Fp, Hh^Fp, Hh^Fp, Hh^Fp, Md, Md, Md, Md, Md, Md, Md, Md
Md, Md, Md, Md, Md, Md, Md, Md, Hd, Hd, Hhd, Hhd, Hhd, Hh^Fms, Hh^Fms, Hhd^Fp, Gs^Fp, Hhd^Fp, Gs^Fp, Gs^Fp, Hh^Fp, Gs^Fp, Gs^Fp, Gd^Fp, Gd^Fp, Gd^Fp, Gs^Fp, Re, Re, Hhd^Fdf, Wwt, Wwt, Wwt, Wwt, Wwt^Es, Wwt, Hhd^Fdf, Hhd^Fdf, Re, Re, Gs^Fp, Hh^Fp, Gs^Fp, Hhd, Hhd, Hh^Fp, Hh^Fms, Hhd, Hh^Fms, Hhd, Hhd, Hh^Fp, Hh^Fp, Hh^Fp, Hh^Fp, Hh^Fp, Hh^Fp, Md, Md, Md, Md, Md, Md, Md
Md, Md, Md, Md, Md, Md, Md, Hd, Md, Md, Md, Md, Md, Md, Md, Md, Md, Md, Md, Md, Gd^Ve, Gg, Gg, Gg, Gg, Re, Re, Re, Re, Re, Re, Re, Re, Re, Re, Re, Re, Re, Re, Wwt, Wwt, Md, Md, Md, Md, Md, Md, Md, Md, Md, Md, Md, Md, Md, Md, Md, Md, Hd, Hd, Md, Md, Md, Md, Md
Hd, Md, Hd, Hd, Md, Hd, Md, Md, Md, Md, Mm^Vhh, Md, Md, Hhd, Hhd, Hhd, Hhd, Hhd, Hhd, Hhd, Gd, Gs, Gg, Gg, Re, Re, Gg^Vh, Gg, Gg, Gg, Gg, Gg, Gg, Gg, Gg, Gg, Gg, Gg^Vh, Gg, Wwt, Wwt, Wwt, Wwt, Md, Md, Md, Md, Md, Md, Md, Md, Md, Md, Md, Md, Md, Md, Md, Md, Hd, Hd, Md, Md, Md
Md, Hd, Md, Md, Md, Md, Md, Md, Md, Md, Md, Hhd, Hhd, Hhd, Hh, Hh, Hh, Gd, Gs, Gd, Gs, Gg, Re, Re, Hh, Hh, Hh, Hh, Hh, Gs, Hh, Gg, Gs, Gg, Hh, Hh, Hh, Gg, Hh, Gg, Gs, Gg, Gd, Hd, Md, Md, Md, Md, Md, Md, Md, Md, Md, Md, Md, Md, Md, Md, Md, Md, Md, Hd, Hd, Md
Md, Md, Md, Md, Md, Md, Md, Md, Md, Md, Hhd, Hhd, Hh, Hh, Gg, Hh, Gs, Gs, Hh, Hh, Hh, Re, Re, Hh, Hh, Hh, Hh, Hh, Hh, Hh, Hh, Hh, Gs^Vl, Hh, Hh, Hh, Hh, Hh, Hh, Hh, Hh, Gd, Gd, Hd, Hd, Hd, Hd, Hd, Md, Md, Md, Md, Md, Md, Md, Md, Md, Md, Md, Md, Md, Hd, Md, Md
Md, Md, Md, Md, Md, Md, Md, Md, Md, Hhd, Hhd, Hh, Gg, Gg, Gs, Gs, Gg, Gg, Hh, Hh, Re, Re, Hhd, Hh, Hhd, Hh, Hh, Hh, Hh, Hh, Hh^Fp, Hh^Fp, Hh^Fp, Hh^Fp, Hh^Fp, Hh, Hh, Hh, Hhd, Hhd, Hhd, Hhd, Hhd, Gd, Gd^Vh, Hd, Hd, Hd, Hd, Hd, Hd, Md, Hd, Md, Md, Mm^Vhh, Md, Md, Md, Md, Md, Md, Md, Md
Md, Md, Md, Md, Md, Md, Md, Md, Md, Hhd, Hhd, Gd, Gs, Gs, Hh, Hh, Hh, Hh, Hh, Hh, Re, Re, Hhd, Hhd, Mm, Hhd, Hhd, Hh^Fp, Hh^Fp, Hh^Fp, Hh^Fp, Hh^Fp, Hh^Fp, Hh^Fp, Hh, Hh, Hh, Hhd, Hd, Md, Md, Md, Md, Md, Md, Md, Md, Hd, Md, Md, Md, Hd, Md, Hd, Hd, Hd, Hd, Md, Md, Md, Md, Md, Md, Md
Md, Md, Md, Md, Md, Md, Md, Md, Hd, Hhd, Hhd, Gd, Gd, Gg, Hh, Hh, Mm, Mm, Hh^Fp, Hh^Fp, Re, Re, Hhd, Mm, Hhd, Hh^Fp, Hh^Fp, Hh^Fp, Hh^Fp, Hh^Fp, Hh^Fp, Hh^Fp, Hh^Fp, Hh^Fp, Hh^Fp, Hh, Hhd, Hhd, Md, Hd, Hd, Md, Md, Md, Hd, Hd, Md, Md, Md, Md, Md, Hd, Hd, Md, Md, Md, Md, Hd, Hd, Md, Md, Md, Md, Md
Md, Md, Md, Md, Hd, Hd, Hd, Hd, Md, Hhd, Hhd, Hhd, Hhd, Gg^Vh, Ce, Hhd, Ce, Hh, Hh, Hh^Fp, Hh^Fp, Re, Re, Hhd, Hhd, Hhd, Hh^Fp, Hh^Fp, Hh^Fp, Hh^Fp, Hh^Fp, Hh^Fp, Hh^Fp, Hh^Fp, Hh^Fp, Hh^Fp, Hh^Fp, Hh^Fp, Md, Md, Md, Hd, Hd, Hd, Md, Md, Md, Md, Md, Md, Md, Md, Hd, Md, Md, Md, Md, Md, Md, Hd, Hd, Hd, Md, Md
Md, Md, Md, Md, Hd, Md, Mm^Vhh, Md, Md, Md, Md, Hhd, Hhd, Hhd, Hhd, Ce, Hhd, Hh, Hh, Ce, Ce, Hhd, Re, Re, Hhd, Hhd, Ce, Hh^Fp, Hhd, Hhd, Hh^Fp, Hh^Fp, Hh^Fp, Hh^Fp, Hh^Fp, Hh^Fp, Md, Md, Md, Md, Md, Md, Hd, Md, Md, Md, Md, Md, Md, Md, Md, Md, Hd, Hd, Md, Md, Md, Md, Md, Md, Md, Hd, Hd, Md
Md, Md, Hd, Hd, Md, Md, Md, Md, Md, Md, Md, Md, Hhd, Hhd, Hhd, 3 Ke, Hhd, Hhd, Hh, Ce, 1 Ke, Hhd, Re, Re, Ce, 2 Ke, Ce, Hhd, Ce, Mm, Mm, Mm, Gll^Ve, Hh^Fp, Hh^Fp, Hh^Fp, Md, Md, Md, Md, Md, Md, Hd, Md, Md, Md, Md, Md, Md, Md, Md, Mm^Vhh, Md, Hd, Md, Md, Md, Md, Md, Md, Md, Md, Mm^Vhh, Hd
Hd, Hd, Md, Md, Md, Md, Md, Md, Md, Md, Md, Md, Md, Md, Md, Md, Md, Md, Hh, Hh, Hhd, Hh, Re, Re, Mm, Mm, Mm, Hhd, Ce, 4 Ke, Ce, Hhd, Hhd, Hhd, Hhd, Md, Md, Md, Md, Md, Md, Md, Hd, Md, Md, Md, Md, Md, Md, Md, Md, Md, Md, Hd, Hd, Md, Md, Md, Md, Md, Md, Md, Md, Md
Md, Md, Md, Md, Md, Md, Md, Md, Md, Md, Md, Md, Md, Md, Md, Md, Md, Md, Hhd, Hhd, Hhd, Hhd, Re, Re, Mm, Mm, Mm, Hhd, Hhd, Hhd, Hhd, Hhd, Hhd, Hhd, Hhd, Md, Md, Md, Md, Md, Md, Md, Md, Hd, Md, Md, Md, Md, Md, Md, Md, Md, Md, Hd, Md, Md, Md, Md, Md, Md, Md, Md, Md, Md
