Mm, Mm, Hh^Fp, Hh^Fp, Gs^Fms, Gs^Fms, Gs^Fms, Gs^Fms, Ds, Ww, Ww, Ww, Ww, Ww, Ww, Hhd, Hh, Hh, Hh, Hh, Gg, Gg, Gg, Gg, Gg, Gg, Gs, Hh, Hh, Hh, Hh, Hhd, Hhd, Hhd, Hhd, Hhd, Ms, Aa^Fpa, Ms, Ms, Ms, Ms, Ms, Ms, Ms, Ms^Xm, Ms^Xm, Ms^Xm, Ms^Xm, Ms^Xm, Ms^Xm, Ms^Xm, Ms^Xm, Ms^Xm, Ms^Xm, Ms^Xm, Ms^Xm, Ms^Xm, Ms^Xm, Ms^Xm, Ms^Xm, Ms^Xm
Mm, Mm, Hh^Fp, Hh^Fp, Hh^Fp, Gs^Fms, Gs^Fms, Ds, Ds, Wwr, Ww, Ww, Ww, Ww, Ww, Hhd, Ww, Hh, Hh, Hh, Gg, Gg, Gg, Gg, Gg, Hh, Gg, Gs, Hh, Hh, Hhd, Hhd, Hh, Hhd, Hhd, Hhd, Ms, Ms, Ms, Aa^Fpa, Aa^Fpa, Ms, Ms, Ms, Ms, Ms^Xm, Ms^Xm, Ms^Xm, Ms^Xm, Ms^Xm, Ms^Xm, Ms^Xm, Ms^Xm, Ms^Xm, Ms^Xm, Ms^Xm, Ms^Xm, Ms^Xm, Ms^Xm, Ms^Xm, Ms^Xm, Ms^Xm
Mm, Mm, Mm, Hh^Fp, Gs^Fms, Gs^Fms, Gs^Fms, Ds, Ww, Ww, Ww, Ww, Ww, Ww, Ww, Ww, Hhd, Hh, Hh, Gg, Gg, Gg, Gg, Gg^Efm, Gg, Gs, Gs, Hh, Hh, Hhd, Hh, Hhd, Hhd, Hhd, Hhd, Hhd, Ms, Ms, Aa^Fpa, Aa^Fpa, Ms, Ms, Ms, Ms, Ms, Ms^Xm, Ms^Xm, Ms^Xm, Ms^Xm, Ms^Xm, Ms^Xm, Ms^Xm, Ms^Xm, Ms^Xm, Ms^Xm, Ms^Xm, Ms^Xm, Ms^Xm, Ms^Xm, Ms^Xm, Ms^Xm, Ms^Xm
Mm, Mm, Mm, Hh^Fp, Hh^Fp, Gs^Fms, Gs^Fms, Ds, Ds, Ww, Ww, Ww, Ww, Ww, Hhd, Hh, Hhd, Hh, Hh, Hh, Gg, Gg, Gg, Gg, Gg, Gg, Gs, Hhd, Gs, Hhd, Gs, Hh, Hhd, Hh, Hhd, Hhd, Ms, Ms, Aa^Fpa, Aa^Fpa, Aa^Fpa, Ms, Ms, Ms, Ms, Ms^Xm, Ms^Xm, Ms^Xm, Ms^Xm, Ms^Xm, Ms^Xm, Ms^Xm, Ms^Xm, Ms^Xm, Ms^Xm, Ms^Xm, Ms^Xm, Ms^Xm, Ms^Xm, Ms^Xm, Ms^Xm, Ms^Xm
Mm, Mm, Gs^Fms, Gs^Fms, Hh^Fp, Gs^Fms, Gs^Fms, Gs^Fms, Ds, Ww, Ww, Ww, Ww, Ww, Ww, Hh, Hh, Hh, Hh, Hh, Gg, Gg, Gg^Efm, Gg, Gg, Hh, Hhd, Hh, Hhd, Hh, Hh, Hhd, Hhd, Hhd, Hhd, Hhd, Aa^Fpa, Aa^Fpa, Aa^Fpa, Ms, Aa^Fpa, Ms, Ms, Ms, Ms, Ms^Xm, Ms^Xm, Ms^Xm, Ms^Xm, Ms^Xm, Ms^Xm, Ms^Xm, Ms^Xm, Ms^Xm, Ms^Xm, Ms^Xm, Ms^Xm, Ms^Xm, Ms^Xm, Ms^Xm, Ms^Xm, Ms^Xm
Mm, Mm, Hh^Fp, Hh^Fp, Gs^Fms, Gs^Fms, Gs^Fms, Gs^Fms, Ds, Ww, Ww, Ww, Ww, Ww, Hhd, Hh, Ww, Hh, Hh, Gg, Gg, Gg, Gg, Gg, Gg, Hh, Gg, Gs, Hh, Hhd, Hhd, Hhd, Hhd, Hhd, Hhd, Hhd, Ms, Ms, Ms, Aa^Fpa, Ms, Ms, Ms, Ms, Ms, Ms^Xm, Ms^Xm, Ms^Xm, Ms^Xm, Ms^Xm, Ms^Xm, Ms^Xm, Ms^Xm, Ms^Xm, Ms^Xm, Ms^Xm, Ms^Xm, Ms^Xm, Ms^Xm, Ms^Xm, Ms^Xm, Ms^Xm
Hh^Fp, Hh^Fp, Hh^Fp, Gs^Fms, Gs^Fms, Gs^Fms, Gs^Fms, Ds, Ww, Ww, Ww, Ww, Ww, Ww, Hhd, Hhd, Hh, Hh, Hh, Hh, Gg, Gg, Gg, Gg, Gg, Gg^Efm, Gg, Hh, Hhd, Hhd, Hhd, Hh, Hhd, Hhd, Hhd, Hhd, Ms, Ms, Aa^Fpa, Ms, Aa^Fpa, Ms, Ms, Ms, Ms, Ms, Ms^Xm, Ms^Xm, Ms^Xm, Ms^Xm, Ms^Xm, Ms^Xm, Ms^Xm, Ms^Xm, Ms^Xm, Ms^Xm, Ms^Xm, Ms^Xm, Ms^Xm, Ms^Xm, Ms^Xm, Ms^Xm
Hh^Fp, Hh^Fp, Gll^Fp, Gs^Fms, Re^Gvs, Gs^Fms, Gll^Fp, Gll^Fp, Gs^Fms, Ww, Ww, Ww, Ww, Ww, Ww, Hh, Gll, Gg, Gg, Gg, Gs, Gg, Gg, Gg^Es, Hh, Gs, Hh, Hh, Hh, Hhd, Mm, Hhd, Gll^Fp, Hhd, Ms, Ms, Ms, Ms, Ms, Ms, Ms, Ms, Ms, Ms, Ms, Ms, Ms^Xm, Ms^Xm, Ms^Xm, Ms^Xm, Ms^Xm, Ms^Xm, Ms^Xm, Ms^Xm, Ms^Xm, Ms^Xm, Ms^Xm, Ms^Xm, Ms^Xm, Ms^Xm, Ms^Xm, Ms^Xm
Hh^Fp, Hh^Fms, Gll^Fp, Re^Gvs, Re^Gvs, Gs^Fms, Gs^Fds, Gs^Fds, Gs^Fms, Ds, Ww, Ww, Ww, Ww, Ww, Gd, Gd, Gg, Gg, Gg, Gg, Gg, Gs, Hh, Mm, Hh, Hhd, Hhd, Hhd, Mm, Mm, Mm, Gll^Fp, Gll^Fp, Aa^Fpa, Ms, Ms, Ms, Ms, Ms, Ms, Ms, Ms, Ms, Ms, Ms, Ms, Ms^Xm, Ms^Xm, Ms^Xm, Ms^Xm, Ms^Xm, Ms^Xm, Ms^Xm, Ms^Xm, Ms^Xm, Ms^Xm, Ms^Xm, Ms^Xm, Ms^Xm, Ms^Xm, Ms^Xm
Hh^Fp, Hh^Fp, Gs^Fms, Re^Gvs, Gs^Fp, Re^Ve, Gll^Fp, Gll^Fp, Gs^Fms, Ds, Ww, Ww, Ww, Wwr, Ww, Ww^Es, Gs, Gg, Gs, Gg, Rb, Rb, Hhd, Hhd, Mm, Hhd, Hhd, Hhd, Hhd^Fp, Hhd, Hhd^Fp, Mm, Gll^Fp, Gll^Fp, Hhd^Fp, Mm, Aa^Fpa, Ha^Vhha, Ms, Ms, Ms, Ms, Ms, Ms, Ms, Ms, Ms, Ms, Ms^Xm, Ms^Xm, Ms^Xm, Ms^Xm, Ms^Xm, Ms^Xm, Ms^Xm, Ms^Xm, Ms^Xm, Ms^Xm, Ms^Xm, Ms^Xm, Ms^Xm, Ms^Xm
Hh^Fms, Hh^Fms, Gs^Fds, Gs^Fms, Gs^Fds, Gs^Fms, Gs^Em, Gs^Fms, Ds^Es, Ds, Ww, Ww, Ww, Ww, Ds, Gg^Es, Gg, Gg^Efm, Gg, Gg, Rb, Rb^Vc, Re, Hhd, Hhd^Fp, Hhd, Hh, Hhd, Hhd, Gd^Fp, Hhd, Gll^Fp, Hhd, Hhd^Fp, Gd^Fp, Hhd^Fp, Ms, Aa^Fpa, Ms, Ms, Ha^Vhha, Ms, Ms, Ms, Ha^Vhha, Ms, Ms, Ms, Ms, Ms^Xm, Ms^Xm, Ms^Xm, Ms^Xm, Ms^Xm, Ms^Xm, Ms^Xm, Ms^Xm, Ms^Xm, Ms^Xm, Ms^Xm, Ms^Xm, Ms^Xm
Gs^Fms, Gs^Fms, Gg^Efm, Gs^Fms, Gs^Fms, Gll^Fp, Gs^Fds, Rd, Ds, Ww, Ww, Ww, Ww, Ww, Ww, Gg, Gs, Gs, Gg, Gg^Es, Gg, Re, Gs, Gll^Fp, Gd, Gs^Fet, Gs^Es, Hhd, Gd, Hhd, Hh, Hhd, Hhd, Hhd^Fp, Hhd, Aa^Fpa, Mm, Mm, Mm, Ms, Ms, Ms, Ms, Ms, Ms, Ms, Ms, Ms, Ms, Ms, Ms, Ms^Xm, Ms^Xm, Ms^Xm, Ms^Xm, Ms^Xm, Ms^Xm, Ms^Xm, Ms^Xm, Ms^Xm, Ms^Xm, Ms^Xm
Gs^Fms, Gs^Fms, Gs^Fms, Gll^Uf, Gll^Uf, Gs^Fms, Gs^Fms, Gll^Fp, Gs^Fms, Ds, Ww, Ww^Vm, Ww, Ww, Ww, Gg, Gs, Gs, Gg, Gg, Hh, Gs, Hh, Gd, Hhd, Gd, Hh, Gd, Hhd, Mm, Mm, Hh, Mm, Hhd, Mm, Hhd, Mm, Mm, Mm, Mm, Aa^Vea, Ms, Ms, Ms, Ms, Ms, Ms, Ms, Ms, Ms, Ms, Ms, Ms, Ms^Xm, Ms^Xm, Ms^Xm, Ms^Xm, Ms^Xm, Ms^Xm, Ms^Xm, Ms^Xm, Ms^Xm
Gs^Fms, Gs^Fms, Gll^Uf, Gll^Uf, Gll^Fp, Gs^Fds, Gs^Fms, Gs^Fms, Gg^Fet, Ds, Ww, Ww, Ww, Ww, Ww, Gg, Gg, Gs, Hh, Gs, Hh, Hh, Hhd, Hhd, Mm, Mm, Hh, Hhd, Mm, Mm, Mm, Mm, Mm, Mm, Mm, Mm, Mm, Mm, Mm, Mm, Mm, Ms, Ms, Ms, Ms, Ms, Ms, Ms, Ms, Ms, Ms, Ms, Ms, Ms, Ms, Ms, Ms, Ms^Xm, Ms, Ms^Xm, Ms, Ms
Mm, Gs^Fms, Gll^Fp, Gs^Fms, Ss, Gs^Fds, Gs^Fms, Gs^Fms, Gs^Fms, Ds, Ww, Ww, Ww, Ww, Wwf^Es, Wwf^Es, Gg, Hh, Gg, Hh, Gs, Hh, Gd, Hhd, Mm, Hhd, Hh, Hhd, Hhd, Mm, Mm, Mm, Mm, Mm, Mm, Mm, Mm, Mm, Mm, Mm, Mm, Mm, Gd^Fmf, Ms, Aa^Vea, Ms, Ms, Ms, Ms, Ms, Ms, Ms, Ms, Ms, Ms, Ms, Ms, Ms, Ms, Ms, Ms, Ms
Mm, Mm, Mm, Gs^Fms, Gs^Fms, Gs^Fms, Wwg^Es, Gs^Fms, Ww, Ds, Ww, Ww, Wwf^Es, Wwrg, Wwf^Es, Wwrg, Wwf^Es, Gg, Gg, Gg, Hh, Gs, Hh, Hhd, Hhd, Hhd, Hh, Hh, Hhd, Hhd, Hhd, Mm, Hhd, Mm, Gll^Fp, Mm, Gll^Fp, Mm, Hh^Fp, Mm, Hhd^Fmf, Mm, Gll^Fp, Gg, Gg, Gg, Gll^Fp, Gll^Fp, Gll^Fp, Ms, Ms, Ms, Ms, Ms, Ms, Ms, Ms, Ms, Ms, Ms, Ms, Ms
Mm, Mm, Mm, Gs^Fms, Ss, Gs^Fms, Gs^Efm, Ww, Ww^Bw|, Ww, Ww, Rd, Rd, Wwf^Es, Wwf, Wwf^Es, Ww^Es, Gg, Gs, Gg, Hh, Hh, Hh, Hhd, Hh, Hh, Hh, Hh, Hh, Hhd, Hh, Hhd, Hh, Hh^Fp, Hhd, Hh^Fp, Gll^Fp, Gll^Fp, Gll^Fp, Gd^Fp, Gd^Fp, Gd^Fp, Gll^Fp, Gg, Gll^Fp, Gll^Fp, Gll^Fp, Gll^Fp, Gll^Fp, Ms, Ms, Ms, Ms, Ms, Ms, Ms, Ms, Ms, Ms, Ms, Ms, Ms
Mm, Mm, Ss, Gll^Uf, Gs^Fds, Gs^Fms, Gs^Fms, Ww, Gs, Ww, Gd, Rd, Gd, Wwrg, Ww^Es, Wwr, Wo^Es, Gg, Gg, Gg, Gg^Es, Hh, Gg, Hh, Gg, Hh, Gs, Gs, Gg, Hh, Gg, Hh, Gg, Hh, Gs, Gll^Fp, Gg, Gll^Fp, Gs, Gll^Fp, Gll^Fp, Gll^Fp, Gll^Fp, Gll^Fp, Gll^Fp, Gll^Fp, Gll^Em, Gll^Fp, Gg^Es, Gll^Fp, Gll^Fp, Ms, Gg^Es, Ms, Gll^Fp, Ms, Gll^Fp, Ms, Gg^Em, Gll^Fp, Gll^Fp, Gll^Fp
Gs^Fds, Gs^Fds, Gs^Fms, Gll^Uf, Gs^Fms, Ss, Gs^Fds, Gs^Fms, Gs^Efm, Gg, Gs, Gd, Gs, Gs, Gg, Wo, Wo, Wo, Ww, Gg, Gs, Gg, Gs, Gg, Gg, Gg, Gg, Gg, Gs^Fds, Gs, Gg, Gg, Gg, Gg, Gg, Rp^Ve, Rp, Gg, Gg, Gg, Rrc, Gs^Fms, Rrc, Gs^Fms, Rr^Ve, Gll^Fp, Gg, Gs^Fms, Gll^Fp, Gll^Fp, Gll^Fp, Gll^Fp, Gll^Fp, Gll^Fp, Gs^Fms, Gll^Fp, Gg, Gs^Fms, Gs^Fms, Gll^Fp, Gll^Fp, Gll^Fp
Gs^Fms, Gll^Uf, Gs^Fds, Gs^Fms, Gs^Fds, Gs^Fms, Gs^Fms, Gs^Fms, Rb, Gg, Gs, Gs, Gg, Gg^Es, Gg, Gg, Ww, Ww^Es, Wo, Gg, Gll^Fp, Gs^Fds, Gll^Fp, Gs, Gll^Fp, Gs, Gll^Fp, Gs^Fds, Gll^Fp, Gs^Fds, Gll^Fp, Gs^Fms, Gll^Fp, Gg^Es, Gll^Fp, Gg, Rp, Gg, Rrc, Rrc, Gs^Fms, Rrc, Gs^Fms, Rrc, Rrc, Rrc, Rrc, Gs^Fms, Gg, Gg^Em, Gs^Fms, Gs^Fms, Gg^Em, Gs^Fms, Gll^Fp, Gg, Gll^Fp, Gg, Gs^Fms, Gll^Fp, Rrc, Rrc
Gs^Fds, Ss, Gs^Fds, Gs^Fms, Gg^Efm, Gs^Fms, Gs^Fds, Gs^Fds, Gs^Fds, Rr^Ve, Rr, Gs, Gg, Gg, Gll^Fp, Gs^Fds, Gs^Fds, Wo, Ww, Ww, Ww, Gll^Fp, Gs^Fms, Gs^Fms, Hh^Fms, Hh^Fms, Gs^Fms, Gs^Fms, Gs^Fms, Gs^Fms, Gll^Fp, Gs^Fms, Re^Ve, Gs^Fms, Gll^Fp, Gs^Fms, Rrc, Rrc, Gs^Vhs, Gs^Em, Gs^Fms, Rr^Ve, Gs^Fms, Gs^Fms, Gs^Fms, Gs^Fms, Rrc, Gll^Fp, Gll^Fp, Gs^Fms, Gs^Fms, Gs^Fms, Gs^Fms, Gg, Gll^Fp, Gs^Fms, Gg, Gs^Fms, Gg, Rrc, Gg, Gs^Fms
Gs^Fds, Gs^Fms, Gs^Fds, Gs^Fds, Re^Ve, Gs^Fds, Re, Gs^Fms, Re, Re, Gs, Rr, Rr, Gs, Gll^Fp, Gs^Fds, Gs^Fds, Ww, Ww^Es, Ww^Es, Ww, Gs^Fms, Gs^Fds, Gs^Fms, Hh^Fds, Hh^Fms, Re^Vhs, Gs^Fms, Gs^Fet, Gs^Fms, Gs^Fms, Gs^Fms, Re, Gs^Fms, Rrc, Rrc, Gs^Fms, Rp, Rp, Gs^Fms, Gs^Fms, Gs^Fms, Gs^Fms, Gll^Fp, Hh^Fp, Gs^Fms, Gs^Fms, Rrc, Rrc, Rrc, Rrc, Gll^Fp, Rrc, Gll^Fp, Rrc, Gll^Fp, Rrc, Rrc, Rrc, Rrc, Md, Gs^Fms
Gs^Fds, Gs^Fds, Gs^Gvs, Re^Gvs, Gs^Fds, Re, Gs^Fms, Re, Gs^Fds, Gs^Fds, Gg, Gg, Rp, Gs, Gs^Fds, Gs^Fds, Hh, Gs^Fds, Ww, Ww, Wo^Es, Ww^Es, Wwr, Gs^Fms, Hh^Fms, Hh, Gs, Re, Gs^Efm, Gs^Fms, Gs^Fms, Gs^Fds, Gs^Fms, Re^Vhs, Rrc, Gg, Gs^Fms, Rp^Ve, Rp, Gll^Fp, Gs^Fms, Gs^Fds, Gs^Fms, Gs^Fms, Gs^Fms, Gs^Fms, Gs^Fms, Gs^Em, Gs^Fms, Gs^Fms, Gs^Fms, Rrc, Gs^Fms, Rrc, Gs^Fms, Rrc, Gg, Gg, Gg, Md, Md, Md
Gs^Fds, Gs^Fms, Re^Ve, Gd^Gvs, Gs^Fds, Gs^Fms, Gs^Fds, Gs^Fds, Hh^Fds, Gs^Fds, Gs^Fds, Gg, Gs^Fds, Rp, Gs^Fds, Gs^Fms, Gll^Fp, Gs^Fds, Ww^Es, Ww^Es, Wwr, Wwr, Wo^Es, Gs^Fds, Ww^Es, Gs^Fds, Gs^Fms, Re^Ve, Rp, Rp^Ve, Rp, Gs^Fms, Rrc, Rrc, Gs^Fms, Gs^Fds, Gs^Fms, Gs^Efm, Gll^Fp, Rp, Rr^Ve, Gs^Fms, Gg, Gs^Ve, Gs^Gvs, Gs^Fms, Gs^Fms, Gs^Fms, Gs^Fms, Gs^Fms, Gs^Fms, Hh^Fms, Gs^Fms, Gs^Fms, Gs^Fms, Gs^Fms, Md, Md, Md, Md, Md, Md
Gs^Fds, Gs^Fds, Re, Gs^Fds, Gs^Fds, Gs^Fds, Gll^Fp, Gll^Fp, Hh, Gs^Fms, Gs^Fds, Gs^Fds, Gs^Fds, Rp, Gs^Fds, Gs^Fds, Gs^Fds, Gs^Fds, Hh^Fds, Ww^Es, Gs^Fds, Wo^Es, Wo^Es, Ww^Es, Wwr, Gs^Fms, Gs^Fms, Gll^Fp, Gll^Fp, Rp, Gs^Fms, Rrc, Gg, Gs^Em, Gs^Fms, Gs^Fms, Hh^Fms, Gs^Fms, Gs^Fds, Gs^Fms, Gg, Gg, Gg, Gs^Em, Gg^Gvs, Gs^Gvs, Gs^Fms, Gs^Fms, Hh^Fms, Gs, Hh^Fms, Hh^Fms, Gs^Fms, Hh^Fms, Gs^Fms, Gs^Fms, Md, Md, Md, Md, Md, Md
Gs^Fds, Gll^Fp, Gs^Fds, Re, Gll^Fp, Gs^Fds, Gs^Fds, Hh^Fds, Gs^Fds, Gs^Fds, Gs^Fds, Gs^Fds, Gs^Fms, Rp, Rp, Gs^Fds, Gs^Fds, Gs^Fms, Gs^Fds, Gs^Fds, Gs^Fds, Ww^Es, Wwr, Wwr, Wo^Es, Gs^Fds, Gs^Fms, Gll^Fp, Gs^Fms, Gs^Fms, Ww, Rrc, Ww, Gs^Fms, Gs^Fms, Gll^Fp, Gll^Fp, Ss, Gs^Fms, Gs^Fms, Gs, Gd, Gg^Fet, Gs, Gs^Gvs, Gs^Gvs, Gs^Fms, Gs^Fms, Gs^Fms, Gs^Fms, Gs^Fms, Gs^Fms, Gs^Fms, Gs^Fms, Md, Md, Md, Md, Md, Md, Md, Md
Gs^Fds, Gs^Fds, Re, Re, Gs^Fds, Gs^Fds, Hh^Fds, Hh^Fms, Gs^Fds, Gs^Fds, Gg, Gs^Fds, Rp, Rp, Gs^Fds, Rrc^Ve, Hh, Gs^Fds, Hh, Gs^Fds, Ss, Wwg^Es, Gs^Fds, Wo^Es, Wo^Es, Ww^Es, Wwr, Gs^Fms, Ww, Gs^Fds, Ww, Ww^Bsb|, Ww, Gs^Fds, Ww, Gs^Fms, Gs^Fms, Hh^Fms, Gs^Fms, Gs^Ve, Gs^Efm, Gs, Gg, Gd, Gg, Hh^Fms, Hh^Fms, Hh^Fms, Gs^Fms, Hh^Fms, Hh^Fms, Hh^Fms, Hh^Fms, Gs^Fms, Md, Md, Md, Md, Md, Md, Md, Md
Gs^Fds, Gs^Fds, Re^Gvs, Gs^Fds, Ss, Gs^Fds, Gs^Fds, Hh, Gs^Fms, Gs^Fds, Rp, Rp, Gs^Fds, Gs^Fds, Gs^Fds, Gs^Fds, Gd^Fdw, Gs^Fms, Gs^Fds, Hh^Fms, Gs^Fds, Gs^Fds, Gs^Fds, Ww^Es, Wwr, Wwr, Wo^Es, Gs^Fds, Ww, Ww, Cv^Fet, Ww^Bsb|, Cv^Fet, Ww, Ww, Gs^Fds, Gs^Fds, Gs^Fms, Gll^Fp, Gs^Efm, Gs^Fms, Gs^Fms, Gll^Fp, Gg, Gll^Fp, Hh^Fms, Hh^Fms, Hh^Fms, Gll^Uf, Gll^Uf, Gll^Uf, Gg, Hh^Fms, Hh^Fms, Hh^Fms, Md, Md, Md, Md, Md, Md, Md
Gs^Fds, Re^Gvs, Re^Gvs, Gs^Fds, Gs^Fds, Ss, Gs^Fds, Gs^Fms, Gs^Fms, Gs^Fds, Rp, Gll^Fp, Gs^Fds, Gs^Fds, Gs^Fms, Gs^Fds, Gs^Fds, Gs^Fds, Gs^Fds, Gs^Fds, Gs^Fds, Gs^Fds, Gs^Fds, Ww^Es, Gs^Fds, Wo^Es, Wo, Ww, Ww, Ww, Cv, Rp, Cv, Ww, Ww, Ww, Ww, Gs^Fms, Gs^Fms, Gs^Fms, Gs^Em, Gs^Fms, Gd^Emf, Gg, Gg^Gvs, Gs^Fms, Gs^Fms, Gs^Fms, Hh^Fms, Gll^Uf, Hh^Fms, Hh^Fms, Hh^Fms, Gs^Fms, Md, Md, Md, Md, Md, Md, Md, Md
Gs^Fds, Re^Ve, Gs^Fds, Gs^Fds, Gs^Fds, Ss, Hh^Fp, Gs^Fms, Gs^Fds, Gs^Fds, Rp, Hh^Fp, Hh^Fms, Hh^Fds, Gll^Em, Gll^Fp, Gll^Fp, Gs^Fds, Gs, Gs, Gs, Re^Ve, Re^Gvs, Gs^Fds, Gs^Fds, Ww, Ww, Ww, Cv^Fet, Cv, Gs, Gs, Gs, Cv, Cv^Fet, Ww, Ww, Gs^Fds, Gs^Fms, Gs^Fms, Gs^Fms, Gs^Fds, Gs^Fms, Rp^Ve, Gs^Gvs, Gg^Gvs, Gs^Fms, Gs^Fms, Gs^Fms, Gll^Uf, Hh^Fms, Hh^Fms, Hh^Fms, Gs^Fms, Md, Md, Md, Md, Md, Md, Md, Md
Gs^Fds, Gs^Fds, Hh^Fms, Gs^Fds, Hh^Fms, Hh^Fds, Hh^Fms, Hh^Fms, Gs^Fds, Gs^Fds, Rp, Gll^Fp, Gs^Fds, Hh^Fms, Gs^Fds, Gll^Fp, Gs^Fds, Gs^Fds, Gs, Gs^Fet, Gll^Emf, Re^Gvs, Re^Gvs, Re, Ww, Ww, Ww, Ww, Cv, Gg^Ve, Gs^Efm, Kv, Gs^Efm, Gg^Ve, Cv, Ww, Ww, Ww, Ww, Gs^Fms, Ss, Gs^Fp, Rp, Rp, Gs^Fms, Gs^Fms, Gs^Fms, Gs^Fms, Gs^Fms, Gs^Fms, Gs^Fms, Hh^Fms, Gs^Fms, Gs^Fms, Gs^Fms, Md, Md, Md, Md, Md, Md, Md
Hh^Fp, Hhd, Mm, Hhd, Hh^Fms, Gs^Fds, Re^Gvs, Gs^Fds, Gs^Fds, Gg^Efm, Gg, Rp, Gs^Fds, Hh, Gs^Fms, Gs^Fds, Gs^Fds, Gg^Ve, Gg^Efm, Gll^Emf, Ss, Gs^Vhs, Gs^Fds, Re, Ww, Ww^Es, Ww, Cv, Gg^Emf, Gg^Efm, Gs^Efm, Wwt^Ewf, Gs^Efm, Gg^Efm, Gg^Emf, Cv, Ww, Ww, Ww, Gs^Fms, Gs^Fp, Rp, Gs^Fms, Gs^Fds, Gs^Fms, Hh^Fms, Hh^Fms, Gs, Hh^Fms, Gs^Fms, Hh^Fms, Gs^Fms, Hh^Fms, Gs^Fms, Gs^Fms, Md, Md, Md, Md, Md, Md, Md
Hhd, Mm, Mm, Mm, Hhd, Gs^Fds, Re^Gvs, Re^Gvs, Gs^Fds, Gs^Fds, Gs^Fds, Rp, Gll^Fp, Hh^Fds, Hh^Fds, Hh, Gs^Fds, Gg^Efm, Gs^Fds, Ss, Ss, Gs^Fds, Gs^Fds, Gs^Fds, Gs^Fds, Ww, Ww, Cv, Cv, Kv, Cv, Gs^Efm, Cv, Kv, Cv, Cv, Ww, Ww, Gs^Fms, Gs^Fms, Gs^Fms, Rp^Ve, Rp, Gs^Fms, Gll^Fp, Hh^Fms, Gs^Fms, Gs^Fms, Gs^Fms, Gs^Fms, Hh^Fms, Gs^Fms, Gs^Fms, Hh^Fms, Hh^Fms, Gs^Fms, Md, Md, Md, Md, Md, Md
Mm, Mm, Mm, Mm, Hh^Fms, Gs^Fds, Re, Re^Ve, Re, Re, Re, Rp, Gs^Fds, Gs^Fds, Gs^Fds, Gs^Fds, Hh^Fp, Gs^Fms, Gs^Fds, Gs^Fds, Gs^Fds, Gs^Fds, Gs^Fms, Gs^Fds, Gs^Fds, Ww, Ww, Cv^Fet, Ww, Wwg, Cv, Gs, Cv, Wwg, Wwr, Cv^Fet, Ww, Ww, Gs^Fds, Hh^Fds, Gll^Fp, Gs^Fms, Rp, Gll^Fp, Gs^Fms, Gs^Fms, Gg^Gvs, Gs^Fms, Gs^Fms, Gs^Es, Hh^Fms, Gs^Fms, Hh^Fms, Hh^Fms, Gs^Fms, Hh^Fms, Md, Md, Md, Md, Md, Md
Hhd, Mm, Wwf, Hh^Fds, Re, Re^Ve, Re, Gs, Gs^Fds, Gs^Fds, Gs, Rp, Gs^Fds, Gs^Fds, Hh, Hh^Fms, Re^Gvs, Gs^Fds, Gll^Fp, Gs^Fms, Gs^Fds, Gs^Fds, Mm, Gs^Fds, Gs^Fds, Ww, Wwf, Ww, Ww, Cv, Cv, Gs, Cv, Cv, Ww, Ww, Wo^Es, Ww^Es, Gs^Fds, Gs^Fms, Gs^Fms, Gs^Fms, Gs^Vhs, Rp, Rp^Ve, Gg^Gvs, Gg^Gvs, Gs^Fms, Gs^Fms, Gs^Fms, Hh^Fms, Hh^Fms, Hh^Fms, Gs, Hh^Fms, Hh^Fms, Gs^Fms, Md, Md, Md, Md, Md
Gs^Fds, Hh^Fds, Wwf, Hh^Fms, Re, Gs, Cv, Cv, Gs^Fds, Gs^Fms, Rp, Rp, Gs^Fds, Gs^Fds, Gs^Fds, Hh^Fp, Re^Ve, Gs^Emf, Gll^Fp, Gs^Fds, Gs^Fds, Gs^Fms, Gs^Fds, Gs^Fds, Gs^Fds, Gs^Fds, Gs^Fds, Ww, Ww, Cv^Fet, Ww, Rp, Ww, Cv^Fet, Ww, Wwr, Wo^Es, Wwr, Wwr, Gs^Fms, Ww^Es, Gs^Fms, Gs^Fms, Gs^Fms, Gs^Fms, Gs^Fms, Gs^Fms, Gs^Fms, Gs^Fms, Gs^Fms, Hh^Fms, Gs^Fms, Hh^Fms, Gs^Fms, Gs^Fms, Hh^Fms, Hh^Fms, Md, Md, Md, Md, Md
Gs^Fds, Gs^Fds, Ss, Ss, Re^Ve, Gs, Cv, Kv, Gs^Fds, Gs^Fds, Rp, Gg^Efm, Gs^Fms, Gs^Fds, Gs^Fds, Re^Gvs, Re^Gvs, Gg^Efm, Gs, Gs^Fds, Gs^Es, Gs^Fds, Gs^Fds, Gs^Fds, Hh^Em, Gs^Fds, Gs^Fds, Ww, Gs^Fds, Ww, Ww, Ww^Bsb|, Ww, Ww, Gs^Fds, Wo^Es, Wwr, Wwr, Wo^Es, Gs^Fds, Ww^Es, Gs^Fds, Ww^Es, Hh^Fp, Gs^Fms, Gs^Fms, Gs^Fms, Gs^Fms, Gg, Gs^Fms, Gs^Fms, Hh^Fms, Gs^Fms, Gs^Fms, Hh^Fms, Gs^Fms, Hh^Fms, Md, Md, Md, Md, Md
Gs^Fms, Ss^Ewl, Ss, Gs^Emf, Gs^Fds, Gs^Fds, Cv, Cv, Gs^Fds, Gs^Fds, Gs^Fds, Rp, Gs^Fds, Gll^Fp, Gs^Fms, Gs^Fds, Gs^Fms, Gs^Fds, Gs^Fds, Gs, Gs^Fds, Gs, Gs^Vhs, Gs^Fds, Gs^Fds, Gs^Fds, Gll^Fp, Gs^Fds, Gs^Fds, Ww, Cv^Fet, Ww^Bsb|, Cv^Fet, Ww, Gs^Fds, Ww^Es, Gs^Fds, Wo^Es, Wwr, Wwr, Wo^Es, Wwr, Wo^Es, Gs^Fds, Ww^Es, Gs^Fms, Gg, Gs^Fms, Gg, Gg, Gs^Fms, Gs, Gs^Fms, Gs^Fms, Gs^Fms, Hh^Fms, Gs, Md, Md, Md, Md, Md
Gs^Fms, Gs^Fms, Gs^Fds, Wwf, Wwf, Gs^Fds, Gs^Fds, Gs^Fds, Gs^Fds, Gs^Fds, Gg^Em, Rp, Gs^Fms, Gs^Fds, Gll^Fp, Hh, Gs^Fds, Hh, Hh^Fds, Gs^Fds, Gs^Fds, Gg, Gs^Fds, Gs^Fds, Gs^Fms, Hh, Gs^Fds, Gll^Fp, Gs^Fds, Gs^Fds, Gs^Fds, Rrc, Gs^Fds, Gs^Fds, Hh^Fds, Gs^Fds, Wwf, Ww^Es, Gs^Vhs, Wo^Es, Wwr, Wo^Es, Wwr, Wwr, Wo^Es, Wo, Wo^Es, Gs, Gs, Gs^Fms, Gg, Gs^Fms, Gg, Gg, Gs^Fms, Gg, Gs^Fms, Gg, Gg, Gg, Gg, Gg
Gs^Fms, Gs^Fms, Gs^Fds, Hh, Gs^Fds, Ss, Gg^Emf, Ss, Ss, Gs^Fds, Gs^Fds, Rp, Gs^Fds, Gs^Fds, Gs^Fds, Gll^Fp, Hh^Fds, Hh^Fds, Gs^Fds, Gs^Fds, Ss, Gs^Fds, Hh, Gs^Fms, Gll^Fp, Gs^Fds, Re^Gvs, Re^Gvs, Gs^Fds, Gs^Fds, Gg^Es, Rrc, Gg, Hh^Fds, Gs^Fds, Gs^Fds, Wwf, Gs^Fds, Gs^Fds, Ww^Es, Gs^Fds, Ww^Es, Gs^Fms, Wo^Es, Re^Ve, Wo^Es, Wo, Wo, Wo, Gg, Wo, Gg, Gg, Gg, Gg, Gg, Gg, Gg, Gg, Gg, Wo, Wo
Gs^Fms, Gll^Fp, Gll^Fp, Gs^Fms, Gs^Fds, Ss, Ss, Gs^Fds, Ss, Ss, Rp, Rp, Gg, Hh, Hh^Fds, Gs^Fds, Hh^Fds, Gs^Fms, Gs^Em, Ss, Ss, Gs^Fds, Gs^Fds, Gs^Fms, Gs^Fms, Gs^Fds, Gs^Fds, Gg^Ve, Gg, Gs, Rrc, Rrc, Gg, Gs^Fds, Gs^Fds, Wwf, Hh^Fds, Gs^Fds, Gs^Fds, Gs^Fds, Gs^Fds, Gs^Fds, Gs^Fds, Ww^Es, Re, Gg, Gg, Wo, Wo, Wo, Wo, Wo, Wo, Wo, Wo, Wo, Wo, Wo, Wo, Wo, Wo, Wo
Hh^Fds, Gs^Fds, Gll^Fp, Gs^Fds, Gs^Fds, Ss, Rp, Ss, Rp, Ss^Bw/, Ss^Bw|, Ss, Ss, Ss, Hh^Fds, Hh^Fds, Gll^Uf, Gll^Uf, Gs^Fds, Gs^Em, Gs^Vhs, Gs, Gd^Fdw, Gd^Fdw, Gs^Fds, Gs^Fds, Gs^Fds, Gg, Rrc, Rrc, Gg, Gs, Gs^Fds, Gg^Efm, Gs^Fds, Wwf, Hh^Fms, Gs^Fds, Gll^Fp, Hh^Fms, Hh^Fds, Gs^Fds, Hh^Fds, Gs^Fds, Re, Gs^Fds, Gs^Fds, Gg, Gg, Wo, Gg, Wo, Wo, Wo, Wo, Wo, Wo, Wo, Wo, Wo, Gg, Gg
Hh^Fds, Hh^Fds, Gs^Fds, Gs^Fds, Gs^Fds, Rp, Gs^Fds, Rp, Gs^Fds, Ss, Rp, Ss, Gs^Fds, Gs^Fds, Gd^Fms, Gs^Fds, Gll^Uf, Gll^Uf, Hh, Gg^Efm, Gg^Efm, Gs^Fds, Gs^Fds, Gd^Fdw, Gs^Fds, Gs^Fds, Rrc, Gs^Vhs, Rrc, Gg, Gs^Fds, Gs^Vhs, Gs^Fds, Gs^Fds, Hh^Fds, Wwf, Gs^Fds, Gs^Fds, Gs^Fds, Hh^Fds, Gll^Fp, Hh^Fms, Hh^Fds, Re^Es, Gs^Fms, Gs^Fms, Gs^Fms, Gs^Fms, Gs^Fms, Gg, Gs^Fms, Gg, Gg, Gg, Gg, Gg, Gg, Gg, Gg, Gg, Gs^Fms, Gs^Fms
Hh^Fds, Hh^Fds, Gs^Fds, Re^Gvs, Re^Gvs, Re^Gvs, Gs^Efm, Rr^Ve, Gs^Es, Gg, Rp, Gs, Gs^Fds, Gd^Fds, Gd^Fdw, Gd^Fds, Gs^Fms, Gs^Fds, Gs^Fds, Gs^Fms, Gs^Fds, Gs^Fds, Gs^Fds, Gs^Fds, Rrc, Rrc, Gs^Fds, Rrc, Gs^Fds, Gs^Fds, Gs^Fds, Gs^Fds, Wwf, Hh^Fds, Wwf, Wwf, Hh^Fms, Re^Vhs, Re, Re, Re, Re, Re, Re, Gs^Fds, Gs^Fms, Gs^Fms, Gs^Fms, Gs^Fms, Gs^Fms, Gs^Fms, Gs^Fms, Gs^Fms, Gs^Fms, Gs^Fms, Gs^Fms, Hh^Fms, Hh^Fms, Gs^Fds, Gs^Fms, Gs^Fms, Gs^Fms
Gs^Fds, Gs^Fds, Gs^Fds, Re^Gvs, Gs^Fds, Re^Gvs, Gs^Fds, Gs^Es, Gs^Fds, Gg, Gs, Rp, Gs^Fds, Gd^Fdw, Gd^Fms, Gd^Fds, Gs^Fds, Gs^Fds, Rp, Gs^Fms, Rp, Rp, Rr, Gs^Fds, Rrc, Gs^Fds, Gs^Fms, Gs^Fds, Hh^Fds, Gs^Fds, Wwf, Wwf, Hh^Fms, Wwf, Gs^Fds, Gs^Fds, Gs^Fds, Re, Gll^Fp, Gs^Fds, Gll^Fp, Gs^Fds, Gg, Re, Gs^Fds, Gs^Fds, Gs^Fds, Gs^Em, Gs^Fds, Gs^Fds, Gs^Fds, Gs^Fds, Gs^Fds, Gs^Fds, Gs^Fds, Hh^Fms, Gll^Fp, Ss, Hh^Fms, Gs^Fms, Gs^Fds, Gs^Fds
Gs^Fds, Gs^Es, Gs^Fds, Gs^Fds, Gs^Fds, Gll^Fp, Gs^Fds, Gs^Fds, Gll^Fp, Gs^Fds, Gg, Rp, Rb, Gs^Fds, Gs^Fds, Gs^Fds, Gs^Fds, Rp, Gs^Fds, Rb, Gs^Fds, Gs^Ve, Gg, Rrc, Gs^Fds, Gs^Fds, Gs^Fds, Hh^Fds, Mm, Mm, Wwf, Hh^Fds, Gs^Fms, Re^Ve, Re, Re, Re, Re, Gs^Fds, Gs^Fds, Gs^Fds, Re^Emf, Re^Gvs, Re^Ve, Gs^Fds, Gs^Fds, Gs^Fds, Gs^Fds, Gll^Uf, Gll^Uf, Gll^Uf, Gll^Uf, Gs^Fds, Gs^Fds, Hh^Fms, Ss, Gs^Fds, Hh^Fms, Ss, Gs^Fms, Ss, Gs^Fds
Gs^Fds, Gs^Fds, Gs^Fds, Gs^Fds, Ss, Gs^Fds, Gs^Es, Gs^Fds, Gs^Fds, Gs^Fds, Gs^Fds, Gs^Fds, Gs^Fds, Rb, Rb, Rr^Ve, Rp, Rp, Gs^Fms, Gs^Fms, Gs^Fds, Gs^Fds, Gs^Fds, Rrc, Gs^Fds, Gs^Fds, Gs^Fms, Hh^Fds, Wwf, Wwf, Gs^Fds, Gs^Fds, Gs^Fms, Gs^Efm, Hh^Fds, Gg, Hh^Fds, Gs^Fds, Mm, Gs^Fds, Gs^Fds, Re^Gvs, Gs^Gvs, Gg^Gvs, Gs^Fms, Gs^Fms, Gs^Fms, Gs^Fms, Gs^Fms, Gll^Uf, Gll^Uf, Gs^Fms, Hh^Fms, Gs^Fds, Hh^Fms, Hh^Fms, Ss, Gll^Fp, Hh^Fms, Ss, Hh^Fms, Gs^Fms
Hh^Fds, Hh^Fds, Gg^Fet, Gs^Fds, Gs^Fds, Gs^Fds, Mm, Gs^Fds, Gg, Hh^Fds, Hh^Fds, Gs^Fds, Gs^Fds, Re^Ve, Gd, Gs^Fds, Gs^Fms, Gll^Fp, Gll^Fp, Gll^Fp, Gll^Fp, Mm, Mm, Rrc, Rrc, Gs^Fds, Gs^Fds, Gs^Fds, Wwf, Gll^Fp, Gs^Fds, Gs^Fds, Gs^Fds, Gs^Fds, Hh^Fds, Gg^Fet, Mm, Hh^Fds, Gll^Fp, Hh^Fds, Gs^Fds, Re^Ve, Gs^Efm, Gs^Fds, Gs^Fms, Hh^Fms, Hh^Fms, Hh^Fms, Hh^Fms, Hh^Fms, Hh^Fms, Gll^Fp, Ss, Ss, Ss, Gs^Fds, Gll^Fp, Gs^Fds, Hh^Fms, Ss, Hh^Fms, Hh^Fms
Gs^Fds, Gs^Fds, Gs^Fds, Gs^Fds, Ss^Ewl, Gs^Fds, Ss, Hh^Fds, Mm, Mm, Mm, Gs^Fds, Gg^Ve, Gd, Gd, Gd, Gll^Fp, Gll^Fp, Gll^Fp, Gll^Em, Gs^Fds, Mm, Mm, Mm, Rrc, Gs^Fds, Gs^Fds, Gs^Fds, Wwf, Gs^Fds, Gs^Fds, Gs^Fds, Gs^Fds, Hh, Hh^Fds, Mm, Gll^Fp, Gll^Fp, Gll^Fp, Gll^Fp, Gs^Fms, Gs^Fds, Gs^Fds, Gs^Fds, Hh^Fms, Hh^Fms, Hh^Fms, Hh^Fms, Ss, Gs^Fms, Gll^Fp, Hh^Fms, Hh^Fms, Hh^Fms, Ss, Gs^Fms, Hh^Fms, Hh^Fms, Hh^Fms, Gs^Fds, Ss, Hh^Fms
Gs^Fds, Gs^Efm, Gs^Fds, Ss^Ewl, Wwg^Ewl, Ss^Ewl, Gs^Fds, Hh^Fds, Hh^Fds, Mm, Mm, Gs^Fds, Gs^Fds, Gs^Fds, Gll^Fp, Gll^Fp, Gll^Fp, Gll^Fp, Gll^Fp, Gll^Fp, Hh^Fds, Hh^Fds, Gs^Fds, Rrc, Gs^Fds, Gs^Fds, Gs^Fds, Wwf, Hd^Es, Ds, Hhd, Ds, Gs^Fds, Gs^Fds, Hh^Fds, Mm, Gll^Fp, Gll^Fp, Gll^Fp, Gll^Fp, Gs^Fms, Gs^Fds, Gs^Fds, Gs^Fds, Hh^Fms, Hh^Fms, Gs^Fds, Hh^Fms, Ss, Gs^Fms, Ss, Gll^Fp, Gs^Fms, Hh^Fms, Ss, Gs^Fds, Ss, Ss, Ss, Ss, Ss, Ss
Gs^Fds, Gs^Fds, Ss, Ss^Ewl, Ss^Ewl, Ss^Ewl, Gs^Fds, Gs^Fds, Gs^Fds, Gs^Fds, Gs^Fds, Gs^Fds, Gs^Fds, Gs^Fds, Gs^Fms, Gll^Fp, Gll^Fp, Gll^Fp, Gll^Fp, Gll^Fp, Hh^Fds, Gs^Fds, Gll^Fp, Rrc, Gs^Fds, Gs^Fds, Gs^Fds, Wwf, Ds, Gs^Fds, Gs^Fds, Ds, Gs^Fds, Gs^Fds, Gs^Fds, Hh^Fds, Gs^Fms, Gll^Fp, Gs^Fms, Gll^Fp, Gs^Fds, Gs^Fds, Hh^Fms, Hh^Fms, Hh^Fms, Hh^Fms, Ss, Ss, Hh^Fms, Gs^Fms, Ss, Ss, Hh^Fms, Ww^Ewf, Ss, Ss, Ss, Ww^Ewl, Ww^Ewl, Ss, Ss, Ss
Gs^Fds, Gs^Fds, Ss, Ss^Ewl, Ss^Ewl, Ss^Ewl, Gs^Fds, Gs^Fds, Gs^Fds, Gs^Fds, Gll^Uf, Gll^Uf, Gs^Fds, Gs^Fds, Gll^Fp, Gll^Fp, Gll^Fp, Gll^Fp, Gg^Fet, Gll^Fp, Gll^Fp, Hh^Fds, Gll^Fp, Rrc, Rrc, Gs^Fds, Gs^Fds, Wwf, Wwf, Gs^Fds, Gs^Fds, Gs^Fds, Gs^Fds, Gs^Fds, Gs^Fds, Gs^Fms, Gs^Fms, Gll^Fp, Gs^Fms, Gll^Fp, Gs^Fds, Gs^Fds, Hh^Fms, Hh^Fms, Gll^Fp, Gs^Fms, Gs^Fms, Hh^Fms, Ss, Gs^Fms, Gs^Fms, Ss, Ss, Ss, Ss, Ss, Ss, Hh^Fms, Ww^Ewl, Hh^Fms, Ss, Ss
Ss^Ewl, Ss^Ewl, Ss, Ss^Ewl, Ss^Ewl, Gs^Fds, Gll^Fp, Ss^Ewl, Ss^Ewl, Ss^Ewl, Gll^Fp, Gll^Uf, Gll^Uf, Gll^Fp, Gll^Fp, Gg, Gll^Fp, Gll^Fp, Gll^Fp, Gll^Fp, Hh^Fds, Gs^Fds, Hh^Fds, Gg, Rrc, Gs^Fds, Gg, Wwf, Ds, Wwf, Gs^Fds, Gs^Fds, Gs^Fds, Gs^Es, Gs^Fms, Gs^Fms, Gs^Fms, Gll^Fp, Gll^Fp, Hh^Fms, Ss, Gs^Fms, Ss, Ss, Hh^Fms, Gs^Fms, Ww^Ewl, Gs^Fms, Gs^Fds, Gll^Fp, Ss, Gs^Fds, Gs^Fms, Ss, Ss, Ss, Ss, Ss, Ss, Ss, Ss, Ss
Ss^Ewl, Gs^Fds, Ss, Ss^Ewl, Ss^Ewl, Ss^Ewl, Ss^Ewl, Ss^Ewl, Ss^Ewl, Ss^Ewl, Gll^Fp, Gll^Uf, Gll^Uf, Gll^Fp, Gll^Fp, Gll^Fp, Gll^Fp, Gll^Fp, Gll^Fp, Gll^Fp, Gs^Fds, Hh^Fds, Gll^Fp, Gg, Gs, Rrc, Gg, Ds, Wwf, Wwf, Wwf, Gs^Fds, Gs^Fds, Gs^Fds, Gs^Fms, Gs^Fms, Gs^Fms, Gll^Uf, Gll^Uf, Hh^Fms, Gs^Fms, Hh^Fms, Hh^Fms, Hh^Fms, Gs^Fms, Hh^Fms, Hh^Fms, Hh^Fms, Ss, Ss, Ss, Ww^Ewl, Ss, Hh^Fms, Gs^Fms, Ss, Ss, Ss, Ss, Ss, Ww^Ewl, Ss
Ss, Ss, Ss^Ewl, Ss^Ewl, Ss^Ewl, Ss^Ewl, Gs^Fds, Gs^Fds, Gs^Fds, Gll^Fp, Gll^Uf, Gll^Uf, Gll^Uf, Ss^Ewl, Gs^Fds, Gll^Fp, Gs^Fds, Gll^Fp, Gll^Fp, Gll^Fp, Gs^Fds, Gs^Fds, Gs^Fds, Gg, Rrc, Rrc, Gg, Wwf, Ds, Wwf, Gs^Fds, Gs^Fds, Gs^Fds, Gs^Fds, Gs^Fms, Gs^Uf, Gs^Uf, Gll^Uf, Gll^Uf, Hh^Fms, Hh^Fms, Gs^Fms, Hh^Fms, Gs^Fds, Ww^Ewf, Ss, Ss, Ss, Ss, Ss, Ss, Ss, Ss, Ss, Ww^Ewl, Ss, Ss, Ss, Ss, Ss, Ss, Ss
Ss^Ewl, Ss^Ewl, Ss^Ewl, Gll^Fp, Ss^Ewl, Gll^Fp, Gll^Fp, Gll^Fp, Gll^Fp, Gs^Fds, Gs^Fds, Ss^Ewl, Ss^Ewl, Gs^Fds, Ss^Ewl, Gll^Fp, Gll^Fp, Gll^Es, Gll^Fp, Gll^Fp, Hh^Fds, Gll^Fp, Hh^Fds, Rrc, Gs, Gg, Gg, Wwf, Wwf, Ds, Gs^Fds, Gs^Fds, Gs^Fms, Gs^Fms, Gs^Fds, Gs^Fms, Gs^Fms, Gll^Fp, Hh^Fms, Gs^Fds, Hh^Fms, Gs^Fms, Hh^Fms, Ss, Hh^Fms, Hh^Fms, Ss, Ww^Ewl, Ss, Ss, Hh^Fms, Ss, Ss, Ss, Ww^Ewf, Ss, Ww^Ewf, Ss, Ss, Ss, Ss, Ss
Ss^Ewl, Gll^Fp, Ss, Ss^Ewl, Gll^Fp, Gll^Es, Gll^Fp, Ss^Ewl, Gll^Fp, Ss^Ewl, Ss^Ewl, Gs^Fds, Gll^Fp, Ss^Ewl, Gll^Fp, Gll^Fp, Gll^Fp, Gs^Fds, Gll^Fp, Gll^Fp, Gs^Fds, Gll^Fp, Gll^Fp, Rrc, Gg, Gg, Wwf, Wwf, Wwf, Wwf, Gs^Fds, Gs^Fds, Gs^Fms, Gs^Fms, Gs^Fds, Gg^Em, Gs^Fms, Hh^Fms, Gs^Fms, Hh^Fms, Ss, Gs^Fms, Hh^Fms, Ss, Ss, Ss, Ss, Ss, Ss, Ww^Ewl, Ss, Ss, Ww^Ewl, Ss, Gs^Fds, Ss, Ww^Ewl, Ww^Ewl, Ss, Gs^Fms, Ss, Ww^Ewl
Ss^Ewl, Gs^Fds, Ss, Ss^Ewl, Ss^Ewl, Gs^Fds, Ss^Ewl, Ss^Ewl, Ss^Ewl, Gll^Fp, Gll^Fp, Ss^Ewl, Gll^Fp, Gll^Fp, Gll^Uf, Gs^Fds, Ss^Ewl, Gll^Fp, Ss^Ewl, Gll^Fp, Gll^Fp, Gs^Fds, Rrc, Rrc, Gg, Gg, Wwf, Wwf, Ds, Gs^Fds, Gs^Fds, Gs^Fds, Gs^Fms, Gs^Fms, Gs^Fds, Gs^Fms, Ss, Hh^Fms, Ss, Gs^Fms, Hh^Fms, Gs^Fds, Ss, Ss, Ss, Ss, Ss, Ss, Ss, Gll^Fp, Gs^Fds, Ww^Ewl, Ss, Ss, Ss, Ss, Ss, Ss, Ss, Ss, Ss, Ss
Ss^Ewl, Gll^Fp, Ss^Ewl, Ss^Ewl, Gs^Fds, Gll^Fp, Gll^Fp, Ss^Ewl, Gll^Fp, Gs^Fds, Ss^Ewl, Ss^Ewl, Gll^Fp, Gs^Fds, Gll^Uf, Gll^Uf, Gll^Fp, Gll^Fp, Gll^Fp, Gll^Fp, Gll^Fp, Gs^Fds, Rrc, Gg, Gg, Gg, Wwf, Wwf, Ds, Gs^Fds, Gs^Fds, Gs^Fds, Gs^Fms, Gs^Fms, Gs^Fds, Hh^Fms, Hh^Fms, Hh^Fms, Gs^Fms, Gs^Fms, Hh^Fms, Ss, Ww^Ewl, Ss, Ss, Gs^Fms, Ss, Ww^Ewl, Ss, Gs^Fds, Hh^Fms, Ss, Ss, Ss, Ss, Ss, Hh^Fms, Ww^Ewf, Ww^Ewl, Ww^Ewl, Ss, Ww^Ewl
Ss^Ewl, Gll^Fp, Ss^Ewl, Ss^Ewl, Ss^Ewl, Gll^Fp, Gs^Fds, Gll^Fp, Gll^Fp, Gll^Es, Gll^Fp, Gll^Fp, Ss^Ewl, Gll^Uf, Gll^Fp, Gll^Uf, Gs^Fds, Gll^Fp, Gll^Fp, Gll^Fp, Gll^Fp, Rrc, Hh, Gg, Gg, Wwf, Wwf, Wwf, Ds, Gs^Fds, Gs^Fds, Gs^Es, Gs^Fms, Gs^Fms, Gs^Fds, Gs^Fds, Hh^Fms, Gs^Fms, Hh^Fms, Hh^Fms, Hh^Fms, Gs^Fms, Ss, Ss, Ss, Ss, Ss, Ww^Ewl, Ss, Ww^Ewl, Ss, Ww^Ewl, Ww^Ewl, Ww^Ewl, Hh^Fms, Ww^Ewl, Ss, Ss, Ss, Ss, Ss, Ss
Ss^Ewl, Ss^Ewl, Ss^Ewl, Ss^Ewl, Gs^Fds, Ss^Ewl, Ss^Ewl, Gll^Fp, Gs^Fds, Gll^Fp, Gll^Fp, Ss, Gll^Fp, Gll^Fp, Gll^Fp, Gll^Uf, Gll^Fp, Gll^Fp, Gll^Fp, Gll^Fp, Gll^Fp, Rrc, Rrc, Gg, Wwf, Wwf, Gs^Fds, Wwf, Ds, Gs^Fds, Gs^Fds, Gs^Fds, Gs^Fms, Gs^Fms, Gs^Fds, Gll^Fp, Hh^Fms, Gs^Fds, Gs^Fms, Hh^Fms, Gs^Fms, Hh^Fms, Hh^Fms, Hh^Fms, Ss, Gs^Fds, Ss, Ss, Ss, Ss, Ss, Gll^Fp, Ww^Ewl, Ss, Ss, Hh^Fms, Ss, Ss, Ss, Ss, Ss, Ww^Ewl
Ss, Ss^Ewl, Gll^Fp, Ss^Ewl, Gs^Fds, Gs^Fds, Ss^Ewl, Gs^Fds, Ss, Gs^Fds, Gs^Fds, Ss^Ewl, Ss^Ewl, Gll^Fp, Ss^Ewl, Gll^Fp, Gs^Fds, Gll^Fp, Gll^Fp, Gll^Fp, Gll^Fp, Gg, Rrc, Gg, Gg, Wwf, Gs^Fds, Wwf, Ds, Gs^Fds, Gs^Fds, Gs^Fds, Gs^Fms, Gs^Fms, Gs^Fds, Gs^Fms, Hh^Fms, Hh^Fms, Hh^Fms, Hh^Fms, Hh^Fms, Hh^Fms, Hh^Fms, Ss, Ss, Ss, Gs^Fds, Hh^Fms, Ss, Gll^Fp, Ss, Ss, Ss, Ww^Ewf, Ss, Ss, Ww^Ewf, Hh^Fms, Ww^Ewl, Ss, Ss, Ss
