border_size=1
usage=map

Hh^Fp       , Hh^Fp       , Hh^Fp       , Hh^Fp       , Gs^Fms      , Gs^Fms      , Gs^Fms      , Gs^Fms      , Ds          , Ww          , Ww          , Ww          , Ww          , Ww          , Ww          , Hhd         , Hh          , Hh          , Hh          , Hh          , Gg          , Gg          , Gg          , Gg          , Gg          , Gg          , Gs          , Hh          , Hh          , Hh          , Hhd         , Hhd         , Hhd         , Hhd         , Hhd         , Hhd         , Ms          , Ms          , Ms          , Aa^Fpa      , Aa^Fpa      , Ms          , Ms          , Ms          , Ms          , Ms          
Hh^Fp       , Hh^Fp       , Gll^Fp      , Gs^Fms      , Re^Gvs      , Gs^Fms      , Gll^Fp      , Gll^Fp      , Ds          , Ww          , Ww          , Ww          , Ww          , Ww          , Ww          , Hhd         , Gll         , Hh          , Gg          , Gg          , Gs          , Gg          , Gg          , Gg^Es       , Hh          , Gs          , Hh          , Hh          , Hh          , Hhd         , Mm          , Hhd         , Gll^Fp      , Hhd         , Ms          , Ms          , Ms          , Ms          , Ms          , Aa^Fpa      , Ms          , Ms          , Ms          , Ms          , Ms          , Ms          
Hh^Fp       , Hh^Fms      , Gll^Fp      , Re^Gvs      , Re^Gvs      , Gs^Fms      , Gs^Fds      , Gs^Fds      , Gs^Fms      , Ds          , Ww          , Ww          , Ww          , Ww          , Ww          , Gd          , Gd          , Gg          , Gg          , Gg          , Gg          , Gg          , Gs          , Hh          , Mm          , Hh          , Hhd         , Hhd         , Hhd         , Mm          , Mm          , Mm          , Gll^Fp      , Gll^Fp      , Aa^Fpa      , Ms          , Ms          , Ms          , Ms          , Ms          , Ms          , Ms          , Ms          , Ms          , Ms          , Ms          
Hh^Fp       , Hh^Fp       , Gs^Fms      , Re^Gvs      , Gs^Fp       , Re^Ve       , Gll^Fp      , Gll^Fp      , Gs^Fms      , Ds          , Ww          , Ww          , Ww          , Wwr         , Ww          , Ww^Es       , Gs          , Gg          , Gs          , Gg          , Rb          , Rb          , Hhd         , Hhd         , Mm          , Hhd         , Hhd         , Hhd         , Hhd^Fp      , Hhd         , Hhd^Fp      , Mm          , Gll^Fp      , Gll^Fp      , Hhd^Fp      , Mm          , Aa^Fpa      , Ha^Vhha     , Ms          , Ms          , Ms          , Ms          , Ms          , Ms          , Ms          , Ms          
Hh^Fms      , Hh^Fms      , Gs^Fds      , Gs^Fms      , Gs^Fds      , Gs^Fms      , Gs^Em       , Gs^Fms      , Ds^Es       , Ds          , Ww          , Ww          , Ww          , Ww          , Ds          , Gg^Es       , Gg          , Gg          , Gg          , Gg          , Rb          , Rb^Vc       , Re          , Hhd         , Hhd^Fp      , Hhd         , Hh          , Hhd         , Hhd         , Gd^Fp       , Hhd         , Gll^Fp      , Hhd         , Hhd^Fp      , Gd^Fp       , Hhd^Fp      , Ms          , Aa^Fpa      , Ms          , Ms          , Ha^Vhha     , Ms          , Ms          , Ms          , Ha^Vhha     , Ms          
Gs^Fms      , Gs^Fms      , Gg^Efm      , Gs^Fms      , Gs^Fms      , Gll^Fp      , Gs^Fds      , Rd          , Ds          , Ww          , Ww          , Ww          , Ww          , Ww          , Ww          , Gg          , Gs          , Gs          , Gg          , Gg          , Gg          , Re          , Gs          , Gll^Fp      , Gd          , Gs^Fet      , Gs^Es       , Hhd         , Gd          , Hhd         , Hh          , Hhd         , Hhd         , Hhd^Fp      , Hhd         , Aa^Fpa      , Mm          , Mm          , Mm          , Ms          , Ms          , Ms          , Ms          , Ms          , Ms          , Ms          
Gs^Fms      , Gs^Fms      , Gs^Fms      , Gll^Fp      , Gs^Uf       , Gs^Fms      , Gs^Fms      , Gll^Fp      , Gs^Fms      , Ds          , Ww          , Ww^Vm       , Ww          , Ww          , Ww          , Gg          , Gs          , Gs          , Gg          , Gg          , Hh          , Gs          , Hh          , Gd          , Hhd         , Gd          , Hh          , Gd          , Hhd         , Mm          , Mm          , Hh          , Mm          , Hhd         , Mm          , Hhd         , Mm          , Mm          , Mm          , Mm          , Aa^Vea      , Ms          , Ms          , Ms          , Ms          , Ms          
Gs^Fms      , Gs^Fms      , Gll^Fp      , Gs^Fds      , Gll^Fp      , Gs^Fds      , Gs^Fms      , Gs^Fms      , Gg^Fet      , Ds          , Ww          , Ww          , Ww          , Ww          , Ww          , Gg          , Gg          , Gs          , Hh          , Gs          , Hh          , Hh          , Hhd         , Hhd         , Mm          , Mm          , Hh          , Hhd         , Mm          , Mm          , Mm          , Mm          , Mm          , Mm          , Mm          , Mm          , Mm          , Mm          , Mm          , Mm          , Mm          , Ms          , Ms          , Ms          , Ms          , Ms          
Mm          , Gs^Fms      , Gll^Fp      , Gs^Fms      , Ss          , Gs^Fds      , Gs^Fms      , Gs^Fms      , Gs^Fms      , Ds          , Ww          , Ww          , Ww          , Ww          , Wwf^Es      , Wwf^Es      , Gg          , Hh          , Gg          , Hh          , Gs          , Hh          , Gd          , Hhd         , Mm          , Hhd         , Hh          , Hhd         , Hhd         , Mm          , Mm          , Mm          , Mm          , Mm          , Mm          , Mm          , Mm          , Mm          , Mm          , Mm          , Mm          , Mm          , Gd^Fmf      , Ms          , Aa^Vea      , Ms          
Mm          , Mm          , Mm          , Gs^Fms      , Gs^Fms      , Gs^Fms      , Ww^Es       , Gs^Fms      , Ww          , Ds          , Ww          , Ww          , Wwf^Es      , Wwr         , Wwf^Es      , Wwr         , Wwf^Es      , Gg          , Gg          , Gg          , Hh          , Gs          , Hh          , Hhd         , Hhd         , Hhd         , Hh          , Hh          , Hhd         , Hhd         , Hhd         , Mm          , Hhd         , Mm          , Gll^Fp      , Mm          , Gll^Fp      , Mm          , Hh^Fp       , Mm          , Hhd^Fmf     , Mm          , Gll^Fp      , Gll^Fp      , Gll^Fp      , Gll^Fp      
Mm          , Mm          , Mm          , Gs^Fms      , Ss          , Gs^Fms      , Gs^Efm      , Ww          , Ww^Bw\      , Ww          , Ww          , Rd          , Rd          , Wwf^Es      , Wwf^Es      , Wwf^Es      , Wwf^Es      , Gg          , Gs          , Gg          , Hh          , Hh          , Hh          , Hhd         , Hh          , Hh          , Hh          , Hh          , Hh          , Hhd         , Hh          , Hhd         , Hh          , Hh^Fp       , Hhd         , Hh^Fp       , Gll^Fp      , Gll^Fp      , Gll^Fp      , Gd^Fp       , Gd^Fp       , Gd^Fp       , Gll^Fp      , Gll^Fp      , Gll^Fp      , Gll^Fp      
Mm          , Mm          , Ss          , Gs^Uf       , Gs^Fds      , Gs^Fms      , Gs^Fms      , Ww          , Gs          , Ww          , Gd          , Rd          , Gd          , Wwr         , Wwf^Es      , Wwr         , Ww^Es       , Gg          , Gg          , Gg          , Gg^Es       , Hh          , Gg          , Hh          , Gg          , Hh          , Gs          , Gs          , Gg          , Hh          , Gg          , Hh          , Gg          , Hh          , Gs          , Gll^Fp      , Gg          , Gll^Fp      , Gs          , Gll^Fp      , Gll^Fp      , Gll^Fp      , Gll^Fp      , Gll^Fp      , Gll^Fp      , Gll^Fp      
Gs^Fds      , Gs^Fds      , Gs^Fms      , Gll^Fp      , Gs^Fms      , Ss          , Gs^Fds      , Gs^Fms      , Gs^Efm      , Gs^Fms      , Gs          , Gd          , Gs          , Gs          , Gg          , Ww^Es       , Ww          , Ww          , Ww          , Gg          , Gs          , Gg          , Gs          , Gg          , Gg          , Gg          , Gg          , Gg          , Gs^Fds      , Gs          , Gg          , Gg          , Gg          , Gg          , Gg          , Rp^Ve       , Rp          , Gg          , Gg          , Gg          , Rrc         , Gs^Fms      , Rrc         , Gs^Fms      , Gg^Ve       , Gll^Fp      
Gs^Fms      , Gs^Fms      , Gs^Fds      , Gs^Fms      , Gs^Fds      , Gs^Fms      , Gs^Fms      , Gs^Fms      , Rb          , Gs^Fms      , Gs          , Gs          , Gg          , Gg^Es       , Gg          , Gg          , Ww          , Ww^Es       , Ww          , Gg          , Gll^Fp      , Gs^Fds      , Gll^Fp      , Gs          , Gll^Fp      , Gs          , Gll^Fp      , Gs^Fds      , Gll^Fp      , Gs^Fds      , Gll^Fp      , Gs^Fms      , Gll^Fp      , Gg^Es       , Gll^Fp      , Gg          , Rp          , Gg          , Rrc         , Rrc         , Gs^Fms      , Rrc         , Gs^Fms      , Rrc         , Rrc         , Rrc         
Gs^Fds      , Ss          , Gs^Fds      , Gs^Fms      , Gg^Efm      , Gs^Fms      , Gs^Fds      , Gs^Fds      , Gs^Fds      , Rr^Ve       , Rr          , Gs          , Gg          , Gg          , Gll^Fp      , Gs^Fds      , Gs^Fds      , Ww          , Ww          , Ww          , Ww          , Gll^Fp      , Gs^Fms      , Gs^Fms      , Hh^Fms      , Hh^Fms      , Gs^Fms      , Gs^Fms      , Gs^Fms      , Gs^Fms      , Gll^Fp      , Gs^Fms      , Gg^Ve       , Gs^Fms      , Gll^Fp      , Gs^Fms      , Rrc         , Rrc         , Gs^Vht      , Gs^Em       , Gs^Fms      , Rrc^Ve      , Gs^Fms      , Gs^Fms      , Gs^Fms      , Gs^Fms      
Gs^Fds      , Gs^Fms      , Gs^Fds      , Gs^Fds      , Re^Ve       , Gs^Fds      , Re          , Gs^Fms      , Re          , Re          , Gs          , Rr          , Rr          , Gs          , Gll^Fp      , Gs^Fds      , Gs^Fds      , Ww          , Ww^Es       , Ww^Es       , Ww          , Gs^Fms      , Gs^Fds      , Gs^Fms      , Hh^Fds      , Hh^Fms      , Gs^Vht      , Gs^Fms      , Gs^Fet      , Gs^Fms      , Gs^Fms      , Gs^Fms      , Re          , Gs^Fms      , Rrc         , Rrc         , Gs^Fms      , Rp          , Rp          , Gs^Fms      , Gs^Fms      , Gs^Fms      , Gs^Fms      , Gll^Fp      , Hh^Fp       , Gs^Fms      
Gs^Fds      , Gs^Fds      , Gs^Gvs      , Re^Gvs      , Gs^Fds      , Re          , Gs^Fms      , Re          , Gs^Fds      , Gs^Fds      , Gg          , Gg          , Rp          , Gs          , Gs^Fds      , Gs^Fds      , Hh          , Gs^Fds      , Ww          , Ww          , Wo^Es       , Ww^Es       , Wwr         , Gs^Fms      , Hh^Fms      , Hh          , Gll^Fp      , Gs^Em       , Gs^Efm      , Gs^Fms      , Gs^Fms      , Gs^Fds      , Gs^Fms      , Gs^Vht      , Rrc         , Gg          , Gs^Fms      , Rp^Ve       , Rp          , Gll^Fp      , Gs^Fms      , Gs^Fds      , Gs^Fms      , Gs^Fms      , Gs^Fms      , Gs^Fms      
Gs^Fds      , Gs^Fms      , Re^Ve       , Gd^Gvs      , Gs^Fds      , Gs^Fms      , Gs^Fds      , Gs^Fds      , Hh^Fds      , Gs^Fds      , Gs^Fds      , Gg          , Gs^Fds      , Rp          , Gs^Fds      , Gs^Fms      , Gll^Fp      , Gs^Fds      , Ww^Es       , Ww^Es       , Wwr         , Wwr         , Wo^Es       , Gs^Fds      , Ww^Es       , Gs^Fds      , Gs^Fms      , Rp^Ve       , Rp          , Rp^Ve       , Rp          , Gs^Fms      , Rrc         , Rrc         , Gs^Fms      , Gs^Fds      , Gs^Fms      , Gs^Efm      , Gs^Fp       , Rp          , Rr^Ve       , Gs^Fms      , Gs^Fms      , Gs^Ve       , Gs^Fms      , Gs^Fms      
Gs^Fds      , Gs^Fds      , Re          , Gs^Fds      , Gs^Fds      , Gs^Fds      , Gll^Fp      , Gll^Fp      , Hh          , Gs^Fms      , Gs^Fds      , Gs^Fds      , Gs^Fds      , Rp          , Gs^Fds      , Gs^Fds      , Gs^Fds      , Gs^Fds      , Hh^Fds      , Ww^Es       , Gs^Fds      , Wo^Es       , Wo^Es       , Ww^Es       , Wwr         , Gs^Fms      , Gs^Fms      , Gll^Fp      , Gll^Fp      , Rp          , Gs^Fms      , Rrc         , Gs          , Gs^Em       , Gs^Fms      , Gs^Fms      , Hh^Fms      , Gs^Fms      , Gs^Fds      , Gs^Fms      , Gs^Fms      , Gs          , Gd          , Gs^Em       , Gll^Fp      , Gs^Fms      
Gs^Fds      , Gll^Fp      , Gs^Fds      , Re          , Gll^Fp      , Gs^Fds      , Gs^Fds      , Hh^Fds      , Gs^Fds      , Gs^Fds      , Gs^Fds      , Gs^Fds      , Gs^Fms      , Rp          , Rp          , Gs^Fds      , Gs^Fds      , Gs^Fms      , Gs^Fds      , Gs^Fds      , Gs^Fds      , Ww^Es       , Wwr         , Wwr         , Wo^Es       , Gs^Fds      , Gs^Fms      , Gll^Fp      , Gs^Fms      , Gs^Fms      , Ww          , Rrc         , Ww          , Gs^Fms      , Gs^Fms      , Gll^Fp      , Gll^Fp      , Ss          , Gs^Fms      , Gs^Fms      , Gs          , Gd          , Gg^Fet      , Gd          , Gs^Fds      , Gs^Fms      
Gs^Fds      , Gs^Fds      , Re          , Re          , Gs^Fds      , Gs^Fds      , Hh^Fds      , Hh^Fms      , Gs^Fds      , Gs^Fds      , Gg          , Gs^Fds      , Rp          , Rp          , Gs^Fds      , Rrc^Ve      , Hh          , Gs^Fds      , Hh          , Gs^Fds      , Ss          , Ww^Es       , Gs^Fds      , Wo^Es       , Wo^Es       , Ww^Es       , Wwr         , Gs^Fms      , Ww          , Gs^Fds      , Ww          , Ww^Bsb|     , Ww          , Gs^Fds      , Ww          , Gs^Fms      , Gs^Fms      , Hh^Fms      , Gs^Fms      , Gs^Ve       , Gs          , Gd          , Re^Gvs      , Re^Gvs      , Gs^Fms      , Gs^Fms      
Gs^Fds      , Gs^Fds      , Re^Gvs      , Gs^Fds      , Ss          , Gs^Fds      , Gs^Fds      , Hh          , Gs^Fms      , Gs^Fds      , Rp          , Rp          , Gs^Fds      , Gs^Fds      , Gs^Fds      , Gs^Fds      , Gd^Fdw      , Gs^Fms      , Gs^Fds      , Hh^Fms      , Gs^Fds      , Gs^Fds      , Gs^Fds      , Ww^Es       , Wwr         , Wwr         , Wo^Es       , Gs^Fds      , Ww          , Ww          , Cv^Fet      , Ww^Bsb|     , Cv^Fet      , Ww          , Ww          , Gs^Fds      , Gs^Fds      , Gs^Fms      , Gll^Fp      , Gs^Efm      , Gs^Fms      , Gs^Fms      , Gll^Fp      , Gs^Em       , Gll^Fp      , Gs^Fms      
Gs^Fds      , Re^Gvs      , Re^Gvs      , Gs^Fds      , Gs^Fds      , Ss          , Gs^Fds      , Gs^Fms      , Gs^Fms      , Gs^Fds      , Rp          , Gll^Fp      , Gs^Fds      , Gs^Fds      , Gs^Fms      , Gs^Fds      , Gs^Fds      , Gs^Fds      , Gs^Fds      , Gs^Fds      , Gs^Fds      , Gs^Fds      , Gs^Fds      , Ww^Es       , Gs^Fds      , Wo^Es       , Wo          , Ww          , Ww          , Ww          , Cv          , Rp          , Cv          , Ww          , Ww          , Ww          , Ww          , Gs^Fms      , Gs^Fms      , Gs^Fms      , Gs^Em       , Gs^Fms      , Gd          , Gs          , Gs^Fms      , Gs^Fms      
Gs^Fds      , Re^Ve       , Gs^Fds      , Gs^Fds      , Gs^Fds      , Ss          , Hh^Fp       , Gs^Fms      , Gs^Fds      , Gs^Fds      , Rp          , Hh^Fp       , Hh^Fms      , Hh^Fds      , Gll^Em      , Gll^Fp      , Gll^Fp      , Gs^Fds      , Gs          , Gs          , Gs          , Re^Ve       , Re^Gvs      , Gs^Fds      , Gs^Fds      , Ww          , Ww          , Ww          , Cv^Fet      , Cv          , Gs          , Gs          , Gs          , Cv          , Cv^Fet      , Ww          , Ww          , Gs^Fds      , Gs^Fms      , Gs^Fms      , Gs^Fms      , Gs^Fds      , Gs^Fms      , Gd^Ve       , Gs^Fms      , Gs^Fms      
Gs^Fds      , Gs^Fds      , Hh^Fms      , Gs^Fds      , Hh^Fms      , Hh^Fds      , Hh^Fms      , Hh^Fms      , Gs^Fds      , Gs^Fds      , Rp          , Gll^Fp      , Gs^Fds      , Hh^Fms      , Gs^Fds      , Gll^Fp      , Gs^Fds      , Gs^Fds      , Gs          , Gs^Fet      , Gll^Emf     , Re^Gvs      , Re^Gvs      , Gs          , Ww          , Ww          , Ww          , Ww          , Cv          , Gg          , Gs^Efm      , Kv          , Gs^Efm      , Gg          , Cv          , Ww          , Ww          , Ww          , Ww          , Gs^Fms      , Ss          , Gs^Fp       , Gd          , Gd          , Gs^Fms      , Gs^Fms      
Hh^Fp       , Hhd         , Mm          , Hhd         , Hh^Fms      , Gs^Fds      , Re^Gvs      , Gs^Fds      , Gs^Fds      , Gg^Efm      , Gg          , Rp          , Gs^Fds      , Hh          , Gs^Fms      , Gs^Fds      , Gs^Fds      , Gg^Ve       , Gg^Efm      , Gll^Emf     , Ss          , Gs^Vht      , Gs^Fds      , Gs          , Ww          , Ww^Es       , Ww          , Cv          , Gg^Emf      , Gg^Efm      , Gs^Efm      , Wwt         , Gs^Efm      , Gg^Efm      , Gg^Emf      , Cv          , Ww          , Ww          , Ww          , Gs^Fms      , Gs^Fp       , Gs          , Gs^Fms      , Gs^Fds      , Gs^Fms      , Gs^Fms      
Hhd         , Mm          , Mm          , Mm          , Hhd         , Gs^Fds      , Re^Gvs      , Re^Gvs      , Gs^Fds      , Gs^Fds      , Gs^Fds      , Rp          , Gll^Fp      , Hh^Fds      , Hh^Fds      , Hh          , Gs^Fds      , Gg^Efm      , Gs^Fds      , Ss          , Ss          , Gs^Fds      , Gs^Fds      , Gs^Fds      , Gs^Fds      , Ww          , Ww          , Cv          , Cv          , Kv          , Cv          , Gs^Efm      , Cv          , Kv          , Cv          , Cv          , Ww          , Ww          , Gs^Fms      , Gs^Fms      , Gs^Fms      , Gs^Ve       , Gs          , Gs^Fms      , Gll^Fp      , Gs^Fms      
Mm          , Mm          , Mm          , Mm          , Hh^Fms      , Gs^Fds      , Re          , Re^Ve       , Re          , Re          , Re          , Rp          , Gs^Fds      , Gs^Fds      , Gs^Fds      , Gs^Fds      , Hh^Fp       , Gs^Fms      , Gs^Fds      , Gs^Fds      , Gs^Fds      , Gs^Fds      , Gs^Fms      , Gs^Fds      , Gs^Fds      , Ww          , Ww          , Cv^Fet      , Ww          , Ww          , Cv          , Gs          , Cv          , Ww          , Wwr         , Cv^Fet      , Ww          , Ww          , Gs^Fds      , Hh^Fds      , Gll^Fp      , Gs^Fms      , Gs          , Gll^Fp      , Gs^Fms      , Gs^Fms      
Hhd         , Mm          , Wwf         , Hh^Fds      , Re          , Re^Ve       , Re          , Gll^Fp      , Gs^Fds      , Gs^Fds      , Gs          , Rp          , Gs^Fds      , Gs^Fds      , Hh          , Hh^Fms      , Re^Gvs      , Gs^Fds      , Gll^Fp      , Gs^Fms      , Gs^Fds      , Gs^Fds      , Mm          , Gs^Fds      , Gs^Fds      , Ww          , Wwf         , Ww          , Ww          , Cv          , Cv          , Gs          , Cv          , Cv          , Ww          , Ww          , Wo^Es       , Ww^Es       , Gs^Fds      , Gs^Fms      , Gs^Fms      , Gs^Fms      , Gs^Vht      , Gs          , Gs^Ve       , Gs^Fms      
Gs^Fds      , Hh^Fds      , Wwf         , Hh^Fms      , Re          , Gll^Fp      , Gll^Fp      , Gll^Fp      , Gs^Fds      , Gs^Fms      , Rp          , Rp          , Gs^Fds      , Gs^Fds      , Gs^Fds      , Hh^Fp       , Re^Ve       , Gs^Emf      , Gll^Fp      , Gs^Fds      , Gs^Fds      , Gs^Fms      , Gs^Fds      , Gs^Fds      , Gs^Fds      , Gs^Fds      , Gs^Fds      , Ww          , Ww          , Cv^Fet      , Ww          , Rp          , Ww          , Cv^Fet      , Ww          , Wwr         , Wo^Es       , Wwr         , Wwr         , Gs^Fms      , Ww^Es       , Gs^Fms      , Gs^Fms      , Gs^Fms      , Gs^Fms      , Gs^Fms      
Gs^Fds      , Gs^Fds      , Ss          , Ss          , Re^Ve       , Gll^Fp      , Gll^Fp      , Gll^Fp      , Gs^Fds      , Gs^Fds      , Rp          , Gg^Efm      , Gs^Fms      , Gs^Fds      , Gs^Fds      , Re^Gvs      , Re^Gvs      , Gg^Efm      , Gs          , Gs^Fds      , Gs^Es       , Gs^Fds      , Gs^Fds      , Gs^Fds      , Hh^Em       , Gs^Fds      , Gs^Fds      , Ww          , Gs^Fds      , Ww          , Ww          , Ww^Bsb|     , Ww          , Ww          , Gs^Fds      , Wo^Es       , Wwr         , Wwr         , Wo^Es       , Gs^Fds      , Ww^Es       , Gs^Fds      , Ww^Es       , Gs^Fms      , Gs^Fms      , Gs^Fms      
Gs^Fms      , Ss          , Ss          , Gs^Emf      , Gs^Fds      , Gs^Fds      , Gs^Fds      , Gs^Fms      , Gs^Fds      , Gs^Fds      , Gs^Fds      , Rp          , Gs^Fds      , Gll^Fp      , Gs^Fms      , Gs^Fds      , Gs^Fms      , Gs^Fds      , Gs^Fds      , Gs          , Gs^Fds      , Gs          , Gs^Vht      , Gs^Fds      , Gs^Fds      , Gs^Fds      , Gll^Fp      , Gs^Fds      , Gs^Fds      , Ww          , Cv^Fet      , Ww^Bsb|     , Cv^Fet      , Ww          , Gs^Fds      , Ww^Es       , Gs^Fds      , Wo^Es       , Wwr         , Wwr         , Wo^Es       , Wwr         , Wo^Es       , Gs^Fds      , Ww^Es       , Gs^Fms      
Gs^Fms      , Gs^Fms      , Gs^Fds      , Wwf         , Wwf         , Gs^Fds      , Gs^Fds      , Gs^Fds      , Gs^Fds      , Gs^Fds      , Gg^Em       , Rp          , Gs^Fms      , Gs^Fds      , Gll^Fp      , Hh          , Gs^Fds      , Hh          , Hh^Fds      , Gs^Fds      , Gs^Fds      , Gll^Fp      , Gs^Fds      , Gs^Fds      , Gs^Fms      , Hh          , Gs^Fds      , Gll^Fp      , Gs^Fds      , Gs^Fds      , Gs^Fds      , Rrc         , Gs^Fds      , Gs^Fds      , Hh^Fds      , Gs^Fds      , Wwf         , Ww^Es       , Gs^Vht      , Wo^Es       , Wwr         , Wo^Es       , Wwr         , Wwr         , Wo^Es       , Ww^Es       
Gs^Fms      , Gs^Fms      , Gs^Fds      , Gs^Fds      , Gs^Fds      , Ss          , Gg^Emf      , Ss          , Ss          , Gs^Fds      , Gs^Fds      , Rp          , Gs^Fds      , Gs^Fds      , Gs^Fds      , Gll^Fp      , Hh^Fds      , Hh^Fds      , Gs^Fds      , Gs^Fds      , Ss          , Gs^Fds      , Hh          , Gs^Fms      , Gll^Fp      , Gs^Fds      , Re^Gvs      , Re^Gvs      , Gs^Fds      , Gs^Fds      , Gg^Es       , Rrc         , Gg          , Hh^Fds      , Gs^Fds      , Gs^Fds      , Wwf         , Gs^Fds      , Gs^Fds      , Ww^Es       , Gs^Fds      , Ww^Es       , Gs^Fms      , Wo^Es       , Gd^Ve       , Wo^Es       
Gs^Fms      , Gll^Fp      , Gll^Fp      , Gs^Fms      , Gs^Fds      , Ss          , Ss          , Gs^Fds      , Ss          , Ss          , Rp          , Rp          , Gs^Fds      , Hh          , Hh^Fds      , Gs^Fds      , Hh^Fds      , Gs^Fms      , Gs^Em       , Ss          , Ss          , Gs^Fds      , Gs^Fds      , Gs^Fms      , Gs^Fms      , Gs^Fds      , Gs^Fds      , Gg^Ve       , Gs^Fds      , Gs          , Rrc         , Rrc         , Gg          , Gs^Fds      , Gs^Fds      , Wwf         , Hh^Fds      , Gs^Fds      , Gs^Fds      , Gs^Fds      , Gs^Fds      , Gs^Fds      , Gs^Fds      , Ww^Es       , Gd          , Gs^Fds      
Hh^Fds      , Gs^Fds      , Gll^Fp      , Gs^Fds      , Gs^Fds      , Ss          , Rp          , Ss          , Rp          , Ss^Bw/      , Ss^Bw|      , Ss          , Ss          , Ss          , Hh^Fds      , Hh^Fds      , Gs^Fds      , Gs^Fds      , Gs^Fds      , Gs^Fds      , Gs^Vht      , Gs          , Gd^Fdw      , Gd^Fdw      , Gs^Fds      , Gs^Fds      , Gs^Fds      , Gs^Fds      , Rrc         , Rrc         , Gs^Fds      , Gs          , Gs^Fds      , Gg^Efm      , Gs^Fds      , Wwf         , Hh^Fms      , Gs^Fds      , Gll^Fp      , Hh^Fms      , Hh^Fds      , Gs^Fds      , Hh^Fds      , Gs^Fds      , Gd          , Gs^Fds      
Hh^Fds      , Hh^Fds      , Gs^Fds      , Gs^Fds      , Gs^Fds      , Rp          , Gs^Fds      , Rp          , Gs^Fds      , Ss          , Rp          , Ss          , Gs^Fds      , Gs^Fds      , Gd^Fms      , Gs^Fds      , Gs^Fds      , Gs^Fds      , Hh          , Gg^Efm      , Gg^Efm      , Gs^Fds      , Gs^Fds      , Gd^Fdw      , Gs^Fds      , Gs^Fds      , Rrc         , Rb^Vht      , Rrc         , Gg          , Gs^Fds      , Gs^Vht      , Gs^Fds      , Gs^Fds      , Hh^Fds      , Wwf         , Gs^Fds      , Gs^Fds      , Gs^Fds      , Hh^Fds      , Gll^Fp      , Hh^Fms      , Hh^Fds      , Gd^Es       , Gs^Fms      , Gs^Fms      
Hh^Fds      , Hh^Fds      , Gs^Fds      , Re^Gvs      , Re^Gvs      , Re^Gvs      , Gs^Efm      , Rr^Ve       , Gs^Es       , Gs^Fds      , Rp          , Gs          , Gs^Fds      , Gd^Fds      , Gd^Fdw      , Gd^Fds      , Gs^Fms      , Gs^Fds      , Gs^Fds      , Gs^Fms      , Gs^Fds      , Gs^Fds      , Gs^Fds      , Gs^Fds      , Rrc         , Rrc         , Gs^Fds      , Rrc         , Gs^Fds      , Gs^Fds      , Gs^Fds      , Gs^Fds      , Wwf         , Hh^Fds      , Wwf         , Wwf         , Hh^Fms      , Gd^Vht      , Gs^Fds      , Gs^Fds      , Gs^Fds      , Gs^Fds      , Gs^Fds      , Gd          , Gs^Fds      , Gs^Fms      
Gs^Fds      , Gs^Fds      , Gs^Fds      , Re^Gvs      , Gs^Fds      , Re^Gvs      , Gs^Fds      , Gs^Es       , Gs^Fds      , Gs^Fds      , Gs          , Rp          , Gs^Fds      , Gd^Fdw      , Gd^Fms      , Gd^Fds      , Gs^Fds      , Gs^Fds      , Rp          , Gs^Fms      , Rp          , Rp          , Rr          , Gs^Fds      , Rrc         , Gs^Fds      , Gs^Fms      , Gs^Fds      , Hh^Fds      , Gs^Fds      , Wwf         , Wwf         , Hh^Fms      , Wwf         , Gs^Fds      , Gs^Fds      , Gs^Fds      , Gd          , Gll^Fp      , Gs^Fds      , Gll^Fp      , Gs^Fds      , Gs^Fds      , Gd          , Gs^Fds      , Gs^Fds      
Gs^Fds      , Gs^Fds      , Gs^Fds      , Gs^Fds      , Gs^Fds      , Gll^Fp      , Gs^Fds      , Gs^Fds      , Gll^Fp      , Gs^Fds      , Rp          , Rp          , Gll         , Gs^Fds      , Gs^Fds      , Gs^Fds      , Gs^Fds      , Rp          , Gs^Fds      , Rp          , Gs^Fds      , Gg^Ve       , Gs^Fds      , Rrc         , Gs^Fds      , Gs^Fds      , Gs^Fds      , Hh^Fds      , Mm          , Mm          , Wwf         , Hh^Fds      , Gs^Fms      , Gd^Ve       , Gd          , Gd          , Gd          , Gd^Es       , Gs^Fds      , Gs^Fds      , Gs^Fds      , Re^Emf      , Re^Gvs      , Gd^Ve       , Gs^Fds      , Gs^Fds      
Gs^Fds      , Gs^Fds      , Gs^Fds      , Gs^Fds      , Ss          , Gs^Fds      , Gs^Fds      , Gs^Fds      , Gs^Fds      , Gs^Fds      , Gs^Fds      , Gs^Fds      , Gs^Fds      , Gll         , Gll         , Rr^Ve       , Rp          , Rp          , Gs^Fms      , Gs^Fms      , Gs^Fds      , Gs^Fds      , Gs^Fds      , Rrc         , Gs^Fds      , Gs^Fds      , Gs^Fms      , Hh^Fds      , Wwf         , Wwf         , Gs^Fds      , Gs^Fds      , Gs^Fms      , Gs^Efm      , Gs^Fds      , Gs^Fds      , Gs^Fds      , Gs^Fds      , Mm          , Gs^Fds      , Gs^Fds      , Re^Gvs      , Gs^Efm      , Gs^Fds      , Gs^Fms      , Gs^Fms      
Gs^Fds      , Gs^Fds      , Gg^Fet      , Gs^Fds      , Gs^Fds      , Gs^Fds      , Gs^Fms      , Gs^Fds      , Gs^Fms      , Hh^Fds      , Hh^Fds      , Gs^Fds      , Gs^Fds      , Re^Ve       , Gd          , Gs^Fds      , Gs^Fms      , Gll^Fp      , Gll^Fp      , Gll^Fp      , Gll^Fp      , Gs^Fds      , Gs^Fds      , Rrc         , Rrc         , Gs^Fds      , Gs^Fds      , Gs^Fds      , Wwf         , Gs^Fp       , Gs^Fds      , Gs^Fds      , Gs^Fds      , Gs^Fds      , Gs^Fds      , Gg^Fet      , Mm          , Gs^Fms      , Gll^Fp      , Gs^Fds      , Gs^Fds      , Gd^Ve       , Gs^Efm      , Gs^Fds      , Gs^Fms      , Hh^Fms      
Gs^Fds      , Gs^Fds      , Gs^Fds      , Gs^Fds      , Ss          , Gs^Fds      , Ss          , Hh^Fds      , Mm          , Mm          , Gs^Fds      , Gs^Fds      , Gg^Ve       , Gd          , Gll         , Gll         , Gll^Fp      , Gll^Fp      , Gll^Fp      , Gll^Fp      , Gll^Fp      , Gs^Fds      , Gs^Fds      , Mm          , Rrc         , Gs^Fds      , Gs^Fds      , Gs^Fds      , Wwf         , Gs^Fds      , Gs^Fds      , Gs^Fds      , Gs^Fds      , Hh          , Gs^Fds      , Mm          , Gll^Fp      , Gll^Fp      , Gll^Fp      , Gll^Fp      , Gs^Fms      , Gs^Fds      , Gs^Fds      , Gs^Fds      , Hh^Fms      , Hh^Fms      
Gs^Fds      , Gs^Fds      , Gs^Fds      , Ss          , Ss          , Ss          , Gs^Fds      , Hh^Fds      , Hh^Fds      , Mm          , Gll^Fp      , Gs^Fds      , Gs^Fds      , Gs^Fds      , Gll^Fp      , Gll^Fp      , Gll^Fp      , Gll^Fp      , Gll^Fp      , Gll^Fp      , Gll^Fp      , Gs^Fds      , Gs^Fds      , Rrc         , Gs^Fds      , Gs^Fds      , Gs^Fds      , Wwf         , Gs^Fds      , Ds          , Hhd         , Ds          , Gs^Fds      , Gs^Fds      , Gs^Fds      , Mm          , Gll^Fp      , Gll^Fp      , Gll^Fp      , Gll^Fp      , Gs^Fms      , Gs^Fds      , Gs^Fds      , Gs^Fds      , Hh^Fms      , Hh^Fms      
Gs^Fds      , Gs^Fds      , Ss          , Ss          , Ss          , Ss          , Gs^Fds      , Gs^Fds      , Gs^Fds      , Gs^Fds      , Gs^Fds      , Gs^Fds      , Gs^Fds      , Gs^Fds      , Gs^Fms      , Gll^Fp      , Gll^Fp      , Gll^Fp      , Gll^Fp      , Gll^Fp      , Gll^Fp      , Gs^Fds      , Gg          , Rrc         , Gg          , Gs^Fds      , Gs^Fds      , Wwf         , Ds          , Ds          , Gs^Fds      , Ds          , Gs^Fds      , Gs^Fds      , Gs^Fds      , Gs^Fms      , Gs^Fms      , Gll^Fp      , Gs^Fms      , Gll^Fp      , Gs^Fds      , Gs^Fds      , Hh^Fms      , Hh^Fms      , Hh^Fms      , Hh^Fms      
