Xu, Xu, Xu, Xu, Xu, Xu, Xu, Xu, Xu, Xu, Xu, Wog, Xu, Xu, Xu, Xu, Xu, Xu, Xu, Xu, Xu, Xu, Xu, Xu
Xu, Xu, Xu, Xu, Xu, Xu, Xu, Xu, Xu, Xu, Xu, Wog, Xu, Xu, Xu, Xu, Xu, Xu, Xu, Xu, Xu, Xu, Xu, Xu
Xu, Xu, Xu, Xu, Xu, Xu, Xu, Xu, Xu, Xu, Xu, Wog, Wog, Xu, Xu, Xu, Xu, Xu, Xu, Xu, Xu, Xu, Xu, Xu
Xu, Xu, Xu, Xu, Xu, Xu, Xu, Xu, Xu, Xu, Xu, Xu, Xu, Wog, Wog, Xu, Xu, Xu, Xu, Xu, Xu, Xu, Xu, Xu
Xu, Xu, Xuc, Xu, Xu, Xu, Xu, Xu, Xu, Xu, Xu, Xu, Xu, Xu, Wog^Xo, Xu, Xu, Xu, Qxu, Xu, Qxu, Xu, Xu, Xu
Urb^Br\, Uu, Uu, Xu, Xu, Xu, Xu, Xu, Cud, Cud, Cud, Xu, Xu, Xu, Wog, Xu, Xu, Qxu, Qxu, Qxu, Qxu, Xu, Uu, Uu
Uu, Urb^Br\, Cud, Cud, Uu^Br\, Uh, Uh^Uf, Uh^Uf, Uu, Uu, Uh, Xu, Xu, Wwg, Wwg, Xu, Cud, Qxu, Uh, Uh, Uh, Cud, Cud, Urb
Xu, Cud, Urb^Ii, Urb^Ii, Urb^Ii, Uu^Br\, Uu, Uu, Cud, Uu, Uu, Uu^Ufi, Uu^Ufi, Uu^Ufi, Wwf^Es, Wwf, Uh^Uf, Uh^Uf, Ce, Ce^Es, Ce^Ecf, Urb, Urb, Cud
Xu, Xu, Uh^Uf, Urb^Ii, Uu^Ii, Urb^Br|, Urb^Br\, Cud, 2 Kud, Cud, Urb, Uu^Uf, Urb, Uu^Es, Urb^Es, Wwf, Urb, Urb, Ce^Ii, 1 Ke, Ce, Urb, Uu, Xu
Xu, Xu, Xu, Uu^Uf, Uh, Uu, Uh, Cud, Cud, Cud, Urb, Urb, Urb^Es, Urb, Urb, Wwf^Es, Wwf, Urb^Ii, Uu^Ii, Ce, Uu, Uu, Xu, Xu
Xu, Xu, Xu, Xu, Cud, Uh, Uu, Uu, Rb^Emf, Uu, Re^Em, Uu^Es, Uu^Es, Uh, Uh^Uf, Uh^Uf, Uh^Uf, Wwf^Ii, Wwg, Uu, Uu, Xu, Xu, Xu
Xu, Xu, Xu, Xu, Xu, Cud, Cud, Rb^Em, Re^Emf, Rb^Emf, Qxu, Qxu, Qxu, Uh^Uf, Qxu, Uh^Uf, Xu, Cud, Xu, Wwg, Xu, Xu, Xu, Xu
Xu, Xu, Xu, Xu, Xu, Xu, Xu, Re^Emf, Re^Emf, Re^Emf, Qxu, Qxu, Qxu, Qxu, Xu, Xu, Xu, Xu, Xu, Wog^Xo, Xu, Xu, Xu, Xu
Xu, Xu, Xu, Xu, Xu, Xu, Xu, Qxu, Qxu, Qxu, Qxu, Qxu, Xu, Qxu, Xu, Xu, Xu, Xu, Xu, Wog, Wog, Xu, Xu, Xu
Xu, Xu, Xu, Xu, Xu, Xu, Xu, Xu, Xu, Xuc, Xu, Xu, Xu, Xu, Xu, Xu, Xu, Xu, Xu, Xu, Xu, Wog, Wog, Xu
Xu, Xu, Xu, Xu, Xu, Xu, Xu, Xu, Xu, Xu, Xu, Xu, Xu, Xu, Xu, Xu, Xu, Xu, Xu, Xu, Xu, Xu, Xu, Wog
Xu, Xu, Xu, Xu, Xu, Xu, Xu, Xu, Xu, Xu, Xu, Xu, Xu, Xu, Xu, Xu, Xu, Xu, Xu, Xu, Xu, Xu, Xu, Xu
Xu, Xu, Xu, Xu, Xu, Xu, Xu, Xu, Xu, Xu, Xu, Xu, Xu, Xu, Xu, Xu, Xu, Xu, Xu, Xu, Xu, Xu, Xu, Xu
Xu, Xu, Xu, Xu, Xu, Xu, Xu, Xu, Xu, Xu, Xu, Xu, Xu, Xu, Xu, Xu, Xu, Xu, Xu, Xu, Xu, Xu, Xu, Xu
Xu, Xu, Xu, Xu, Xu, Xu, Xu, Xu, Xu, Xu, Xu, Xu, Xu, Xu, Xu, Xu, Xu, Xu, Xu, Xu, Xu, Xu, Xu, Xu
