Gg, Gg, Hh, Hh, Mm^Xm, Mm^Xm, Xu, Xu, Xu, Xu, Xu, Xu, Xu, Xu, Xu, Xu, Xu, Xu, Xu, Xu, Xu, Xu, Xu, Xu, Xu, Xu, Xu, Xu, Xu, Xu, Xu, Xu, Xu, Xu, Xu, Uu, Uu, Uu, Uu, Xu, Xu, Xu
Hh, Gg, Hh^Vhh, Mm, Xu, Xu, Uh, Uh, Xu, Xu, Xu, Xu, Xu, Xu, Xu, Xu, Xu, Xu, Qxu, Xu, Xu, Xu, Uh^Vu, Xu, Xu, Xu, Xu, Xu, Xu, Xu, Xu, Xu, Xu, Xu, Qxu, Uh, Uu, Uh, Xu, Xu, Xu, Xu
Mm, Hh, Hh, Mm, Xu, Uh^Vu, Uu, Uu, Re, Uh, Uh, Uh, Uh, Xu, Xu, Xu, Qxu, Qxu, Uu, Uh, Uh, Uh, Uh, Uh, Uu, Xu, Uu, Uh^Vu, Tb^Tf, Xu, Uh, Uh^Vu, Wwg, Xu, Uh, Uh, Uh, Xu, Xu, Xu, Xu, Xu
Mm^Xm, Mm, Xu, Uu^Ii, Uu^Ii, Uu^Ii, Re^Br\, Uu, Cte, Cte, Cte, Uh^Tf, Uu^Tf, Xu, Xu, Qxu, Uh^Vu, Uh, Chr, Uue, Uu, Uu, Cer, Cer, Cer, Uu^Tf, Re, Tb^Tf, Re^Br\, Uu, Uu, Wwf, Wwg, Wwg, Uu^Vu, Uh, Qxu^Bw\, Xu, Xu, Xu, Xu, Xu
Xu, Xu, Xuc, Xuc, Re^Br/, Re^Br/, Uu, Rd^Br\, Cte, 2 Khr, Cte, Uu^Tf, Xu, Xu, Xu, Qxu, Uh, Uh, Uue, Re, Uu, Uu, Cer, 8 Ket, Cer, Uu, Uu^Br/, Re^Br/, Rd, Uu^Br\, Chr, Wwf, Wwf, Uh^Tf, Uu^Tf, Qxu, Qxu, Uu, Uu, Xu, Xu, Xu
Xu, Xuc, Uh^Dr, Re^Br/, Uu, Chr^Ii, Uu, Uu^Vu, Uu, Cte, Rd, Uu, Uu^Vu, Xu, Xu, Uu, Uu, Uu, Uh, Re, Rd, Urb, Re, Cer, Re^Br/, Uu^Br/, Xuc, Uu^Vu, Re, Rd, Urb, Uu, Uu^Tf, Uh^Tf, Uh^Tf, Uu, Qxu^Bcx\, Xu, Xu, Uu, Xu, Xu
Xu, Xuc, Uh^Dr, Re^Br|, Uu, Uu, Rd^Tf, Re, Re^Es, Uu^Es, Uu^Es, Uu^Vu, Xu, Xu, Uu, Uu^Pr\, Xu, Uh, Xu, Xu, Xu, Urb, Re^Br/, Re^Br/, Xuc, Xuc, Xu, Xuc, Xuc, Uu, Urb, Re, Xu, Xu, Qxu, Qxu, Qxu, Qxu^Bcx\, Uu, Uu, Xu, Xu
Xu, Xu, Uh, Uu^Br|, Uu, Uh, Tb^Tf, Chr, Rd, Uu^Es, Re, Uh, Urb, Uu^Pr\, Xu, Xu, Xu, Xu, Xu, Xu, Xu, Urb^Br|, Re^Es, Uu^Vud, Xuc, Xu, Xuc, Xu, Xuc, Urb, Uu, Xu, Xu, Qxu, Qxu, Qxu, Qxu, Uu^Vu, Uu, Uu, Xu, Xu
Xu, Xu, Xu, Uu^Br|, Uu^Tf, Uh, Xuc, Xu, Uu^Vu, Uu, Uh^Dr, Tb^Tf, Tb^Tf, Xu, Xu, Xu, Xu, Xu, Uh, Chr, Rd, Uu^Br\, Uu^Br\, Uh, Uh, Xuc, Qxu, Xuc, Rd, Uu, Uu, Uu^Vu, Xu, Qxu, Qxu, Qxu, Rd^Es, Uu, Uu, Uu, Uh^Vu, Xu
Xu, Xu, Xu, Uu^Br|, Uu, Uu, Xuc, Xu, Xu, Xu, Xu, Tb^Tf, Xu, Xu, Xu, Xu, Xu, Xu, Uh^Dr, Uu^Tf, Rd, Re^Vu, Re, Uu^Br|, Uu, Qxu, Chr, Qxu, Re, Uu, Xu, Xu, Xu, Uh, Rd, Re, Cud, Cud, Cud, Uh, Xu, Xu
Xu, Xu, Xu, Uu^Br\, Rd^Br\, Re, Uu, Xuc, Xuc, Xu, Xu, Xu, Xu, Xu, Xu, Xu, Xu, Uh, Uu, Uh^Dr, Qxu, Uu^Tf, Re, Uu^Br|, Uue, Uue, Uue, Uue, Rd^Es, Chr, Tb^Tf, Xu, Cud, Uu^Vud, Uu, Uu, Cud, 6 Kud, Cud, Uh^Tf, Xu, Xu
Xu, Xu, Xu, Xu, Uu, Uu^Br\, Uu^Br\, Uu^Vu, Uu, Xuc, Xuc, Xu, Xu, Xu, Xu, Xu, Cud, Uh, Uu, Uu, Qxu, Uu^Vu, Chr, Kh, Re, Uue, Re, Uue, Uue, Uue^Tf, Uu^Vu, Xu, Uu, Uu, Uh^Dr, Uh, Xu, Cud, Xu, Uh, Xu, Xu
Uu^Ii, Uu^Ii, Uu^Ii, Xu, Uu, Uu, Ce, Ce, Ce, Uu, Tb^Tf, Uu, Re, Xu, Tb^Tf, Uh, Rd, Uu, Rd^Es, Qxu, Chr, Qxu, Qxu, Rd, Re, Chr, Chr, Uue, Uue, Uue, Uu, Uu, Uu, Rd, Uh^Dr, Xu, Xuc, Xu, Cud, Xu, Cud, Xu
Re^Ii, Uu^Ii, Re, Uu^Vu, Uu, Uu, Ce, Ce^Es, 1 Ke, Ce, Rd^Br\, Uu, Re^Br/, Uu, Uu^Vu, Tb^Tf, Rd, Re^Es, Rd, Uu, Uh, Qxu, Re^Br\, Chr, Chr, Uue^Tf, Uue^Tf, Uue, Rd^Br/, Uu, Rd, Uu, Uu, Uh, Uh, Xuc, Re^Br|, Uu^Br/, Uu, Cud, Urb, Uu
Re^Ii, Re^Ii, Re, Uu^Tf, Uu^Es, Uu^Es, Uu^Es, Ce, Ce, Ce, Uu, Re^Br/, Uu, Rd^Br\, Re^Br/, Re^Br/, Rd^Br\, Uue^Es, Uue, Re, Re^Br/, Rd^Br/, Chr, Kh, Re^Br\, Re, Re^Br/, Rd^Br/, Rd, Re^Br\, Uh^Br\, Uu, Uu, Chr, Uh, Uu, Urb^Br/, Uu, Uh, Urb, Uu, Urb
Uu^Ii, Uu^Ii, Re, Re, Uu^Tf, Uu^Es, Uu, Rd, Uu, Uu, Uh, Re, Re, Uh, Uu^Vu, Tb^Tf, Uu, Re^Br\, Rd^Br\, Rd^Br/, Re, Rd, Re, Chr, Uue, Rd^Br/, Chr, Re, Uu, Uh, Uu, Uu^Br\, Re^Br\, Uu, Uu^Br/, Urb^Br/, Uh, Uh, Qxu, Uh, Qxu, Xu
Xu, Re, Xu, Uu, Uu, Uu, Rd, Re, Xu, Uu^Vu, Chr, Uh^Dr, Xu, Uu, Xu, Chr, Xu, Uu, Tb^Tf, Tb^Tf, Uu, Chr, Chr, Uue, Chr, Re, Uue^Vu, Uue, Uu, Uue, Chr, Uu, Uu, Rd^Br\, Uu^Br\, Xu, Xu, Xu, Xu, Qxu, Qxu, Qxu
Xu, Xu, Xu, Xu, Uu, Uu, Uu, Chr, Xu, Xu, Xu, Xu, Xu, Xu, Xu, Xu, Xu, Uu, Uu^Vu, Uu, Uu, Rd, Uu, Kh, Uue, Uue, Uue, Uue, Uu^Tf, Uu, Uu, Uu, Uu, Re, Uu^Br|, Uue^Tf, Xu, Xu, Xu, Xu, Qxu, Qxu
Xu, Xu, Xu, Xu, Chr, Uu, Uu, Uu, Uu^Tf, Xu, Xu, Xu, Xu, Xu, Xu, Xu, Xu, Xu, Xu, Xu, Xu, Uu, Uu, Uu, Uh, Qxu, Qxu, Uu, Qxu, Uu, Uu^Vu, Uu, Xu, Rd, Rd^Br|, Rd, Uh, Uh^Vu, Xu, Xu, Xu, Qxu
Xu, Xu, Xu, Xu, Xu, Uu, Re, Uu^Tf, Xu, Xu, Xu, Xu, Qxu, Xu, Qxu, Xu, Xu, Xu, Re^Es, Rd, Uu, Re, Uu, Uu, Uu, Qxu, Xu, Qxu, Xu, Qxu, Xu, Xu, Xu, Xu, Uue, Uue^Br\, Uu^Br\, Cud^Br\, Cud, Xu, Qxu, Qxu
Xu, Xu, Xu, Xu, Uu, Rd^Em, Tb^Tf, Re^Es, Xu, Xu, Xu, Qxu, Wwg^Ii, Qxu, Qxu, Qxu, Xu, Xu, Rd, Uu, Uu, Re, Xu, Uu^Vu, Xu, Xu, Xu, Xu, Xu, Xu, Xu, Xu, Xu, Xu, Xu, Cud, Cud, Cud, 5 Kud, Qxu, Xu, Qxu
Xu, Xu, Xu, Uh^Vud, Uu^Tf, Rd, Uu, Re^Es, Uu^Tf, Xu, Uu^Tf, Wwg, Wwg, Uh^Tf, Uh, Qxu, Xu, Xu, Xuc, Tb^Tf, Uue, Xuc, Xuc, Xu, Xu, Uh^Ii, Rb^Emf, Xu, Cud, Cud, 4 Kud, Cud, Cud, Xu, Xu, Xu, Xu, Cud, Uu^Br|, Xu, Qxu, Qxu
Xu, Xu, Xu, Xu, Uu^Tf, Uu, Uh^Dr, Re, Xu, Xu, Uu^Vud, Tb^Tf, Uu^Dr, Wwg, Uh, Qxu, Qxu, Xu, Xuc, Tb^Tf, Uue, Uu^Vu, Xuc, Xu, Uh^Ii, Rb^Emf, Re^Emf, Xu, Uu, Cud^Ebn, Uue, Cud^Ebn, Uu^Vud, Cud, Xu, Xu, Uh, Uu, Uu^Br|, Uu, Qxu, Qxu
Xu, Xu, Xu, Xu, Uu, Uu, Uu, Uu, Xu, Xu, Chr, Uu, Wwf^Em, Wwg, Chr, Uh, Xuc, Xuc, Rd^Es, Re^Es, Uue, Uue, Xu, Xu, Xu, Re^Emf, Re^Vud, Wwg, Wwf^Ii, Uue, Rb^Emf, Re^Em, Uue^Ii, Xu, Uh^Tf, Xu, Xu, Uu, Uu^Br|, Uu, Uu, Qxu
Xu, Xu, Xu, Xu, Xu, Uu, Uue^Ii, Uue, Uue, Chr, 3 Khr, Chr, Re, Tb^Tf, Tb^Tf, Xuc, Xuc, Rd^Es, Uue, Uue, Xuc, Xuc, Xuc, Xu, Uu^Vud, Wwg, Wwf, Wwf^Ii, Gs^Fet, Rb^Em, Rb^Emf, Re^Emf, Rb^Ii, Rb^Ii, Rb^Vud, Uh^Tf, Xu, Urb, Uu^Br|, Re, Uu^Vu, Qxu
Xu, Xu, Xu, Xu, Xu, Uh^Ii, Re^Ii, Rd^Ii, Uue, Chr, Chr, Chr, Tb^Tf, Rd, Uue, Xu, Xu, Re, Uue, Uh, Tb^Tf, Cud, Xuc, Xu, Cud, Uh, Re^Emf, Wwf^Ii, Rb^Emf, Rb^Emf, Re^Emf, Rb^Emf, Xu, Xu, Xu, Cud, Xu, Urb, Uu^Br|, Rd, Xu, Xu
Xu, Xu, Xu, Xu, Uh^Vu, Uh, Uh, Uh, Uue, Wwf, Wwf, Tb^Tf, Re^Ii, Uue^Es, Uue, Uu^Vu, Xu, Xu, Rd, Tb^Tf, Tb^Tf, Xuc, Xu, Xu, Cud, Uh, Urb^Ii, Rb^Emf, Re^Em, Re^Emf, Re, Re^Emf, Xu, Xu, Xu, Xu, Re, Re, Uu^Br|, Re, Xu, Xu
Xu, Xu, Xu, Xu, Xu, Uh^Dr, Uh^Tf, Uu, Wog, Wwg, Wwf, Uue^Ii, Re^Ii, Rd^Es, Re^Tf, Xu, Xu, Uu, Uu, Uu, Uu, Uu, Xu, Xu, Xu, Xu, Uh^Ii, Uu^Ii, Uu, Uu, Uu, Xu, Uh, Uh, Uu, Urb, Re^Br/, Re^Br/, Uh, Uu, Xu, Xu
Xu, Xu, Xu, Xu, Xu, Chr, Uh^Tf, Tb^Tf, Uh^Vu, Wwg, Chr, Wwg, Wwg, Tb^Tf, Xu, Xu, Xu, Xu, 7 Kud, Cud, Uu, Uh, Cud, Xu, Xu, Xu, Qxu, Uh, Uu^Vud, Uu, Uu, Cud, Uu, Urb, Urb^Br/, Urb^Br/, Urb, Urb, Uu, Uu^Vud, Xu, Xu
Xu, Xu, Xu, Xu, Xu, Xu, Xu, Xu, Xu, Xu, Xu, Xu, Wwg, Uu^Vud, Qxu, Xu, Qxu, Xu, Xu, Cud, Cud, Cud, Cud, Xu, Xu, Qxu, Qxu, Qxu, Qxu, Qxu, Xu, Cud, Xu, Uu^Vud, Qxu, Qxu, Qxu, Qxu, Xu, Xu, Xu, Xu
Xu, Xu, Xu, Xu, Xu, Xu, Xu, Xu, Xu, Xu, Xu, Xu, Wwg, Xu, Xu, Qxu, Xu, Xu, Xu, Xu, Xu, Xu, Xu, Xu, Xu, Xu, Xuc, Xuc, Xuc, Xuc, Xuc, Xu, Xu, Xu, Qxu, Qxu, Xu, Qxu, Xu, Xu, Xu, Xu
Xu, Xu, Xu, Xu, Xu, Xu, Xu, Xu, Xu, Xu, Xu, Wwg, Wwg, Xu, Xu, Xu, Xu, Xu, Xu, Xu, Xu, Xu, Xu, Xu, Xu, Xu, Xu, Xuc, Xuc, Xuc, Xu, Xu, Xu, Xu, Xu, Xu, Xu, Xu, Xu, Xu, Xu, Xu
