Mm, Mm, Mm, Mm, Mm, Mm, Mm, Mm, Mm, Mm, Hh, Hh, Hh, Mm, Mm, Mm, Gs^Fp, Gg, Mm, Mm^Xm, Mm^Xm, Mm^Xm
Mm, Mm, Mm, Mm, Mm, Mm, Mm, Mm, Mm, Mm, Hh^Vhhr, Hh, Hh, Mm, Mm, Mm, Gs^Fp, Gg^Ve, Mm, Mm^Xm, Mm^Xm, Mm^Xm
Mm, Mm, Ce, Ce, Ce^Es, Mm, Gg^Fet, Hh, Mm, Mm, Mm, Gs^Fp, Gs^Fp, Hh, Hh, Hh^Fp, Hh^Fp, Mm, Mm, Mm, Mm^Xm, Mm^Xm
Mm, Mm, Ce, 2 Ke, Ce^Es, Gs^Fp, Gll^Fp, Hh, Gs^Fp, Mm, Gg, Gs^Fp, Gg, Gg, Gg, Hh, Chr, Chr, Mm, Mm, Mm, Mm^Xm
Mm, Mm, Mm, Ce, Gs, Gs, Gg, Gll^Fp, Gs, Gg^Fp, Gs, Gs, Gs, Gs, Gg, Gg, Rp, Rp, Rp, Chr, Mm, Mm
Chr, Chr, Gs, Gs, Gs, Gg, Gg, Gg, Gg, Gg, Rp, Gg, Rp, Rp, Rp, Rp, Gg, Rp, Gg, Chr, Hh, Hh
Hh, Hh^Vhh, Gg, Gg, Gg, Gg, Gg, Gg, Rp, Rp, Gg, Rp, Gg, Gg, Gg^Efm, Gg^Efm, Rp, Rp, Gs^Fp, Hh, Gg^Fet, Gs^Fp
Gs^Fp, Gs^Fp, Gs^Fp, Gs, Gs^Fp, Gg, Gg, Rp, Gg, Gg, Chr, Gg, Gg, Gg, Gg, Rp, Gg^Efm, Gg^Efm, Gll^Fp, Gll^Fp, Hh, Hh
Hh, Hh, Hh, Hh^Fp, Hh^Fp, Gg, Rp, Rp, Gg, Chr, Gs^Fp, Gll^Fp, Gll^Fp, Gg, Rp, Rp, Gg, Gs^Fp, Hh, Hh, Hh^Vhhr, Hh
Mm, Mm, Mm, Mm, Mm, Gs^Fp, Rp, Gg, Gg^Efm, Gs^Vc, Gg, Gs^Fp, Gll^Fp, Gll^Fp, Rp, Gg, Gg, Hh, Mm, Mm, Mm, Mm
Mm, Mm, Mm, Mm, Mm, Mm, Rp, Gs, Gg^Efm, Gg^Efm, Hh^Fp, Gll^Fp, Gll^Fp, Gll^Fp, Rp, Gg, Gg, Hh, Mm, Mm, Mm, Mm
Mm, Mm, Mm, Mm, Hh, Hh, Rp, Gg^Efm, Hh, Hh, Mm, Hh^Fp, Hh^Fp, Gll^Fp, Rp, Gg, Mm, Mm, Mm, Mm, Mm, Mm
Mm, Mm, Mm, Hh, Hh, Gg^Fet, Rp, Hh, Mm, Mm, Mm, Mm, Mm, Hh, Gg, Rp, Hh, Mm, Gll^Fp, Gs^Fp, Hh^Vc, Hh
Mm, Mm, Hh, Hh^Vhhr, Gg, Rp, Gg^Efm, Hh, Mm, Mm, Mm, Mm, Mm, Mm, Gg, Rp, Gg, Hh, Gs^Fp, Hh, Hh^Es, Hh
Mm, Hh, Hh, Hh, Gg, Rp, Hh, Mm, Mm, Mm, Mm, Mm, Mm, Hh^Fp, Gg, Rp, Gg, Gg, Gs^Fp, Hh^Es, Hh, Hh
Hh, Hh, Gll^Fp, Gg, Rp, Rp, Gg^Efm, Hh, Chr, Mm, Mm, Mm, Hh^Vhh, Hh^Fp, Gg, Rp, Gg, Gg, Gg^Efm, Hh, Chr, Chr
Hh, Hh, Gll^Fp, Gs^Fp, Rp, Gg, Gg^Efm, Gg^Efm, Chr, Chr, Mm, Mm, Hh^Fp, Gg, Rp, Rp, Gs^Fp, Gg, Gg, Gg^Efm, Gg^Efm, Gg^Efm
Hh^Fp, Hh^Fp, Gll^Fp, Gs^Fp, Rp, Gg, Gg, Gg, Hh, Hh, Mm, Gg^Fet, Gg, Rp, Gg, Gg, Gs^Fp, Gs^Fp, Gs^Vh, Gg^Efm, Gg^Efm, Gg^Efm
Hh, Hh, Mm, Hh, Chr, Rp, Rp, Gg, Gg, Hh, Gg, Gg, Rp, Rp, Gg, Gg, Gg, Gs^Fp, Hh, Hh, Hh, Hh
Mm, Mm, Mm, Hh, Hh, Gg, Rp, Gg^Es, Rp, Rp, Rp, Rp, Gg, Gg^Efm, Gg^Efm, Gg, Mm, Mm, Mm, Hh, Hh, Hh
Mm, Mm, Mm, Hh, Gs^Vct, Rp, Gg, Re^Es, Gs, Gg, Chr, Gg, Gg^Efm, Gg^Efm, Gg^Efm, Gs^Fp, Gs^Fp, Mm, Mm, Hh, Mm, Mm
Chr, Chr, Mm, Hh^Fp, Gs, Rp, Gg^Ecf, Gs, Gg, Hh, Mm, Hh, Gs^Fp, Gg, Gg^Efm, Gg^Efm, Gs^Fp, Mm, Mm, Mm, Mm, Mm
Chr, Chr, Chr, Hh^Fp, Ce, Ce, Ce, Gs, Gs^Vct, Hh, Mm, Hh, Hh, Gs^Fp, Gll^Fp, Gll^Fp, Gll^Fp, Hh, Mm, Mm, Mm, Mm
Xu, Xu, Xu, Re, Ce, 1 Ke, Ce, Gg, Hh, Mm, Mm, Mm, Mm, Hh, Gs^Fp, Gs^Fp, Gs^Fp, Hh, Hh^Vhh, Mm, Mm^Xm, Mm^Xm
Uh, Uh^Ii, Re^Ii, Re^Ii, Re^Es, Ce, Mm, Hh, Mm, Mm, Mm, Mm, Mm^Xm, Mm^Xm, Mm, Gg^Fet, Gg^Fet, Hh, Mm, Mm, Mm^Xm, Mm^Xm
Re, Re^Ii, Uu^Ii, Uu, Xu, Mm, Chr, Mm, Chr, Hh^Vhh, Mm, Mm, Mm, Mm, Mm^Xm, Mm, Mm, Mm, Mm^Xm, Mm^Xm, Mm^Xm, Mm^Xm
Re, Uu, Uh, Xu, Xu, Xu, Chr, Chr, Chr, Hh, Mm, Mm, Mm, Mm, Mm^Xm, Mm, Mm, Mm, Mm^Xm, Mm^Xm, Mm^Xm, Mm^Xm
