Xu, Xu, Xu, Xu, Xu, Xu, Xu, Xu, Xu, Xu, Xu, Xu, Xu, Xu, Xu, Xu, Xu, Xu, Xu, Xu, Xu, Xu, Xu, Xu, Xu, Xu, Xu, Xu, Xu, Xu, Xu, Xu, Xu, Xu, Xu, Xu, Xu, Xu, Xu, Xu, Wog, Xuc
Xu, Xu, Xu, Xu, Xu, Xu, Xu, Xu, Xu, Xu, Xu, Xu, Xu, Xu, Xu, Xu, Xu, Xu, Xu, Xu, Xu, Xu, Xu, Xu, Xu, Xu, Xu, Xu, Xu, Xu, Xu, Xu, Xu, Xu, Xu, Xu, Xu, Xu, Wog, Wog, Uu, Uu
Xu, Xu, Xu, Xu, Xu, Xu, Xu, Xu, Uu^Vu, Xu, Xu, Xu, Rr, Uu^Vu, Xu, Xu, Xu, Xu, Xu, Xu, Xu, Xu, Xu, Xu, Xu, Xu, Xu, Xu, Xu, Xu, Xu, Xu, Wog, Xu, Xu, Xu, Wog, Wog, Uu, Cud, Cud, Rr
Xu, Xu, Xu, Xu, Xu, Xu, Rr, Xu, Tb^Tf, Rr, Uh, Uh, Rr, Uu, Uh, Xu, Xu, Xu, Qxu, Xu, Xu, Xu, Xu, Xu, Xu, Xu, Xu, Xu, Wog, Wog, Wog, Wog, Xu, Wog, Wog, Wog, Uu, Uu, Rr, Rr, Uu, Cud
Xu, Xu, Xu, Xu, Xu, Uu^Vud, Xu, Rr, Rr, Rr^Es, Rr, Rr, Uh, Uu, Uh, Xu, Xu, Qxu, Qxu, Qxu, Qxu, Qxu, Qxu, Xu, Xu, Xu, Xu, Wog, Xu, Xu, Xu, Xu, Xu, Xuc, Cud, Uu, Rr, Rr, Uu, Uu, Wog, Wog
Xu, Xu, Xu, Xu, Xu, Xu, Rr, Tb^Tf, Tb^Tf, Uu^Es, Rr, Uh, Xu, Uh, Xu, Xu, Xu, Qxu, Qxu, Qxu, Qxu, Qxu, Qxu, Qxu, Xu, Xu, Wog, Wog, Xu, Xu, Xu, Xu, Uu, Xu, Uu, Rr, Uu, Uu, Wog, Wog, Xuc, Xuc
Xu, Xu, Xu, Xu, Uh, Rr, Xu, Rr, Rr, Rr, Uu, Uh^Vu, Xu, Xu, Xu, Xu, Tb^Tf, Uh^Tf, Uh, Uh, Uh, Qxu, Uh, Uh, Uh, Xu, Wog, Xu, Uu^Dr, Uu^Dr, Uu, Uu, Uu, Uu, Rr, Rr, Uu, Cud, Xuc, Xuc, Xu, Xu
Xu, Xu, Xu, Xu, Uh^Vu, Rr, Xu, Xu, Uh, Rr^Es, Uu, Xu, Cud, Xu, Uu, Uh, Uu, Tb^Tf, Cud, Uh, Uu, Uu, Uu, Uh, Cud, Uu, Wog, Wwg, Uu, Uu, Qxu, Cud^Ebn, Qxu, Rr, Rr, Rr, Uh, Xu, Xu, Xu, Xu, Xu
Xu, Xu, Xu, Xu, Xu, Xu, Xu, Uh, Xu, Rr^Es, Rr, Uu, Uu, Xu, Rr, Rr, Rr^Es, Rr, Rr, Rr, Rr, Rr, Rr, Rr, Rr, Wwf, Wwf^Em, Rr, Rr, Cud^Eb, Cud, Cud, Cud, Cud^Eb, Uu, Uu, Uh^Tf, Xu, Xu, Xu, Xu, Xu
Xu, Xu, Xu, Xu, Xu, Xu, Xu, Xu, Xu, Cud, Rr, Uu, Rr, Rr, Cud, Rr^Es, Wog, Rr, Cud, Rr, Wwf, Rr, Wog, Rr, Cud, Wwf^Es, Wwf, Rr^Dr, Rr, Qxu, Cud, 2 Kud, Cud, Qxu, Uh, Uu, Uh, Xu, Xu, Xu, Xu, Xu
Xu, Xu, Xu, Xu, Xu, Xu, Xu, Xu, Xu, Xu, Rr, Rr, 6 Kud, Cud, Cud, Wog, Wog, Wog, Wog, Wog, Wwf, Wwf, Wog, Wog, Wog, Wog, Wog, Uu^Dr, Rr, Cud^Eb, Qxu, Cud, Qxu, Cud^Ebn, Uu, Uh, Xu, Xu, Xu, Xu, Xu, Xu
Xu, Xu, Xu, Xu, Xu, Xu, Xu, Xu, Uu, Uu, Rr, Rr, Cud, Cud, Wwg, Wwg, Wog, Wog, Uh, Uh^Tf, Uh^Tf, Uh^Tf, Uh^Tf, Uh, Uh, Wog, Wog, Uu^Es, Uu, Rr, Rr, Cud^Ebn, Uh, Uu, Uh, Xu, Xu, Xu, Xu, Xu, Xu, Xu
Xu, Xu, Xu, Xu, Xu, Xu, Cud, Cud, Rr, Rr, Uh^Dr, Uu, Uu, Cud, Cud, Cud, Uh, Uh, Xu, Xu, Xu, Uh^Tf, Xu, Xu, Xu, Xu, Uh, Wog, Uu, Uu, Rr, Rr^Br|, Uh^Vu, Uh, Xu, Xu, Xu, Xu, Xu, Xu, Xu, Xu
Xu, Xu, Xu, Xu, Xu, Xu, Cud, Rr, Rr, Rb^Es, Uh^Dr, Uh, Uu, Uu^Br|, Uu, Uu, Qxu, Qxu, Xu, Xu, Xu, Xu, Xu, Xu, Xu, Uh^Tfi, Wwf^Em, Wwf, Wog, Uu, Rr^Es, Rr^Br|, Uu, Uh, Xu, Xu, Xu, Xu, Xu, Xu, Xu, Xu
Xu, Xu, Xu, Xu, Xu, Xu, Uu, Rr, Rr, Uu^Es, Uh, Uu^Vu, Rb, Uu^Br|, Uu, Qxu, Qxu, Xu, Xu, Xu, Xu, Xu, Xu, Xu, Qxu, Uh^Tfi, Wwf^Em, Wog, Wog, Cud, Rr^Es, Rr^Br|, Uu, Cud, Xu, Xu, Xu, Xu, Xu, Xu, Xu, Xu
Xu, Xu, Xu, Xu, Xu, Xu, Uu, Re, Rr, Rr, Rr, Uh, Uu^Br/, Uu^Br|, Qxu, Qxu, Qxu, Xu, Xu, Xu, Xu, Xu, Xu, Xu, Qxu, Wwf, Wwf^Es, Wog, Wog, Cud, Rr, Rr^Br|, Uu, Cud, Xu, Xu, Xu, Xu, Xu, Xu, Xu, Xu
Xu, Xu, Xu, Xu, Xu, Xu, Uu, Rr, Uu, Uu, Uu^Br/, Rr^Br/, Rr, Uu, Qxu, Qxu, Qxu, Qxu, Xu, Xu, Xu, Xu, Xu, Xu, Qxu, Qxu, Qxu, Wog, Wog^Bw\, Wog, Rr, Rr^Br|, Uh, Uh^Dr, Xu, Xu, Xu, Xu, Xu, Xu, Xu, Xu
Xu, Xu, Xu, Xu, Xu, Xu, Rr, Rr, Cud, Uu^Br/, Xu, Uu, Uu, Rr, Rr, Qxu, Xuc, Xu, Xuc, Xuc, Xuc, Xuc, Xuc, Xu, Xu, Qxu, Wog, Wog, Rr, Rr^Br\, Cud, Cud, Cud, Uh, Uh, Xu, Xu, Xu, Xu, Xu, Xu, Xu
Xu, Xu, Xu, Xu, Xu, Cud, Rr, Rr, Uu^Br|, Xu, Xu, Xu, Xu, Uu, Uu, Rr, Cud, Xuc, Uh^Dr, Uh^Dr, Uh^Tf, Uh^Tf, Uu^Tf, Xuc, Xuc, Uh^Tf, Wog, Cud, Wwf, Rr, Cud, 5 Kud, Cud, Rr, Rr, Uu, Uu, Xu, Xu, Xu, Xu, Xu
Xu, Xu, Xu, Xu, Uu, Uh, Rr, Rr, Uu^Br|, Uh^Dr, Xu, Xu, Xu, Xuc, Cud, Rr, Re, Rb, Uu^Vud, Uh, Rb, Uh^Tf, Uu^Vud, Xuc, Cud, Uh^Tf, Rr, Wog, Re^Vud, Uu, Uu^Es, Cud, Uu, Rr^Br\, Rr^Br|, Rr^Es, Uu, Xu, Xu, Xu, Xu, Xu
Xu, Xu, Xu, Xu, Uh, Rr, Rr, Uu, Uu^Br|, Uh^Dr, Xu, Xu, Xu, Xuc, Uu, Rd^Es, Uue, Rb, Rr, Rr, Rr, Re, Uu^Dr, Uu, Rr, Rr, Uu, Wog^Bw/, Re, Rb^Es, Uu, Uu, Rr, Rr, Rr^Br/, Rr, Rr, Cud, Xu, Xu, Xu, Xu
Xu, Xu, Xu, Uh, Uu^Vud, Rr, Rr, Uu, Uu^Br|, Uu^Br\, Uh^Br\, Xu, Xuc, Xuc, Uu, Uue, Uue^Dr, Uue^Dr, Qxe, Qxe, Qxe, Rr^Es, Rr, Rr, Xu, Cud, Wwf, Wwf, Cud, Rb, Rr, Rr, Rr^Br/, Rr^Br/, Uu^Vud, Rr^Br\, Rr^Br\, Rr, Xu, Xu, Xu, Xu
Xu, Xu, Uh, Uh, Uu, Rr, Cud, Re^Br/, Rr, Uu, Rr, Cud, Rr^Br\, Uu, Re^Es, Uue^Vu, Re, Uue^Dr, Qxe, Qxe, Qxe, Rr^Es, Rr, Xuc, Xu, Xu, Tb^Tf, Tb^Tf, Rr, Rr, Rr^Br/, Rr^Br/, Uu, Uu, Xu, Rr, Rr, Rr^Br\, Rr^Br\, Xu, Xu, Xu
Xu, Xu, Uu, Uu, Uu, Cud, 3 Kud, Cud, Rr, Rr, Rr, Rr, Rr, Rr^Br\, Rr^Br\, Re, Rr^Br/, Re^Br/, Uue, Qxe, Uue^Br\, Rr^Vu, Rr, Xuc, Xu, Xu, Rr, Rr, Rr^Br/, Rr^Br/, Rr^Br\, Uu, Xu, Xu, Xu, Qxu, Qxu, Rr, Cud, Cud, Xu, Xu
Xu, Xu, Uu^Vud, Uu^Dr, Uu^Dr, Cud, Cud, Cud, Uu, Uu^Vu, Uu, Cud, Xu, Uh, Uu, Rr^Br|, Uh^Dr, Rr, Rr, Uue, Uu, Re^Br\, Re^Br\, Xuc, Cud, Rr, Rr, Rr, Uu^Br|, Uu, Uu^Vud, Rr^Br\, Rr^Br\, Xu, Xu, Xu, Xu, Qxu, Xu, Xu, Xu, Xu
Xu, Xu, Xu, Uu, Uu, Rr, Rr, Rr, Uu, Uu, Xu, Xu, Xu, Xu, Rr, Uu^Br|, Chr, Uu, Uh^Dr, Xuc, Xuc, Re, Rd, Uu^Br\, Rr, Rr, Uu^Br|, Uu^Br/, Xu, Xu, Qxu, Rr, Rr, Rr^Br\, Cud, Xu, Xu, Xu, Xu, Xu, Xu, Xu
Xu, Xu, Xu, Xu, Cud, Uu^Vu, Rd, Uu^Vu, Cud, Xu, Xu, Xu, Xu, Uh, Uu, Chr, Uh, Uh^Dr, Uh, Xu, Xu, Cud, Uu, Re^Br|, Rr^Br\, Uu^Br/, Uh, Uh, Xu, Xu, Xu, Qxu, Qxu, Cud, Xu, Xu, Xu, Xu, Xu, Xu, Xu, Xu
Xu, Xu, Xu, Xu, Xu, Uh, Rd, Uu, Xu, Xu, Xu, Xu, Xu, Xu, Xu, Rr, Xu, Uh, Xu, Xu, Xu, Uh, Uh, Re, Rr^Br|, Uu, Uu^Dr, Uh^Dr, Xu, Xu, Xu, Xu, Xu, Xu, Xu, Xu, Xu, Xu, Xu, Xu, Xu, Xu
Xu, Xu, Xu, Xu, Xu, Uu, Rd, Uu, Uh, Xu, Xu, Xu, Xu, Xu, Xu, Xu, Xu, Xu, Xu, Xu, Xu, Xu, Tb^Tf, Rr, Rr, Rr^Br\, Uu^Br\, Uu^Dr, Chr, Xu, Uu, Xu, Xu, Xu, Xu, Xu, Xu, Xu, Xu, Xu, Xu, Xu
Xu, Xu, Xu, Xu, Uh, Uu, Re, Chr, Uh, Uh^Tf, Xu, Xu, Xu, Xu, Xu, Xu, Xu, Xu, Xu, Xu, Xu, Xu, Tb^Tf, Tb^Tf, Chr, Rr, Rr, Rr^Br|, Uu, Uu, Uu, Uu^Vu, Xu, Xu, Xu, Xu, Xu, Xu, Xu, Xu, Xu, Xu
Xu, Xu, Xu, Uh^Vu, Uh, Re, Uu, Uu, Uh, Uh^Tf, Xu, Xu, Xu, Xu, Xu, Xu, Xu, Xu, Xu, Xu, Xu, Xu, Xu, Tb^Tf, Uh, Rd, Re, Rr^Br|, Rr, Rr, Uu^Br/, Uu^Br/, Uu, Xu, Xu, Xu, Xu, Xu, Xu, Xu, Xu, Xu
Xu, Xu, Xu, Xu, Qxu, Re^Es, Qxu, Uu, Qxu, Uu^Vu, Xu, Xu, Xu, Xu, Xu, Xu, Xu, Xu, Xu, Xu, Xu, Xu, Xu, Xu, Uh, Rd, Cud, Cud, Cud, Rr^Br/, Uu, Uu, Xu, Xu, Xu, Xu, Xu, Xu, Xu, Xu, Xu, Xu
Xu, Xu, Xu, Xu, Qxu, Qxu^Bcx|, Qxu, Qxu^Bcx|, Qxu, Xu, Xu, Xu, Xu, Xu, Xu, Xu, Xu, Xu, Xu, Xu, Xu, Xu, Xu, Xu, Uu, Uu, Cud, 4 Kud, Cud, Rr, Rr, Uu, Uu, Cud, Cud, Xu, Xu, Xu, Xu, Xu, Xu, Xu
Xu, Xu, Xu, Uh^Dr, Uu, Re, Re^Em, Re^Es, Uu, Xuc, Xu, Xu, Xu, Xu, Xu, Xu, Xu, Xu, Cud, Cud, Xu, Xu, Xu, Uh, Rr, Rr, Rr^Br|, Cud, Uu, Rr, Rr, Rr, Rr, Uu, Uu, Xu, Xu, Xu, Xu, Xu, Xu, Xu
Xu, Xu, Uh^Tf, Uh, Chr, Chr, Rb^Es, Rb, Uh, Xuc, Xu, Xu, Xuc, Xu, Xu, Xu, Cud, Cud, Uu, Tb^Tf, Tb^Tf, Xu, Rr^Br/, Rr, Rr^Br/, Rr^Br/, Rd, Re, Uu, Uu, Cud, Rr, Rr, Uu, Uu, Uu^Vud, Xu, Xu, Xu, Xu, Xu, Xu
Xu, Xu, Uh^Tf, Uh, Uh^Ii, Uu^Ii, Re^Ii, Uu, Xuc, Xuc, Xuc, Xuc, Uh^Tf, Xuc, Xuc, Xuc, Uu^Vud, Uu, Rd, Rd, Rd^Br/, Rd^Br/, Uh, Rr^Br\, Uh, Rd, Xu, Xu, Xu, Cud, Rr, Xu, Xu, Rr, Cud, Cud, Uu, Xu, Xu, Xu, Xu, Xu
Xu, Xu, Xu, Uh^Vu, Ce, Uu^Ii, Re, Uu^Ii, Uu^Vud, Uh^Tf, Tb^Tf, Uh^Dr, Uh, Uh, Uh^Ii, Uu^Ii, Uu, Uu, Re^Br/, Re^Br/, Uu, Uu^Vu, Chr, Chr, Uh^Vu, Uh, Xu, Xu, Xu, Uu, Rr, Xu, Xu, Cud, Uu, Rr, Rr, Uu, Uu, Xu, Xu, Xu
Mm^Xm, Xu, Xu, Xu, Ce^Ii, Ce^Ii, Uu, Re, Re^Ii, Uu, Re, Uu, Re, Uu, Uu, Uu^Ii, Re^Br/, Re^Br/, Xu, Uu, Tb^Tf, Uh, Uh^Vu, Chr, Xu, Xu, Xu, Uh, Uu^Vud, Rr, Rr, Xu, Uu, Xu, Xu, Uu, Uu, Rr, Rr, Uu, Cud, Xu
Mm, Mm^Xm, Xu, Ce^Es, 1 Ke, Ce^Ii, Ce^Ii, Uu^Ii, Uu^Ii, Re, Uu, Re, Chr, Re, Uu^Br/, Uu^Br/, Uh, Xu, Xu, Tb^Tf, Tb^Tf, Chr, Xu, Xu, Xu, Xu, Uh, Uh, Rr, Rr, Uu^Vu, Rr, Rr, Uu^Vud, Xu, Xu, Xu, Uu, Cud, Cud, Rr, Uu
Hh, Chr, Gg^Vct, Ce, Ce, Ce, Xu, Xu, Uh^Vu, Uh, Tb^Tf, Uh, Uh, Chr, Uh, Uh, Xu, Xu, Xu, Xu, Xu, Xu, Xu, Xu, Xu, Rr, Rr, Rr, Rr, Uu, Xu, Uu, Uh, Uh, Xu, Xu, Xu, Xu, Xu, Uu, Uu, Rr
Rp, Gs^Es, Rp, Rp, Mm, Xu, Xu, Xu, Xu, Tb^Tf, Xu, Xu, Xu, Xu, Xu, Xu, Xu, Xu, Xu, Xu, Xu, Xu, Xu, Xu, Xu, Uu^Vud, Uu, Uu^Tf, Uh^Tf, Rr, Xu, Xu, Xu, Xu, Xu, Xu, Xu, Xu, Xu, Xu, Xu, Uu
Rp, Rp, Gg, Chr, Mm, Mm^Xm, Mm^Xm, Xu, Xu, Xu, Xu, Xu, Xu, Xu, Xu, Xu, Xu, Xu, Xu, Xu, Xu, Xu, Xu, Xu, Xu, Xu, Xu, Xu, Xu, Xu, Xu, Xu, Xu, Xu, Xu, Xu, Xu, Xu, Xu, Xu, Xu, Xu
