Xu, Xu, Xu, Xu, Xu, Xu, Xu, Xu, Xu, Xu, Xu, Xu, Xos, Xu, Xos, Xu, Xos, Xu, Xu, Xu, Xu, Xu, Xu, Xu, Xu, Xu, Xos, Qxu, Xos, Xu, Xu, Xu, Wog, Wog, Xu, Xu, Xu, Urb, Xu, Xu, Xu, Xu
Xu, Xu, Xu, Xu, Xu, Xu, Xu, Xu, Xu, Xu, Xu, Xu, Re, Xu, Rd, Xu, Re, Xu, Xu, Xu, Uh^Uf, Xu, Xu, Xu, Xu, Xu, Xos, Qxu, Xos, Xu, Xu, Xu, Wog^Xo, Wog^Xo, Wog^Xo, Xu, Xos, Xu, Xu, Xu, Xu, Xu
Xu, Xu, Xu, Xu, Uu, Kh, Cud, Xu, Uu, Xu, Re^Edb, Rd^Edb, Re^Edb, Rd^Edb, Re, Re^Es, Re^Edb, Rd^Edb, Re^Edb, Xu, Uu^Es, Uu^Uf, Uh, Xu, Xos, Xos, Urb, Urb, Cud, Xos, Xos, Xu, Xuc, Wog, Wog, Wog^Xo, Wog^Xo, Xos, Xos, Xu, Xu, Xu
Xu, Xu, Xu, Xu, Xu, Cud, Uu, Xu, Uu, Xu, Re, Chr^Eb, Re^Edb, Re, Ch, Re^Edb, Rd, Chr^Eb, Re, Xu, Uu, Uu^Es, Uu, Xu, Cud, Cud, Urb, Urb, Urb, Cud, Xuc, Xuc, Cud, Wwg, Wwg, Wog, Wog, Wog^Xo, Wog^Xo, Xos, Xu, Xu
Xu, Xu, Xu, Xu, Xu, Cud, Uu, Uu, Uu, Xu, Rd, Re^Es, Re^Es, Chr^Edb, Kh, Chr, Re, Rd^Edb, Re, Xu, Xu, Xu, Xuc, Xu, Urb, Urb, Urb, Urb, Urb, Urb, Urb, Cud, Cud, Cud, Cud, Wwg, Wwg, Wog, Wog^Xo, Xos, Xos, Xu
Xu, Xu, Xu, Xu, Xu, Cud, Xu, Xu, Xu, Xu, Re, Rd^Edb, Re^Edb, Chr, Ch, Chr, Re^Edb, Re, Rd, Xu, Xu, Xu, Xuc, Urb, Urb, Urb, Urb, Urb, Urb, Urb, Urb, Cud^Ebn, Cud, 2 Kud, Cud, Cud, Cud, Xuc, Wog, Xos, Xos, Xu
Xu, Xu, Xu, Xu, Xu, Xu, Xu, Xu, Xu, Xu, Re, Chr^Eb, Re, Re, Re, Rd^Edb, Re, Chr^Eb, Re, Xu, Xu, Xu, Xuc, Cud^Eb, Urb, Urb, Urb, Urb, Urb, Urb, Rr, Rr, Urb, Cud^Ebn, Urb, Cud, Xuc, Xuc, Wwg, Wog, Xos, Xu
Xu, Xu, Xu, Xu, Qxu, Xu, Xu, Cud, Rd, Uu, Uu, Re^Edb, Xu, Rd, Re^Es, Re^Es, Xu, Re, Xu, Xu, Xu, Xu, Xu, Xu, Urb, Urb, Urb, Urb, Rr, Rr, Urb, Urb, Urb, Urb, Urb, Urb, Xu, Xu, Wwg, Wog, Xos, Xos
Xu, Xu, Qxu, Qxu, Uh^Vu, Uh, Re, Rd, Uu, Urb, Cud, Xu, Xu, Xu, Xu, Xu, Xu, Xu, Xu, Xu, Xu, Xu, Xos, Xos, Urb, Urb, Rr, Rr, Urb, Urb, Urb, Urb, Urb, Urb, Xu, Cud, Xu, Xu, Wwg^Xo, Wwg, Xos, Xos
Xu, Xu, Qxu, Qxu, Re^Es, Uh, Uu, Uu, Re, Uh^Uf, Xu, Xu, Xu, Xu, Xos, Xos, Xu, Xu, Xu, Xu, Xol, Xol, Urb, Urb^Xo, Rr^Xo, Rr, Urb, Urb, Urb, Urb, Cud, Urb, Urb, Xu, Re^Ii, Xu, Xu, Xu, Wwg, Xos, Xos, Xos
Xu, Xu, Uh^Uf, Rd, 7 Kud, Cud, Uu, Uu^Vu, Uu, Uh, Xu, Xu, Xos, Xos, Urb, Urb^Xo, Xos, Xu, Xu, Xos, Cud, Urb, Rr, Rr, Urb, Urb^Xo, Xos, Xos, Xos, Xu, Xu, Xu, Xu, Xu, Re^Ii, Urb^Ii, Uu, Wwf, Chw, Xos, Xos, Xos
Xu, Xu, Uh^Uf, Uu^Uf, Cud, Cud, Uu, Re, Re, Urb, Urb, Xol, Xol, Urb, Xol, Xos, Urb^Xo, Xu, Xu, Xos, Urb, Rr, Urb, Urb, Xol, Xos, Xos, Xos, Xu, Xu, Xu, Xu, Xu, Urb, Uu, Re^Es, Wwf, Chw, Kh, Wog, Wog^Xo, Xos
Xu, Xu, Uu^Uf, Uh, Uu, Uu, Uu, Uu, Uu, Uu, Xos, Cud, Rr, Urb, Urb, Xol, Urb, Xos, Xos, Xos, Cud, Rr, Rr, Urb, Urb, Xol, Xu, Xu, Xu, Xu, Xu, Xu, Xu, Xu, Xu, Xu, Wwf^Vm, Chw, Wwf, Wog, Wog^Xo, Wog
Xu, Xu, Xu, Re, Uu, Uu, Uu^Vud, Xu, Uu, Xu, Xos, Xos, Urb, Rr, Rr, Urb, Urb, Xos, Xos, Xos, Xos, Urb, Urb, Rr, Rr, Urb, Cud, Xu, Xu, Xu, Xu, Xu, Xu, Xu, Xu, Xu, Wwf, Wwf^Em, Xu, Xu, Xu, Wog
Xu, Xu, Xu, Uh, Uh, Uu, Xu, Xu, Xu, Xu, Xu, Xos, Xos, Urb, Urb, Rr, Cud, Cud, Xu, Xu, Xu, Xol, Xos, Urb, Cud, Cud, Rr, Urb, Urb, Xu, Xu, Xu, Xu, Xu, Xu, Re, Re, Xu, Xu, Xu, Xu, Xu
Xu, Xu, Xu, Xu, Rd^Es, Re, Xu, Xu, Xu, Cud, Xu, Xu, Xu, Xos, Xos, Cud, Rr, Urb, Xu, Qxu, Xu, Xu, Xu, Xos, Xos, Urb, Urb, Rr, Rr, Xuc, Xu, Xu, Xu, Xu, Wwg, Wwg, Xu, Xu, Xu, Xu, Xu, Xu
Xu, Xu, Xu, Xu, Rd^Es, Xu, Xu, Cud, Rr, Rr, Rr, Xu, Xu, Xu, Xos, Urb, Rr, Urb, Urb, Cud, Xu, Xu, Qxu, Xu, Xu, Xos, Xos, Urb, Rr, Xuc, Xuc, Cud, Xu, Xu, Wwf, Re^Es, Xu, Xu, Xu, Xu, Xu, Xu
Xu, Xu, Xu, Xu, Rd^Es, Xu, Xu, Xu, Rr, Rr, Cud, Xu, Xu, Xu, Xos, Urb, Urb, Rr, Rr, Urb, Urb, Cud, Xu, Xu, Xu, Xu, Xos, Urb, Rr, Urb, Rr, Rr, Rr, Xu, Xu, Re^Es, Wwf, Xu, Xu, Xu, Xu, Xu
Xu, Xu, Uu, Re, Xu, Xu, Xu, Rr, Rr, Cud, 5 Kud, Cud, Urb, Xu, Xol, Xos, Xos, Urb, Urb, Rr, Rr, Urb, Cud, Xu, Xu, Xuc, Urb, Urb, Rr, Rr, Urb, Urb, Rr, Rr, Xu, Xu, Xu, Wwg, Xu, Xu, Xu, Xu
Xu, Xu, Uu, Xu, Xu, Cud, Rr, Rr, Rr, Cud, Cud, Cud, Rr, Urb, Urb, Xol, Xos, Xos, Xos, Urb, Rr, Urb, Xu, Qxu, Xu, Xuc, Urb, Rr, Urb, Urb, Xu, Xu, 6 Kh, Ch, Ch, Xu, Xu, Wwg, Wwf, Xu, Xu, Xu
Xu, Xu, Uu, Xu, Xu, Xu, Cud, Rr, Rr, Xu, Xu, Urb, Urb, Rr, Rr, Cud, Xos, Xu, Xos, Urb, Cud, Urb, Xu, Xu, Xu, Xuc, Urb, Rr, Urb, Xos, Xu, Xu, Xu, Ch, Xu, Xu, Wwf, Wwf, Xu, Wwf, Xu, Xu
Xu, Xu, Re, Xu, Xu, Xu, Xu, Rr, Rr, Cud, Xu, Xu, Xu, Urb, Rr, Urb, Xos, Xu, Xos, Cud, Rr, Cud, Xu, Xu, Xu, Xos, Cud, Cud, Cud, Xos, Xu, Xu, Wog, Xu, Wwg, Wwf, Xu, Xu, Xu, Wwf, Xu, Xu
Xu, Xu, Rd, Xu, Xu, Xu, Cud, Rr, Xu, Xu, Xos, Xu, Urb, Urb, Rr, Urb, Xos, Xu, Xu, Urb, Rr, Urb, Xu, Xu, Xu, Xos, Urb, Rr, Urb, Xos, Xu, Wog, Wog^Ii, Wog, Wwg, Wwf, Wwf, Xu, Xu, Wwf, Wog, Xu
Xu, Xu, Rd^Es, Xu, Xu, Xu, Xu, Cud, Xu, Xos, Xos, Cud, Rr, Rr, Urb, Cud, Xos, Xu, Xu, Urb, Rr, Urb, Xu, Xu, Xu, Xos, Urb, Rr, Urb, Xos, Xu, Wog, Wog, Wog, Wwg, Wwg, Wwf, Xu, Xu, Xu, Xu, Xu
Xu, Xu, Xu, Re^Es, Re, Xu, Xu, Xu, Xu, Xos, Xos, Urb, Rr, Urb, Xos, Xos, Xu, Xu, Xu, Urb, Rr, Urb, Xu, Xu, Xu, Xos, Urb, Rr, Urb, Xos, Xu, Xu, Wwg, Wwg, Wwg, Wwg, Wwf^Es, Xu, Xu, Xu, Xu, Xu
Xu, Xu, Xu, Xu, Uu, Xu, Xu, Xu, Xu, Xos, Xos, Urb, Rr, Urb, Xol, Xos, Xu, Xu, Xu, Urb, Cud, Urb, Xu, Xu, Xu, Xos, Urb, Rr, Urb, Xos, Xu, Wwf^Vm, Xu, Wwg, Xu, Wwf^Es, Wwf, Xu, Xu, Xu, Xu, Xu
Xu, Xu, Xu, Xu, Uu, Xu, Xu, Xu, Xu, Xos, Xos, Urb, Rr, Urb, Urb, Xol, Xu, Xu, Xu, Cud, Rr, Cud, Xu, Xu, Xol, Xol, Urb, Rr, Urb, Xos, Xu, Xu, Rr, Xu, Rr, Xu, Xu, Uu, Uu, Xu, Xu, Xu
Xu, Xu, Xu, Xu, Uu, Xu, Xu, Xu, Xu, Xos, Xos, Urb, Urb, Rr, Rr, Urb, Cud, Xu, Rr, Rr^Eb, Rr, Rr^Eb, Rr, Xu, Cud, Urb, Rr, Rr, Urb, Xos, Xu, Xu, Rr, Rr, Rr, Rr, Xu, Xu, Uu, Uu, Xu, Xu
Xu, Xu, Xu, Xu, Xos, Xos, Xos, Xu, Xu, Xu, Xu, Xos, Xos, Urb, Cud, Cud, Rr, Rr, Rr, Rr, Rr, Rr, Rr, Rr, Rr, Cud, Cud, Urb, Xos, Xos, Xu, Xu, Xu, Rr, Xu, Xu, Uh^Vu, Xu, Uu, Re, Uu^Es, Xu
Xu, Xu, Xu, Xu, Xos, Uu, Uu, Xu, Xu, Xu, Xu, Xu, Xu, Xu, Xu, Rr, Rr, Rr, Rr, Rr, Ce, Rr, Rr, Rr, Rr, Rr, Xu, Xos, Xu, Xu, Xu, Xu, Xu, Xu, 3 Kud, Cud, Uh, Uh, Uu, Re, Uu, Xu
Xu, Xu, Xu, Xu, Xol, Xol, Uu, Uh, Xos, Qxu, Qxu, Xu, Xu, Xu, Xu, Rr, Rr, Rr, Rr, Ce, Ke, Ce, Rr, Rr, Rr, Rr, Xu, Xu, Xu, Xu, Xu, Xu, Xu, Xu, Cud, Cud, Uu^Es, Uu, Uu, Xu, Xu, Xu
Xu, Xu, Xu, Xos, Uu, Uu, Uu, Uh, Xos, Qxu, Qxu, Xu, Xu, Xu, Xu, Rr, Rr, Rr, Rr, Ce, Ce, Ce, Rr, Rr, Rr, Rr, Xu, Xu, Xu, Xu, Xu, Xu, Xu, Cud, Uu, Uu, Re, Re, Xu, Xu, Xu, Xu
Xu, Xu, Xu, Cud, Urb, Urb, Xos, Xos, Uu, Uh, Xu, Xu, Xol, Xol, Cud, Rr, Rr, Rr, Rr, Rr, Rr, Rr, Rr, Rr, Rr, Rr, Cud, Xol, Xol, Xu, Xu, Xu, Xu, Uh, Uu, Rd^Es, Uu, Uh, Xu, Xu, Xu, Xu
Xu, Xu, Xu, Urb, Urb, Urb, Urb, Urb, Urb, Uu, Xol, Xos, Urb, Urb, Rr, Cud, Cud, Rr, Rr, Rr, Rr, Rr, Rr, Rr, Cud, Cud, Rr, Urb, Urb, Xos, Xu, Xu, Xu, Uh^Vu, Uu, Rd, Uh, Uu^Vud, Xu, Xu, Xu, Xu
Xu, Xu, Xos, Xu, Urb, Urb, Urb, Urb, Xuc, Xol, Urb, Urb, Rr, Rr, Urb, Urb, Xos, Xu, Xuc, Rr, Rr, Rr, Xuc, Xu, Xos, Urb, Urb, Rr, Urb, Xos, Xu, Xu, Xu, Xu, Uu, Xu, Xu, Xu, Xu, Xu, Xu, Xu
Xu, Xos, Urb, Urb, Cud, Urb, Urb, Urb, Xuc, Xuc, Urb, Rr, Urb, Urb, Xos, Xos, Xu, Xu, Xuc, Cud, Cud, Cud, Xuc, Xu, Xu, Xos, Urb, Rr, Xuc, Xu, Uh, Rd^Es, Re, Uu, Xu, Xu, Xu, Xu, Xu, Xu, Xu, Xu
Xu, Xos, Urb, Cud, 4 Kud, Cud, Rr, Urb, Urb, Cud, Rr, Rr, Urb, Xos, Xos, Xu, Xu, Xu, Xuc, Urb, Rr, Urb, Xuc, Xu, Xu, Xos, Xu, Rr, Rr, Xuc, Re, Re^Es, Uu, Xu, Xu, Xu, Xu, Xu, Xu, Xu, Xu, Xu
Xu, Xos, Urb, Cud, Cud, Cud, Urb, Rr, Rr, Rr, Urb, Urb, Urb, Cud, Xos, Xu, Xu, Xu, Xuc, Urb, Rr, Urb, Xuc, Xu, Xu, Xu, Xu, Xu, Rd, Rd, Xu, Uu, Uu^Vud, Uh, Xu, Xu, Xu, Xu, Xu, Xu, Xu, Xu
Xu, Xos, Xu, Urb, Urb, Urb, Urb, Urb, Urb, Urb, Urb, Urb, Cud, Cud, Xos, Xu, Xu, Xu, Xuc, Urb, Rr, Urb, Xuc, Xu, Xu, Xu, Xu, Xu, Xu, Xu, Xu, Xu, Xu, Xu, Xu, Xu, Xu, Xu, Xu, Xu, Xu, Xu
Xu, Xos, Xos, Xu, Cud, Urb, Xos, Xos, Xos, Urb, Cud, Cud, Xu, Xu, Xu, Xu, Xu, Xu, Xuc, Urb, 1 Rr, Urb, Xuc, Xu, Xu, Xu, Xu, Xu, Xu, Xu, Xu, Xu, Xu, Xu, Xu, Xu, Xu, Xu, Xu, Xu, Xu, Xu
Xu, Xos, Xos, Urb, Xu, Xu, Xu, Xu, Xu, Xos, Xos, Xu, Xu, Xu, Xu, Xu, Xu, Xu, Xuc, Urb, Rr, Urb, Xuc, Xu, Xu, Xu, Xu, Xu, Xu, Xu, Xu, Xu, Xu, Xu, Xu, Xu, Xu, Xu, Xu, Xu, Xu, Xu
Xu, Xu, Xu, Xu, Xu, Xu, Xu, Xu, Xu, Xu, Xu, Xu, Xu, Xu, Xu, Xu, Xu, Xu, Xuc, Urb, Rr, Urb, Xuc, Xu, Xu, Xu, Xu, Xu, Xu, Xu, Xu, Xu, Xu, Xu, Xu, Xu, Xu, Xu, Xu, Xu, Xu, Xu
