Xu, Xu, Xu, Xu, Xu, Xu, Xu, Xu, Xu, Xu, Xu, Wog, Xu, Xu, Xu, Xu, Xu, Xu, Xu, Xu, Xu, Xu, Xu, Xu
Xu, Xu, Xu, Xu, Xu, Xu, Xu, Xu, Xu, Xu, Xu, Wog, Xu, Xu, Xu, Xu, Xu, Xu, Xu, Xu, Xu, Xu, Xu, Xu
Xu, Xu, Xu, Xu, Xu, Xu, Xu, Xu, Xu, Xu, Xu, Wog, Wog, Xu, Xu, Xu, Xu, Xu, Xu, Xu, Uu, Xu, Xu, Xu
Xu, Xu, Xu, Xu, Xu, Xu, Xu, Uu, Uu, Xu, Xu, Xu, Xu, Wog, Wog, Xu, Xu, Xu, Xu, Uu, Xu, Xu, Xu, Xu
Uu, Xu, Xu, Xu, Xu, Xu, Xu, Uu, Uu, Xu, Xu, Xu, Xu, Xu, Wog^Xo, Xu, Xu, Xu, Qxu, Uu, Qxu, Xu, Xu, Xu
Ur^Br\, Uu, Uu, Xu, Xu, Xu, Xu, Xu, Cud, Cud, Cud, Xu, Xu, Xu, Wog, Xu, Xu, Qxu, Qxu, Qxu^Bp|, Qxu, Xu, Uu, Uu
Uu, Ur^Br\, Cud, Cud, Ur^Br\, Uh, Uu^Tf, Uu^Tf, Uu, Uu, Uu, Xu, Xu, Wwg, Wwg, Xu, Cud, Qxu, Uh, Uh, Uh, Cud, Cud, Urb
Xu, Cud, Uh^Ii, Uu^Ii, Uu^Ii, Ur^Br\, Uu, Uu, Cud, Uu, Uu, Tb^Tfi, Uu^Tfi, Cud, Wwf^Es, Wwf, Tb^Tf, Uh^Tf, Ce, Ce, Ce^Ecf, Ur, Uu, Cud
Xu, Xu, Uh^Tf, Uh^Ii, Uu^Ii, Ur^Br|, Ur^Br\, Cud, 2 Kud, Cud, Ur, Uu^Tf, Ur, Uu^Es, Ur^Es, Wwf, Ur, Ur, Ce^Ii, 1 Ke, Ce, Ur, Uu, Xu
Xu, Xu, Xu, Uu^Tf, Uu, Uu, Uu, Cud, Cud, Cud, Uue, Ur, Ur^Es, Ur, Ur, Wwf^Bw/, Wwf, Re, Uu^Ii, Ce, Uu, Uu, Xu, Xu
Xu, Xu, Xu, Xu, Xu, Uu, Uue, Uue, Rb^Emf, Uue, Re^Em, Uue^Es, Cud, Uu, Uu^Tf, Tb^Tf, Tb^Tf, Wwf^Ii, Wwg, Uu, Uu, Xu, Xu, Xu
Xu, Xu, Xu, Xu, Xu, Uu, Uu, Rb^Em, Re^Emf, Rb^Emf, Rb^Em, Cud, Kud, Cud, Cud, Tb^Tf, Xu, Cud, Xu, Wwg, Xu, Xu, Xu, Xu
Xu, Xu, Xu, Xu, Cud, Uu, Uu, Re^Emf, Re^Emf, Re^Emf, Qxu, Cud, Qxu, Cud, Xu, Xu, Xu, Xu, Xu, Wog^Xo, Xu, Xu, Xu, Xu
Xu, Xu, Re, Re, Uu, Cud, Xu, Qxu, Qxu, Qxu, Qxu, Qxu, Xu, Qxu, Xu, Xu, Xu, Xu, Xu, Wog, Wog, Xu, Xu, Xu
Xu, Xu, Uu, Uu, Xu, Xu, Xu, Xu, Xu, Xu, Xu, Xu, Xu, Xu, Xu, Xu, Xu, Xu, Xu, Xu, Xu, Wog, Wog, Xu
Xu, Xu, Xu, Xu, Xu, Xu, Xu, Xu, Xu, Xu, Xu, Xu, Xu, Xu, Xu, Xu, Xu, Xu, Xu, Xu, Xu, Xu, Xu, Wog
Xu, Xu, Xu, Xu, Xu, Xu, Xu, Xu, Xu, Xu, Xu, Xu, Xu, Xu, Xu, Xu, Xu, Xu, Xu, Xu, Xu, Xu, Xu, Xu
Xu, Xu, Xu, Xu, Xu, Xu, Xu, Xu, Xu, Xu, Xu, Xu, Xu, Xu, Xu, Xu, Xu, Xu, Xu, Xu, Xu, Xu, Xu, Xu
Xu, Xu, Xu, Xu, Xu, Xu, Xu, Xu, Xu, Xu, Xu, Xu, Xu, Xu, Xu, Xu, Xu, Xu, Xu, Xu, Xu, Xu, Xu, Xu
Xu, Xu, Xu, Xu, Xu, Xu, Xu, Xu, Xu, Xu, Xu, Xu, Xu, Xu, Xu, Xu, Xu, Xu, Xu, Xu, Xu, Xu, Xu, Xu
