Rd, Rd, Hh, Hh, Hh, Rd, Re, Re^Gvs, Re^Gvs, Re^Gvs, Re, Re^Gvs, Re^Gvs, Re^Gvs, Rd, Re^Gvs, Re^Gvs, Re^Gvs, Re^Gvs, Re^Gvs, Re, Re, Re, Gg, Ww, Ww, Re^Gvs, Re^Gvs, Re^Gvs
Rd, Re^Gvs, Rd, Gs^Fp, Hh, Rd, Gg, Re^Gvs, Gg^Efm, Re, Ww, Re^Gvs, Ww, Re^Gvs, Rd, Re^Gvs, Ww, Re^Gvs, Ww, Re^Gvs, Ww, Gg^Efm, Ww, Ww^Bw\, Re, Re^Gvs, Re^Gvs, Gg^Efm, Re^Gvs
Rd, Rd, Re^Gvs, Rd, Rd, Rd, Gg^Efm, Gg, Ww, Ww, Co, Ww, Co, Ww, Ww^Bw|, Ww, Co, Ww, Co, Ww, Ww, Ww, Ww, Gg^Efm, Re, Re^Gvs, Re, Re^Gvs, Re^Gvs
Gg, Re^Gvs, Re^Gvs, Re^Gvs, Re^Gvs, Gg^Efm, Ww, Ww, Co, Co, Mm, Co, Mm, Co, Rd, Co, Mm, Co, Mm, Co, Co, Ww, Ww, Gg^Efm, Re^Gvs, Re, Re^Gvs, Re, Re^Gvs
Re^Gvs, Re^Gvs, Re^Gvs, Re^Gvs, Ww, Ww, Co, Co, Mm, Mm, Mm, Mm, Mm, Mm, Rd, Mm, Mm, Mm, Mm, Mm, Mm, Co, Co, Ww, Ww, Re^Gvs, Re^Gvs, Re, Re^Gvs
Gg, Re^Gvs, Re^Gvs, Ww, Co, Co, Mm, Mm, Mm, Mm, Co, Mm, Mm^Vo, Mm, Rd, Mm, Mm^Vo, Mm, Co, Mm, Mm, Mm, Mm, Co, Co, Ww, Gg, Re, Rd
Gs^Fp, Re^Gvs, Gg, Ww, Co, Mm, Mm, Mm, Co, Co, Co, Mm^Vo, Mm^Vo, Mm, Rd, Mm, Mm^Vo, Mm^Vo, Co, Co, Co, Mm, Mm, Mm, Co, Ww, Gg^Efm, Rd, Re^Gvs
Re^Gvs, Gg, Gg, Ww, Co, Mm, Mm, Co, Co, Ko, Co, Co, Mm^Vo, Mm^Vo, Rd, Mm^Vo, Mm^Vo, Co, Co, Ko, Co, Co, Mm, Mm, Co, Ww, Gg^Efm, Rd, Re^Gvs
Re^Gvs, Re^Gvs, Re^Gvs, Ww, Co, Mm, Mm, Mm^Vo, Co, Co, Mm^Vo, Mm^Vo, Rd, Rd, Rd, Rd, Rd, Mm^Vo, Mm^Vo, Co, Co, Mm^Vo, Mm, Mm, Co, Ww, Gg, Rd, Re^Gvs
Re^Gvs, Re^Gvs, Rd, Ww, Co, Mm, Mm, Mm^Vo, Mm, Mm^Vo, Mm^Vo, Rd, Mm^Vo, Co, Co, Co, Mm^Vo, Rd, Mm^Vo, Mm^Vo, Mm, Mm^Vo, Mm, Mm, Co, Ww, Rd, Rd, Re
Re^Gvs, Re, Rd, Ww^Bw\, Rd, Rd, Rd, Rd, Rd, Rd, Rd, Rd, Rd, Co, 1 Ko, Co, Rd, Rd, Rd, Rd, Rd, Rd, Rd, Rd, Rd, Ww^Bw/, Re, Re, Re
Rd, Rd, Rd, Ww^Bw/, Co, Rd, Mm, Rd, Mm, Rd, Mm^Vo, Rd, Mm^Vo, Co, Co, Co, Mm^Vo, Rd, Mm^Vo, Rd, Mm, Rd, Mm, Rd, Co, Ww^Bw\, Rd, Re, Re^Gvs
Rd, Re^Gvs, Re^Gvs, Ww, Co, Mm, Mm, Mm^Vo, Co, Mm^Vo, Mm^Vo, Rd, Rd, Co, Rd, Co, Rd, Rd, Mm^Vo, Mm^Vo, Co, Mm^Vo, Mm, Mm, Co, Ww, Gg^Efm, Rd, Re^Gvs
Re^Gvs, Rd, Re^Gvs, Ww, Co, Mm, Mm, Mm^Vo, Co, Co, Co, Mm^Vo, Mm^Vo, Rd, Rd, Rd, Mm^Vo, Mm^Vo, Co, Co, Co, Mm^Vo, Mm, Mm, Co, Ww, Gg^Efm, Rd, Re^Gvs
Re^Gvs, Rd, Rd, Ww, Co, Mm, Mm, Co, Co, Ko, Co, Co, Mm^Vo, Mm^Vo, Rd, Mm^Vo, Mm^Vo, Co, Co, Ko, Co, Co, Mm, Mm, Co, Ww, Gg, Rd, Rd
Re^Gvs, Rd, Re^Gvs, Ww, Co, Mm, Mm, Mm, Mm, Co, Co, Mm^Vo, Mm^Vo, Mm, Rd, Mm^Vo, Mm, Mm, Co, Co, Mm, Mm, Mm, Mm, Co, Ww, Re^Gvs, Re^Gvs, Gg
Re^Gvs, Rd, Re, Ww, Ww, Co, Co, Mm, Mm, Mm, Mm, Mm, Mm, Mm, Rd, Mm, Mm, Mm, Mm, Mm, Mm, Mm, Co, Co, Ww, Ww, Re^Gvs, Re^Gvs, Re^Gvs
Rd, Rd, Gg, Re, Gg, Ww, Ww, Co, Co, Mm, Mm, Mm, Mm, Mm, Rd, Mm, Mm, Mm, Mm, Mm, Co, Co, Ww, Ww, Gg^Efm, Re^Gvs, Re, Re^Gvs, Re^Gvs
Re^Gvs, Gg, Re^Gvs, Gg, Re^Gvs, Re^Gvs, Ww, Ww, Ww, Co, Co, Mm, Co, Mm, Rd, Mm, Co, Mm, Co, Co, Ww, Ww, Re^Gvs, Re^Gvs, Re, Gg^Efm, Re^Gvs, Re^Gvs, Re^Gvs
Hh, Re^Gvs, Re^Gvs, Re^Gvs, Re^Gvs, Re^Gvs, Ww, Ww, Re^Gvs, Ww, Ww, Co, Ww, Co, Ww^Bw|, Co, Ww, Co, Ww, Ww, Rd, Re^Gvs, Rd, Rd, Rd, Re, Rd, Re^Gvs, Rd
Re^Gvs, Re^Gvs, Ww, Ww, Ww, Ww, Re^Gvs, Re^Gvs, Re, Gg, Gg, Ww, Re^Gvs, Ww, Rd, Ww, Re^Gvs, Ww, Re^Gvs, Rd, Re^Gvs, Rd, Re^Gvs, Re^Gvs, Re^Gvs, Rd, Re^Gvs, Rd, Re^Gvs
Re^Gvs, Re^Gvs, Ww, Gg, Re^Gvs, Re^Gvs, Re^Gvs, Re^Gvs, Re, Re^Gvs, Re^Gvs, Re^Gvs, Re^Gvs, Re^Gvs, Rd, Re^Gvs, Re^Gvs, Re^Gvs, Re, Re, Re^Gvs, Re^Gvs, Gll^Fp, Re^Gvs, Gll^Fp, Gg, Re^Gvs, Re^Gvs, Re^Gvs
