Gg, Gg, Gg, Gg^Efm, Gg, Gg, Gg, Gg, Gs^Fp, Gs^Fp, Gs^Fp, Gg, Gs^Fp, Gg^Efm, Re, Re, Re, Re, Re, Gg, Gg, Gs^Fp, Gs^Fp, Gs^Fp, Gg, Gg, Gg, Gg, Gg, Gg, Gg, Gg, Gg, Gg, Gg, Gg
Gg, Gg, Gg, Gg^Efm, Gg, Gg, Gg, Gg, Gs^Fp, Gs^Fp, Gs^Fp, Gg, Gs^Fp, Gg^Efm, Re, Re, Re, Re, Re, Gg, Gg, Gs^Fp, Gs^Fp, Gs^Fp, Gg, Gg, Gg, Gg, Gg, Gg, Gg, Gg, Gg, Gg, Gg, Gg
Gg, Gg, Gg^Efm, Gg, Gg, Gg^Efm, Gs^Fp, Gs^Fp, Gs^Fp, Gg^Fet, Gs^Fp, Gs^Fp, Gs^Fp, Gs^Fp, Co, Co, Re, Co, Co, Re, Gs^Fp, Gs^Fp, Gg^Fet, Gs^Fp, Gs^Fp, Gs^Fp, Gs^Fp, Gs^Fp, Gs^Fp, Gg, Gs^Fp, Gg, Gg, Gg, Gg, Gg
Gg, Gg, Gg^Efm, Gg, Gs^Fp, Gg, Gs^Fp, Gs^Fp, Gg^Fet, Gs^Fp, Gs^Fp, Gg^Ve, Hh, Hh, Co, Ko, Re, Ko, Co, Re, Hh, Gs^Fp, Hh, Gs^Fp, Gg^Fet, Gs^Fp, Gs^Fp, Gs^Fp, Gs^Fp, Gs^Fp, Gs^Fp, Gs^Fp, Gg, Gg, Gg, Gg
Gg^Efm, Gg^Efm, Gg, Gg, Gs^Fp, Gs^Fp, Gs^Fp, Gg^Fet, Gs^Fp, Gs^Fp, Hh, Hh, Mm, Hh, Mm, Mm, Re, Mm, Mm, Hh, Mm, Hh, Hh, Hh, Gs^Fp, Gs^Fp, Gs^Fp, Gg^Fet, Gs^Fp, Gs^Fp, Gs^Fp, Gs^Fp, Gs^Fp, Gg, Gg, Gg
Gg^Efm, Gg^Efm, Gg, Gg, Gs^Fp, Gs^Fp, Gg^Ve, Gs^Fp, Hh, Mm, Mm, Mm, Mm, Mm, Mm, Mm, Re, Mm, Mm, Mm, Mm, Mm, Hh, Hh, Gg^Ve, Hh, Hh, Gs^Fp, Gs^Fp, Gg^Ve, Gs^Fp, Gs^Fp, Gs^Fp, Gg, Gg, Gg
Gg^Efm, Gg^Efm, Gg, Gs^Fp, Gs^Fp, Gs^Fp, Hh, Hh, Mm, Mm, Co, Co, Co, Co, Co, Mm, Re, Mm, Co, Co, Co, Co, Co, Hh, Mm, Hh, Hh, Hh, Gg^Fet, Gs^Fp, Gs^Fp, Gs^Fp, Gg, Gg, Gg, Gg
Gg^Efm, Gg^Efm, Gg, Gs^Fp, Gg, Gs^Fp, Hh, Mm, Mm, Mm, Co, Co, Ko, Co, Co, Ko, Re, Ko, Co, Co, Ko, Co, Co, Mm, Mm, Mm, Hh, Hh, Gs^Fp, Gs^Fp, Gg, Gg, Gg, Gg, Gg, Gg
Gg^Efm, Gg^Efm, Gg^Efm, Gg, Gg, Hh, Hh, Hh, Mm, Mm, Co, Ko, Gg^Vh, Co, Re, Re, Re, Re, Re, Co, Gg^Vh, Ko, Co, Mm, Mm, Mm, Mm, Hh, Hh, Gg, Gg, Gg^Efm, Gg, Gg, Gg, Gg
Gg^Efm, Gg^Efm, Gg, Gg, Co, Co, Mm, Mm, Mm, Mm, Ko, Co, Re, Re, Co, Gg^Vh, Co, Gg^Vh, Co, Re, Re, Co, Ko, Mm, Mm, Mm, Mm, Hh, Hh, Co, Co, Gg, Gg, Gg, Gg, Gg
Gg^Efm, Gg^Efm, Gg^Efm, Re, Re, Ko, Re, Mm, Re, Mm, Re, Co, Re, Gg^Vh, Co, Co, Ko, Co, Co, Gg^Vh, Re, Co, Re, Mm, Re, Mm, Re, Hh, Re, Ko, Re, Gg, Gg, Gg, Gg, Gg
Gg, Gg, Gg^Efm, Re, Re, Re, Re, Re, Re, Re, Re, Re, Re, Gg^Vh, Co, Ko, 1 Ko, Ko, Co, Gg^Vh, Re, Re, Re, Re, Re, Re, Re, Re, Re, Re, Re, Gg, Gg, Gg, Gg, Gg
Gg, Gg, Gg^Efm, Re, Co, Ko, Mm, Mm, Mm, Mm, Ko, Co, Re, Gg^Vh, Co, Co, Co, Co, Co, Gg^Vh, Re, Co, Ko, Re, Re, Mm, Mm, Mm, Hh, Ko, Co, Gg, Gg, Gg, Gg, Gg
Gg^Efm, Gg^Efm, Gg, Hh, Hh, Co, Mm, Mm, Mm, Gg, Co, Co, Gg^Vh, Re, Re, Gg^Vh, Re, Gg^Vh, Re, Re, Gg^Vh, Co, Co, Re, Mm, Mm, Mm, Mm, Hh, Co, Gg, Gg, Gg, Gg, Gg, Gg
Gg, Gg, Gs^Fp, Hh, Hh, Hh, Hh, Mm, Mm, Mm, Co, Ko, Ko, Co, Co, Re, Re, Re, Co, Co, Ko, Ko, Co, Mm, Mm, Mm, Mm, Hh, Hh, Gg, Gs^Fp, Gg, Gg, Gg, Gg, Gg
Gs^Fp, Gs^Fp, Gs^Fp, Gs^Fp, Gs^Fp, Hh, Mm, Mm, Mm, Mm, Co, Co, Co, Co, Co, Ko, Re, Ko, Co, Co, Co, Co, Co, Mm, Mm, Mm, Mm, Hh, Hh, Gs^Fp, Gs^Fp, Gs^Fp, Gs^Fp, Gg, Gg, Gg
Gs^Fp, Gs^Fp, Gg^Fet, Gg^Fet, Hh, Hh, Mm, Mm, Mm, Mm, Mm, Co, Mm, Co, Mm, Re, Re, Re, Mm, Co, Mm, Co, Mm, Mm, Mm, Mm, Hh, Hh, Hh, Hh, Gs^Fp, Gg^Fet, Gs^Fp, Gs^Fp, Gg, Gg
Gg, Gg, Gs^Fp, Gs^Fp, Gg^Ve, Hh, Hh, Mm, Hh, Mm, Mm, Mm, Mm, Mm, Mm, Mm, Re, Mm, Mm, Mm, Mm, Mm, Mm, Mm, Hh, Hh, Hh, Hh, Gs^Fp, Gg^Ve, Gs^Fp, Gs^Fp, Gs^Fp, Gs^Fp, Gs^Fp, Gs^Fp
Gs^Fp, Gs^Fp, Gs^Fp, Gg^Fet, Gs^Fp, Hh, Hh, Hh, Hh, Hh, Hh, Mm, Mm, Mm, Co, Mm, Re, Mm, Co, Mm, Mm, Mm, Hh, Mm, Hh, Hh, Gs^Fp, Hh, Gs^Fp, Gs^Fp, Gg^Fet, Gs^Fp, Gg, Gs^Fp, Gs^Fp, Gs^Fp
Gg, Gg, Gg, Gs^Fp, Gs^Fp, Gs^Fp, Gs^Fp, Gs^Fp, Gs^Fp, Hh, Gs^Fp, Hh, Hh, Mm, Co, Ko, Re, Ko, Co, Hh, Hh, Hh, Hh, Hh, Gs^Fp, Gs^Fp, Gs^Fp, Gs^Fp, Gs^Fp, Gs^Fp, Gs^Fp, Gg, Gg, Gg, Gg, Gg
Gg, Gg, Gs^Fp, Gs^Fp, Gg, Gs^Fp, Gs^Fp, Gs^Fp, Gs^Fp, Gs^Fp, Gs^Fp, Gs^Fp, Gs^Fp, Hh, Re, Co, Re, Co, Re, Hh, Gg, Hh, Hh, Hh, Gg^Ve, Gs^Fp, Gs^Fp, Gs^Fp, Gs^Fp, Gs^Fp, Gs^Fp, Gg, Gg, Gg, Gg, Gg
Gg, Gg, Gg, Gg, Gg, Gg, Gg, Gs^Fp, Gs^Fp, Gs^Fp, Gs^Fp, Gs^Fp, Gs^Fp, Gs^Fp, Gs^Fp, Re, Gg, Re, Gg, Gg, Gg, Gs^Fp, Gs^Fp, Hh, Gs^Fp, Gs^Fp, Gs^Fp, Gs^Fp, Gs^Fp, Gs^Fp, Gg, Gg, Gg, Gg, Gg, Gg
Gg, Gg, Gg, Gg, Gg, Gg, Gg, Gs^Fp, Gg, Gs^Fp, Gs^Fp, Gg, Gg, Gg, Gg, Gg, Gg, Gg, Gg, Gg, Gg, Gg, Gs^Fp, Gs^Fp, Gs^Fp, Gs^Fp, Gs^Fp, Gg, Gg, Gg, Gg, Gg, Gg, Gg, Gg, Gg
Gg, Gg, Gg, Gg, Gg, Gg, Gg, Gs^Fp, Gg, Gs^Fp, Gs^Fp, Gg, Gg, Gg, Gg, Gg, Gg, Gg, Gg, Gg, Gg, Gg, Gs^Fp, Gs^Fp, Gs^Fp, Gs^Fp, Gs^Fp, Gg, Gg, Gg, Gg, Gg, Gg, Gg, Gg, Gg
