border_size=1
usage=map

Mm          ,Mm          , Mm          , Mm^Xm       , Mm^Xm       , Mm^Xm       , Mm          , Mm          , Mm          , Mm          , Mm          , Mm          , Mm          , Gs^Fp       , Mm          , Mm          , Mm          , Mm          , Mm          , Mm          , Mm          , Mm          , Gs^Fp       , Mm          , Mm          , Mm          , Mm          , Mm          , Mm          , Mm          , Mm          , Mm          , Mm          , Mm^Xm       , Mm^Xm       , Mm^Xm       , Mm^Xm       
Mm          ,Mm          , Mm          , Mm^Xm       , Mm^Xm       , Mm^Xm       , Mm          , Mm          , Mm          , Mm          , Mm          , Mm          , Mm          , Gs^Fp       , Mm          , Mm          , Mm          , Mm          , Mm          , Mm          , Mm          , Mm          , Gs^Fp       , Mm          , Mm          , Mm          , Mm          , Mm          , Mm          , Mm          , Mm          , Mm          , Mm          , Mm^Xm       , Mm^Xm       , Mm^Xm       , Mm^Xm       
Mm          ,Mm          , Mm          , Mm^Xm       , Mm^Xm       , Mm^Xm       , Mm          , Mm          , Mm          , Gg^Vh       , Mm          , Mm          , Hh          , Gs^Fp       , Gs^Fp       , Mm          , Hh          , Mm          , Hh          , Mm          , Gs^Fp       , Gs^Fp       , Mm          , Mm          , Mm          , Mm          , Hh          , Mm          , Hh          , Mm          , Gg^Vh       , Mm          , Mm          , Mm          , Mm^Xm       , Mm^Xm       , Mm^Xm       
Mm          ,Mm          , Mm^Xm       , Mm          , Mm          , Mm          , Gg^Vh       , Mm          , Mm          , Hh          , Hh          , Mm          , Gg^Vh       , Gs^Fp       , Mm          , Gs^Fp       , Gg^Vh       , Hh          , Hh          , Mm          , Gs^Fp       , Gs^Fp       , Hh          , Hh          , Hh          , Mm          , Hh          , Hh          , Hh          , Hh          , Mm          , Mm          , Mm          , Mm          , Mm          , Mm          , Mm          
Mm          ,Mm          , Mm^Xm       , Mm^Xm       , Mm^Xm       , Mm          , Mm          , Hh          , Hh          , Gs^Fp       , Hh          , Hh          , Hh          , Mm          , Gs^Fp       , Gs^Fp       , Gs^Fp       , Gs^Fp       , Hh          , Hh          , Re          , Hh          , Gg          , Mm          , Gg          , Hh          , Hh          , Gg^Vh       , Hh          , Hh          , Gg          , Mm          , Mm          , Mm          , Mm          , Mm          , Mm          
Mm          ,Mm          , Mm          , Mm          , Mm          , Mm          , Mm          , Hh          , Gs^Fp       , Gs^Fp       , Gs^Fp       , Gs^Fp       , Chr         , Re          , Gs^Fp       , Gs^Fp       , Gs^Fp       , Gs^Fp       , Gs^Fp       , Gg^Vh       , Gs^Fp       , Gg          , Gg          , Gg          , Re^Gvs      , Hh          , Gg          , Hh          , Hh          , Rd          , Re          , Re          , Mm          , Mm          , Mm          , Mm          , Mm          
Mm          ,Mm          , Mm          , Mm          , Gs^Fp       , Mm          , Mm          , Hh          , Hh          , Gs^Fp       , Chr         , Chr         , Chr         , Re          , Gs^Fp       , Gs^Fp       , Gs^Fp       , Gs^Fp       , Gs^Fp       , Gs^Fp       , Gs^Fp       , Gg          , Gg          , Gg^Vh       , Re^Gvs      , Re^Gvs      , Gg          , Chr         , Chr         , Re          , Kh          , Hh          , Hh          , Mm          , Mm          , Mm          , Mm          
Mm          ,Mm          , Mm          , Hh          , Gs^Fp       , Mm          , Gs^Fp       , Gg^Vh       , Gs^Fp       , Re          , Chr         , 1 Kh        , Chr         , Gs^Fp       , Gs^Fp       , Re          , Gs^Fp       , Chr         , Gg          , Gs^Fp       , Gg          , Gg          , Re^Gvs      , Re^Gvs      , Re^Gvs      , Re^Gvs      , Re^Gvs      , Gg          , Rd          , Rd          , Chr         , Hh          , Mm          , Hh          , Mm          , Mm          , Mm          
Mm          ,Mm          , Mm          , Mm          , Hh          , Gs^Fp       , Gs^Fp       , Gs^Fp       , Gs^Fp       , Chr         , Gs^Fp       , Chr         , Chr         , Gs^Fp       , Re          , Re          , Gs^Fp       , Chr         , Gg          , Gg          , Gg          , Gg          , Re^Gvs      , Re^Gvs      , Re^Gvs      , Re^Gvs      , Re^Gvs      , Re          , Gg          , Gg          , Gg          , Hh          , Hh          , Mm          , Mm          , Mm          , Mm          
Mm          ,Mm          , Mm          , Gg^Vh       , Hh          , Hh          , Hh          , Gs^Fp       , Gs^Fp       , Gs^Fp       , Chr         , Gs^Fp       , Gs^Fp       , Gs^Fp       , Rd          , Gs^Fp       , Re^Gvs      , Rd          , Rd          , Re^Gvs      , Re^Gvs      , Gg          , Gg          , Gg          , Rd          , Re          , Rd          , Rd          , Gg          , Gg^Vh       , Hh          , Gg          , Hh          , Hh          , Mm          , Mm          , Mm          
Mm          ,Mm          , Hh          , Hh          , Gg          , Hh          , Gs^Fp       , Gg^Vh       , Gs^Fp       , Gs^Fp       , Gs^Fp       , Gs^Fp       , Gg^Vh       , Gs^Fp       , Rd          , Re^Gvs      , Re^Gvs      , Re^Gvs      , Gg^Vh       , Re^Gvs      , Gg          , Gg          , Rd          , Rd          , Gg^Vh       , Rd          , Gs^Fp       , Re          , Gg          , Gg          , Hh          , Hh          , Mm          , Hh          , Mm          , Mm          , Mm          
Hh          ,Hh          , Hh          , Hh          , Mm          , Gg          , Gg          , Gs^Fp       , Gg          , Gs^Fp       , Gs^Fp       , Gs^Fp       , Gs^Fp       , Gs^Fp       , Re          , Re^Gvs      , Re^Gvs      , Re^Gvs      , Gg          , Rd          , Re          , Re          , Re^Gvs      , Gg          , Re^Gvs      , Gs^Fp       , Gs^Fp       , Gg          , Gg          , Hh          , Hh          , Hh          , Mm          , Hh          , Mm          , Mm          , Mm          
Hh          ,Hh          , Hh          , Mm          , Gs^Fp       , Gg          , Gg          , Gg          , Gg          , Gg          , Rd          , Gg          , Rd          , Gs^Fp       , Re          , Re^Gvs      , Re^Gvs      , Gg          , Chr         , Rd          , Gg^Vh       , Re^Gvs      , Re^Gvs      , Re^Gvs      , Re^Gvs      , Gs^Fp       , Gg          , Gg          , Re^Gvs      , Hh          , Hh          , Hh          , Mm          , Mm          , Mm          , Mm          , Mm          
Hh          ,Hh          , Gs^Fp       , Gs^Fp       , Gs^Fp       , Gg          , Gg^Vh       , Gg          , Re          , Rd          , Gg^Vh       , Re          , Gg          , Re          , Gg^Vh       , Re^Gvs      , Re^Gvs      , Re          , Re          , Chr         , Rd          , Gg          , Re^Gvs      , Re^Gvs      , Re^Gvs      , Gg          , Gs^Fp       , Gg          , Re^Gvs      , Re^Gvs      , Re^Gvs      , Gg          , Gg          , Hh          , Mm          , Mm          , Mm          
Gs^Fp       ,Gs^Fp       , Gs^Fp       , Gs^Fp       , Hh          , Gg          , Re          , Re          , Gg          , Gg          , Gs^Fp       , Gg          , Re^Gvs      , Re^Gvs      , Re^Gvs      , Gg          , Re^Gvs      , Re          , Chr         , Re          , Kh          , Rd          , Re          , Re^Gvs      , Re          , Gg          , Gg          , Gg          , Gg          , Gg          , Gg^Vh       , Gg          , Hh          , Hh          , Gg^Vh       , Mm          , Mm          
Gg          ,Gg          , Gs^Fp       , Mm          , Hh          , Gg          , Re          , Re^Gvs      , Re^Gvs      , Gg          , Gs^Fp       , Gs^Fp       , Gg          , Re^Gvs      , Re^Gvs      , Re^Gvs      , Gg          , Re          , Re          , Chr         , Gg          , Gg          , Gg          , Rd          , Re          , Gg          , Gg          , Gg          , Gg          , Gg          , Gg          , Hh          , Hh          , Hh          , Hh          , Mm          , Mm          
Gg          ,Gg          , Gg          , Gg          , Gg^Vh       , Rd          , Re^Gvs      , Re^Gvs      , Gg          , Gs^Fp       , Gs^Fp       , Gs^Fp       , Gs^Fp       , Gg          , Gg          , Gg          , Rd          , Rd          , Gg          , Gg          , Gg          , Gg          , Gg          , Gg^Vh       , Re          , Gg          , Re^Gvs      , Gg^Vh       , Re^Gvs      , Re^Gvs      , Hh          , Hh          , Gg          , Hh          , Hh          , Hh          , Hh          
Re          ,Re          , Re^Gvs      , Re^Gvs      , Chr         , Chr         , Re          , Re^Gvs      , Re^Gvs      , Re^Gvs      , Re^Gvs      , Gs^Fp       , Rd          , Gg          , Gg          , Gg          , Re^Gvs      , Gg          , Gg          , Gg          , Gs^Fp       , Gs^Fp       , Gs^Fp       , Rd          , Gg          , Gg          , Re^Gvs      , Re^Gvs      , Re^Gvs      , Re^Gvs      , Re^Gvs      , Hh          , Ce          , Hh          , Gg          , Hh          , Hh          
Rd          ,Rd          , Rd          , Re^Gvs      , Re          , Rd          , Rd          , Re^Gvs      , Re^Gvs      , Re^Gvs      , Gg          , Re^Gvs      , Rd          , Gg          , Gs^Fp       , Re^Gvs      , Re^Gvs      , Gg          , Re^Gvs      , Gg^Vh       , Gs^Fp       , Gs^Fp       , Gs^Fp       , Rd          , Gg          , Re^Gvs      , Gg          , Re^Gvs      , Rd          , Re          , Rd          , Ce          , 3 Ke        , Ce          , Rd          , Rd          , Rd          
Hh          ,Hh          , Gg^Vh       , Re          , Hh          , Chr         , Gg          , Re          , Gg          , Gg^Vh       , Rd          , Rd          , Gs^Fp       , Gs^Fp       , Chr         , Gs^Fp       , Re^Gvs      , Re^Gvs      , Gg          , Chr         , Gs^Fp       , Gs^Fp       , Gs^Fp       , Rd          , Rd          , Gg          , Gg          , Gg          , Rd          , Gg^Vh       , Gg          , Ce          , Ce          , Ce          , Gg          , Gg          , Gg          
Mm          ,Mm          , Hh          , Hh          , Mm          , Hh          , Hh          , Gg          , Gg          , Gg          , Rd          , Gg          , Gs^Fp       , Gs^Fp       , Chr         , Gg          , Rd          , Re^Gvs      , Gg          , Gg          , Rd          , Gs^Fp       , Re^Gvs      , Re^Gvs      , Gg          , Rd          , Re          , Rd          , Re          , Gg          , Gs^Fp       , Gs^Fp       , Gs^Fp       , Gg          , Hh          , Gg^Vh       , Gg       
Mm          ,Mm          , Hh          , Mm          , Mm          , Hh          , Gg^Vh       , Hh          , Gg          , Gg          , Rd          , Gs^Fp       , Gg^Vh       , Chr         , Gg          , Gg          , Rd          , Gg          , Ch          , Rd          , Gg          , Rd          , Re^Gvs      , Re^Gvs      , Re^Gvs      , Gg          , Rd          , Re          , Gg          , Gs^Fp       , Gs^Fp       , Gs^Fp       , Hh          , Hh          , Mm          , Hh          , Hh          
Mm          ,Mm          , Mm          , Mm          , Mm          , Mm          , Mm          , Mm          , Gg          , Rd          , Re^Gvs      , Gg          , Re^Gvs      , Gg          , Gg          , Gg          , Rd          , Ch          , 2 Kh        , Ch          , Gg          , Re^Gvs      , Re^Gvs      , Re^Gvs      , Re          , Rd          , Gg          , Gg          , Gs^Fp       , Gg^Vh       , Gs^Fp       , Hh          , Gg^Vh       , Hh          , Mm          , Mm          , Mm          
Mm^Xm       ,Mm^Xm       , Mm^Xm       , Mm^Xm       , Mm          , Mm          , Mm          , Hh          , Hh          , Rd          , Re^Gvs      , Re^Gvs      , Re^Gvs      , Gg          , Re^Gvs      , Gg^Vh       , Gg          , Ch          , Ch          , Ch          , Gg          , Gg          , Chr         , Gg          , Re          , Gg^Vh       , Gg          , Gg          , Gs^Fp       , Gs^Fp       , Hh          , Hh          , Mm          , Mm          , Mm          , Mm          , Mm          
Mm^Xm       ,Mm^Xm       , Mm          , Mm          , Mm          , Mm          , Hh          , Chr         , Gg          , Rd          , Rd          , Re^Gvs      , Gg^Vh       , Gg          , Re^Gvs      , Re^Gvs      , Re^Gvs      , Rd          , Re          , Gg          , Chr         , Gs^Fp       , Gs^Fp       , Gg          , Re          , Re^Gvs      , Re^Gvs      , Gg          , Gs^Fp       , Chr         , Chr         , Hh          , Mm          , Mm          , Mm          , Mm          , Mm          
Mm          ,Mm          , Mm          , Mm          , Gg          , Chr         , Kh          , Hh          , Gg          , Gg          , Re          , Gg          , Gg          , Re^Gvs      , Re^Gvs      , Re^Gvs      , Rd          , Re^Gvs      , Re          , Gg          , Gg^Vh       , Gs^Fp       , Gs^Fp       , Gg          , Re          , Re^Gvs      , Re^Gvs      , Re^Gvs      , Gg          , Hh          , Hh          , Kh          , Mm          , Mm          , Mm          , Mm^Xm       , Mm^Xm       
Mm          ,Mm          , Mm          , Gg^Vh       , Gg          , Chr         , Chr         , Gg          , Gg          , Gg          , Re          , Gg          , Gs^Fp       , Gs^Fp       , Gs^Fp       , Re^Gvs      , Re^Gvs      , Rd          , Rd          , Gg          , Gg          , Gs^Fp       , Gs^Fp       , Gg^Vh       , Re          , Re^Gvs      , Re^Gvs      , Re^Gvs      , Gg          , Gg^Vh       , Chr         , Mm          , Mm          , Mm          , Mm          , Mm^Xm       , Mm^Xm       
Mm          ,Mm          , Mm          , Mm          , Chr         , Gg          , Gg          , Re^Gvs      , Gg^Vh       , Rd          , Re^Gvs      , Gg          , Gs^Fp       , Chr         , Gs^Fp       , Gs^Fp       , Re^Gvs      , Re^Gvs      , Rd          , Gg          , Gg          , Gg          , Gs^Fp       , Gg          , Rd          , Gg          , Gg          , Gg          , Gg          , Hh          , Hh          , Hh          , Mm          , Mm          , Mm          , Mm^Xm       , Mm^Xm       
Mm          ,Mm          , Mm          , Chr         , Hh          , Gg          , Re^Gvs      , Re^Gvs      , Rd          , Rd          , Re^Gvs      , Gg          , Gg          , Gs^Fp       , Gg          , Gg^Vh       , Gg          , Re^Gvs      , Rd          , Gg          , Gg          , Gg          , Rd          , Rd          , Gg          , Gg          , Re^Gvs      , Gg          , Hh          , Hh          , Hh          , Mm          , Mm          , Mm          , Mm          , Mm          , Mm          
Mm          ,Mm          , Hh          , Hh          , Gg          , Re^Gvs      , Re^Gvs      , Re^Gvs      , Re          , Re^Gvs      , Rd          , Gg          , Gg          , Gg          , Gg          , Gg          , Gg          , Gg          , Ggf         , Re          , Re          , Gg          , Rd          , Re^Gvs      , Re^Gvs      , Ggf         , Gg^Vh       , Re^Gvs      , Hh          , Hh          , Mm          , Mm          , Mm          , Mm          , Mm^Xm       , Mm          , Mm          
Mm          ,Mm          , Gg          , Hh          , Gg          , Re^Gvs      , Rd          , Rd          , Re          , Re^Gvs      , Gg          , Re^Gvs      , Re^Gvs      , Gg          , Re^Gvs      , Gg          , Gg          , Ggf         , Gg^Vh       , Re          , Rd          , Re          , Gg          , Re^Gvs      , Re^Gvs      , Re^Gvs      , Ggf         , Re^Gvs      , Mm          , Hh          , Hh          , Mm          , Mm^Xm       , Mm^Xm       , Mm          , Mm          , Mm          
Gg          ,Gg          , Gg^Vh       , Gg          , Re          , Rd          , Gg          , Gg^Vh       , Gs^Fp       , Gg          , Gs^Fp       , Gg          , Re^Gvs      , Re^Gvs      , Re^Gvs      , Re^Gvs      , Gg          , Ggf         , Gs^Fp       , Rd          , Gg          , Gg          , Gg          , Gg          , Gg          , Ggf         , Gg          , Hh          , Mm          , Hh          , Mm          , Mm          , Mm^Xm       , Mm^Xm       , Mm          , Mm          , Mm          
Rd          ,Rd          , Rd          , Re          , Gg          , Gg          , Gs^Fp       , Gs^Fp       , Gs^Fp       , Gs^Fp       , Gs^Fp       , Gg^Vh       , Hh          , Re^Gvs      , Re^Gvs      , Gg          , Gg          , Gs^Fp       , Gs^Fp       , Rd          , Gg          , Gg^Vh       , Gg          , Gg          , Gg          , Gg          , Gg          , Hh          , Mm          , Mm          , Mm          , Mm          , Gs^Fp       , Gs^Fp       , Gs^Fp       , Gs^Fp       , Gs^Fp       
Re^Gvs      ,Re^Gvs      , Re^Gvs      , Re^Gvs      , Gg          , Gs^Fp       , Gs^Fp       , Gs^Fp       , Gs^Fp       , Gs^Fp       , Hh          , Hh          , Hh          , Hh          , Mm          , Gg^Vh       , Gg          , Gs^Fp       , Gs^Fp       , Gs^Fp       , Gs^Fp       , Gg          , Gg          , Gg          , Gg^Vh       , Hh          , Hh          , Hh          , Mm          , Mm          , Mm          , Hh          , Mm^Xm       , Gs^Fp       , Gs^Fp       , Gs^Fp       , Gs^Fp       
Re^Gvs      ,Re^Gvs      , Re^Gvs      , Gg          , Gg          , Gs^Fp       , Hh          , Gs^Fp       , Gs^Fp       , Hh          , Mm          , Hh          , Mm          , Mm          , Hh          , Chr         , Chr         , Gg          , Gs^Fp       , Gs^Fp       , Re          , Gs^Fp       , Gs^Fp       , Gg          , Gg          , Chr         , Hh          , Mm          , Mm          , Mm          , Mm          , Mm          , Mm          , Mm^Xm       , Mm^Xm       , Mm          , Mm          
Re^Gvs      ,Re^Gvs      , Gg^Vh       , Gg          , Gg          , Gs^Fp       , Mm          , Mm          , Mm          , Hh          , Mm          , Mm          , Mm          , Mm          , Mm          , Hh          , Chr         , Gs^Fp       , Gs^Fp       , Gs^Fp       , Rd          , Gs^Fp       , Gs^Fp       , Gg          , Gg          , Hh          , Hh          , Hh          , Mm          , Mm          , Mm          , Mm          , Mm          , Mm          , Mm          , Mm          , Mm          
Re^Gvs      ,Re^Gvs      , Gg       , Gg          , Gg          , Gs^Fp       , Mm          , Mm          , Mm          , Hh          , Mm          , Mm          , Mm          , Mm          , Mm          , Hh          , Chr         , Gs^Fp       , Gs^Fp       , Gs^Fp       , Rd          , Gs^Fp       , Gs^Fp       , Gg          , Gg          , Hh          , Hh          , Hh          , Mm          , Mm          , Mm          , Mm          , Mm          , Mm          , Mm          , Mm          , Mm          
