border_size=1
usage=map

Xu          , Xu          , Xu          , Xu          , Xu          , Xu          , Xu          , Xu          , Xu          , Xu          , Xu          , Xu          , Xu          , Xu          , Xu          , Xu          , Xu          , Xu          , Xu          , Xu          , Xu          , Xu          , Xu          , Xu          , Xu          , Xu          , Xu          , Xu          , Xu          , Xu          , Xu          , Xu          , Xu          , Xu          , Xu          , Xu          , Uu          , Uu          , Wo          , Wo          , Rr          , Rr          
Xu          , Xu          , Xu          , Xu          , Xu          , Xu          , Xu          , Xu          , Xu          , Xu          , Xu          , Xu          , Xu          , Xu          , Xu          , Xu          , Xu          , Xu          , Xu          , Xu          , Xu          , Xu          , Xu          , Xu          , Xu          , Xu          , Xu          , Xu          , Xu          , Xu          , Xu          , Xu          , Xu          , Xu          , Xu          , Xu          , Uu          , Uu          , Wo          , Wo          , Rr          , Rr          
Xu          , Xu          , Uu          , Uu          , Rr          , Xu          , Rr          , Rr          , Rr          , Rr          , Rr          , Rr          , Rr          , Rr          , Xu          , Xu          , Xu          , Uu          , Uu^Uf       , Uu^Uf       , Uu^Uf       , Uu          , Uu^Uf       , Uu^Uf       , Uu^Uf       , Uu          , Uu^Uf       , Uu^Uf       , Uu^Uf       , Xu          , Uu          , Xu          , Uu          , Xu          , Uu          , Uu          , Wo          , Wo          , Rr          , Rr          , Rr          , Rr          
Xu          , Xu          , Rr          , Rr          , Rr          , Rr          , Uu          , Uu^Vud      , Uh          , Rr          , Uu^Vud      , Uu          , Rr          , Rr          , Xu          , Xu          , Xu          , Uu^Uf       , Uu^Uf       , Uu          , Uu^Uf       , Uu^Uf       , Uu^Uf       , Uu          , Uu^Uf       , Uu^Uf       , Uu^Uf       , Uu          , Uu^Uf       , Uu^Uf       , Uu^Uf       , Uu^Uf       , Uu          , Uu          , Wo          , Wo          , Rr          , Rr          , Rr          , Rr          , Uu          , Uu          
Xu          , Xu          , Rr          , Uu          , Uu^Vud      , Rr          , Rr          , Uu          , Uh          , Uh          , Uh          , Uu          , Rr          , Uu          , Xu          , Xu          , Xu          , Uu          , Uu^Uf       , Uu^Uf       , Uu^Uf       , Uu          , Uu^Uf       , Uu^Uf       , Uu^Uf       , Uu          , Uu^Uf       , Uu^Uf       , Uu^Uf       , Uu          , Uu          , Uu          , Cud         , Wo          , Cud         , Rr          , Rr          , Rr          , Uu          , Uu          , Xu          , Xu          
Xu          , Xu          , Rr          , Uh          , Uh          , Uu          , Rr          , Uu^Vud      , Uu          , Uh          , Uh          , Uu          , Rr          , Rr          , Xu          , Xu          , Xu          , Uu^Uf       , Uu^Uf       , Uu^Uf       , Uu^Uf       , Uu^Uf       , Uu^Uf       , Uu^Uf       , Uu^Uf       , Uu^Uf       , Uu^Uf       , Uu^Uf       , Uu          , Uu          , Wo          , Wo          , Cud         , Cud         , Cud         , Rr          , Uu          , Uu          , Xu          , Xu          , Xu          , Xu          
Xu          , Xu          , Rr          , Uh          , Uh          , Uh          , Uh          , Rr          , Rr          , Uh          , Uu^Vud      , Uu          , Rr          , Xu          , Xu          , Xu          , Uh          , Uu          , Uu          , Uu          , Uu          , Uu          , Uu          , Uu          , Uu          , Uu          , Uu          , Uu          , Uu          , Wo          , Wo          , Rr          , Cud         , 2 Kud       , Cud         , Uu          , Uu          , Uu          , Xu          , Xu          , Xu          , Xu          
Xu          , Xu          , Rr          , Uu          , Uu^Vud      , Uh          , Uh          , Uu          , Rr          , Uu          , Uu          , Rr          , Cud         , Xu          , Uu          , Uu          , Uu          , Uu          , Cud         , Uu          , Uu          , Uu          , Uu          , Uu          , Cud         , Uu          , Uu          , Uu          , Cud         , Cud         , Wo          , Rr          , Rr          , Cud         , Uu          , Uu          , Uu          , Uu          , Xu          , Xu          , Xu          , Xu          
Xu          , Xu          , Rr          , Uu          , Uu          , Uh          , Uu          , Uu^Vud      , Rr          , Rr          , Rr          , Rr          , Cud         , Xu          , Rr          , Rr          , Rr          , Rr          , Rr          , Rr          , Rr          , Rr          , Rr          , Rr          , Rr          , Rr          , Rr          , Rr          , Rr          , Rr          , Ww^Bw/      , Rr          , Rr          , Uu          , Uu          , Uu          , Uu^Uf       , Uu          , Xu          , Xu          , Xu          , Xu          
Xu          , Xu          , Rr          , Rr          , Rr          , Uu          , Rr          , Rr          , Xu          , Cud         , Cud         , Rr          , Rr          , Rr          , Cud         , Rr          , Wo          , Rr          , Cud         , Rr          , Wo          , Rr          , Wo          , Rr          , Cud         , Rr          , Wo          , Rr          , Cud         , Rr          , Wo          , Rr          , Rr          , Uu          , Uu          , Uh          , Uh          , Uh          , Xu          , Xu          , Xu          , Xu          
Xu          , Xu          , Rr          , Uu          , Xu          , Rr          , Xu          , Xu          , Xu          , Xu          , Rr          , Rr          , 6 Kud       , Cud         , Cud         , Wo          , Uu          , Wo          , Wo          , Wo          , Uu          , Wo          , Uh          , Wo          , Wo          , Wo          , Uu          , Wo          , Ww^Bw|      , Cud         , Wo          , Rr          , Rr          , Cud         , Uu          , Uu          , Uu          , Uu          , Xu          , Xu          , Xu          , Xu          
Xu          , Xu          , Xu          , Xu          , Xu          , Xu          , Xu          , Xu          , Rr          , Rr          , Rr          , Rr          , Cud         , Wo          , Wo          , Wo          , Uu          , Uu          , Uu          , Uu          , Uu          , Uu          , Uu          , Uu          , Uu          , Uu          , Uu          , Cud         , Cud         , Wo          , Rr          , Rr          , Rr          , Uu          , Uu          , Uu          , Uu          , Uu          , Uu^Uf       , Uu^Uf       , Xu          , Xu          
Xu          , Xu          , Xu          , Xu          , Xu          , Xu          , Rr          , Rr          , Rr          , Rr          , Uu          , Uu          , Uu          , Cud         , Cud         , Cud         , Uu          , Uu^Uf       , Uu^Uf       , Uu^Uf       , Xu          , Uu          , Xu          , Xu          , Xu          , Xu          , Uu          , Uu          , Uu          , Wo          , Rr          , Rr          , Uu^Vu       , Uu          , Uu          , Uu^Uf       , Uu          , Uu          , Uu^Uf       , Uu^Uf       , Xu          , Xu          
Xu          , Xu          , Xu          , Xu          , Xu          , Uh          , Rr          , Rr          , Cud         , Cud         , Uu          , Uu          , Uu          , Uu          , Uu          , Uu          , Uu          , Uu^Uf       , Xu          , Xu          , Xu          , Xu          , Xu          , Xu          , Uu          , Uu          , Mm          , Md          , Md          , Wo          , Rr          , Rr          , Uu          , Uu          , Uh          , Uh          , Uu          , Uu          , Uu^Uf       , Uu^Uf       , Xu          , Xu          
Xu          , Xu          , Xu          , Uu^Uf       , Uu          , Uu          , Rr          , Rr          , Uu          , Cud         , Uu          , Uu^Vu       , Uu          , Uu          , Uu          , Uu          , Xu          , Xu          , Xu          , Xu          , Xu          , Xu          , Uu          , Uu          , Re          , Re          , Re          , Md          , Mm          , Wo          , Rr          , Rr          , Cud         , Uu          , Uu          , Uu^Vud      , Uu          , Uu          , Uu^Vud      , Uu^Uf       , Xu          , Xu          
Xu          , Xu          , Xu          , Uu          , Uh          , Uu          , Rr          , Rr          , Uu          , Uu          , Uh          , Uh          , Uh          , Uu          , Uu          , Uu          , Uu          , Uu          , Uh          , Xu          , Uh          , Uu^Uf       , Uu          , Re          , Re          , Re          , Re          , Re          , Uu          , Wo          , Rr          , Rr          , Uu          , Uu          , Uu          , Uu          , Uu^Uf       , Uu          , Uu^Uf       , Uu^Uf       , Xu          , Xu          
Xu          , Xu          , Xu          , Uh          , Uu          , Uh          , Rr          , Rr          , Uu          , Uu          , Uu          , Uh          , Re          , Uu          , Uu          , Uu          , Uu          , Uu          , Uu          , Uh          , Uh          , Uh          , Uu          , Uu          , Re          , Re          , Re          , Uu          , Uu          , Wo          , Rr          , Rr          , Uu          , Uu          , Uu          , Uu^Uf       , Uu^Uf       , Uu          , Uu^Uf       , Uu^Uf       , Xu          , Xu          
Xu          , Xu          , Xu          , Uu          , Uu          , Uu          , Rr          , Rr          , Cud         , Uu          , Uu          , Uu          , Md          , Mm          , Uu          , Uu          , Uu          , Uu          , Uu          , Uu^Uf       , Uu          , Uu          , Uu          , Uu          , Md          , Md          , Mm          , Uu          , Cud         , Ww^Bw/      , Cud         , Cud         , Cud         , Uu          , Uu          , Uu^Vu       , Uu          , Uu          , Uu^Vud      , Uu^Uf       , Xu          , Xu          
Xu          , Xu          , Xu          , Uu^Vu       , Uu          , Cud         , Rr          , Rr          , Uu          , Uu          , Uh          , Uu          , Uu          , Uu          , Uu          , Uu          , Cud         , Uu          , Re          , Uu          , Uh          , Uu          , Uu          , Uu          , Uu          , Md          , Uu          , Uu          , Wo          , Wo          , Cud         , 5 Kud       , Cud         , Uu          , Uu          , Uu          , Uu          , Uu          , Uu^Uf       , Uu^Uf       , Xu          , Xu          
Xu          , Xu          , Xu          , Uu          , Uu          , Uh          , Rr          , Rr          , Uu          , Uu          , Uu^Uf       , Uu^Uf       , Uu          , Uu          , Cud         , Cud         , Re          , Re          , Uu^Vud      , Mm          , Md          , Uh          , Uu^Vud      , Uu          , Uu          , Uu          , Uu          , Wo          , Rr          , Rr          , Rr          , Cud         , Rr          , Rr          , Rr          , Uu          , Uu          , Uu          , Xu          , Xu          , Xu          , Xu          
Xu          , Xu          , Xu          , Uh          , Uh          , Rr          , Md          , Mm          , Mm          , Uu          , Uu          , Uh          , Uu          , Uu          , Re          , Re          , Md          , Re          , Mm          , Mm          , Mm          , Md          , Md          , Uu          , Uu          , Uu          , Uu          , Wo          , Rr          , Rr          , Uu          , Uu          , Uu          , Rr          , Rr          , Rr          , Rr          , Cud         , Xu          , Xu          , Xu          , Xu          
Xu          , Xu          , Uu          , Uh          , Uu^Vu       , Rr          , Md          , Md          , Md          , Uu          , Uh          , Uu          , Uu          , Uu          , Re          , Md          , Mm          , Mm          , Mm          , Md          , Mm          , Md          , Mm          , Md          , Wo          , Uu          , Wo          , Wo          , Rr          , Cud         , Xu          , Xu          , Uu^Uf       , Uu          , Uu          , Rr          , Rr          , Rr          , Xu          , Xu          , Xu          , Xu          
Xu          , Xu          , Uu^Vud      , Uu          , Uu          , Rr          , Cud         , Re          , Rr          , Uu          , Rr          , Cud         , Rr          , Uu          , Re          , Uu^Vu       , Re          , Mm          , Re          , Md          , Re          , Mm          , Mm          , Md          , Md          , Wo          , Rr          , Rr          , Md          , Mm          , Xu          , Xu          , Uh          , Uu          , Uu          , Cud         , Rr          , Rr          , Rr          , Xu          , Uh          , Uh          
Xu          , Xu          , Uu^Vud      , Uu          , Uu          , Cud         , 3 Kud       , Cud         , Rr          , Rr          , Rr          , Rr          , Rr          , Rr          , Rr          , Re          , Re          , Re          , Mm          , Mm          , Mm          , Uu^Vu       , Mm          , Mm          , Md          , Wo          , Rr          , Rr          , Re          , Mm          , Xu          , Xu          , Uu^Uf       , Uu^Uf       , Uu          , Uu          , Uu          , Rr          , Rr          , Rr          , Rr          , Rr          
Xu          , Xu          , Uu^Vud      , Uu          , Uu          , Cud         , Cud         , Cud         , Uu          , Uu^Vu       , Uu          , Cud         , Uu          , Uh          , Uh          , Re          , Uu^Vu       , Mm          , Md          , Mm          , Md          , Re          , Re          , Mm          , Cud         , Wo          , Rr          , Rr          , Re          , Xu          , Xu          , Xu          , Uu^Uf       , Uu^Uf       , Uu^Uf       , Uu          , Uu          , Cud         , Cud         , Rr          , Rr          , Rr          
Xu          , Xu          , Xu          , Uu          , Uu          , Rr          , Rr          , Rr          , Uu          , Uu          , Uu          , Uu          , Re          , Uu          , Uh          , Uu          , Md          , Mm          , Re          , Md          , Md          , Re          , Re          , Md          , Rr          , Ww^Bw/      , Cud         , Rr          , Xu          , Xu          , Xu          , Uu^Uf       , Uu          , Uu^Uf       , Uu^Uf       , Uu          , Uu          , Cud         , Rr          , Rr          , Rr          , Rr          
Xu          , Xu          , Xu          , Uu          , Uh          , Uu^Vu       , Rd          , Uu^Vu       , Uh          , Uu^Uf       , Md          , Md          , Re          , Uu          , Uu          , Uu          , Re          , Mm          , Re          , Uu^Vud      , Uu          , Uu          , Uu          , Rr          , Uh          , Wo          , Rr          , Rr          , Xu          , Xu          , Xu          , Uu^Uf       , Uu          , Uu^Uf       , Uu          , Uu          , Rr          , Rr          , Rr          , Rr          , Rr          , Rr          
Xu          , Xu          , Uu          , Uu          , Uu          , Uh          , Rd          , Uu          , Uu          , Uu          , Xu          , Xu          , Uu          , Uh          , Uh          , Uu          , Uu          , Uu          , Uu          , Uu          , Uu          , Uu          , Uu          , Uu          , Uh          , Wo          , Rr          , Rr          , Xu          , Xu          , Mm          , Uu^Uf       , Uu          , Cud         , Rr          , Rr          , Rr          , Rr          , Uu          , Uu          , Xu          , Xu          
Xu          , Xu          , Uu^Vu       , Uu          , Uu          , Uu          , Rd          , Uu          , Uu          , Uu          , Xu          , Xu          , Uu          , Uh          , Uh          , Uh          , Uu          , Uu          , Uu^Uf       , Uu          , Uh          , Uu          , Uu          , Uh          , Uh          , Wo          , Rr          , Rr          , Uu          , Mm          , Md          , Uh          , Rr          , Rr          , Rr          , Rr          , Uu          , Uu          , Xu          , Xu          , Xu          , Xu          
Xu          , Xu          , Uu^Uf       , Uu^Uf       , Uu          , Uu          , Re          , Chr         , Uu          , Uu^Uf       , Xu          , Xu          , Uh          , Uu          , Uu          , Uu          , Uu          , Uu^Uf       , Uu^Uf       , Uu^Uf       , Uu^Uf       , Uh          , Uu          , Uu          , Uu          , Wo          , Rr          , Rr          , Cud         , Uu          , Rr          , Rr          , Rr          , Rr          , Uu          , Cud         , Xu          , Xu          , Xu          , Xu          , Xu          , Xu          
Xu          , Xu          , Xu          , Uu^Uf       , Uu          , Uu          , Re          , Uu          , Uh          , Uu^Uf       , Xu          , Xu          , Xu          , Uh          , Uu^Vud      , Uu          , Uh          , Uu^Uf       , Uu^Uf       , Uu^Uf       , Mm          , Uu          , Uu          , Uu          , Uu          , Wo          , Wo          , Rr          , Rr          , Rr          , Rr          , Rr          , Uu          , Uh          , Xu          , Xu          , Xu          , Xu          , Rr          , Uh          , Xu          , Xu          
Xu          , Xu          , Uu^Vu       , Uu          , Uu          , Uu          , Re          , Uu          , Uh          , Uu^Vu       , Xu          , Xu          , Xu          , Xu          , Xu          , Xu          , Xu          , Uu^Uf       , Xu          , Md          , Md          , Uu          , Uu          , Uu          , Uu          , Wo          , Cud         , Cud         , Cud         , Rr          , Cud         , Uu          , Uu          , Xu          , Xu          , Xu          , Rr          , Rr          , Rr          , Rr          , Xu          , Xu          
Xu          , Xu          , Uh          , Uh          , Uh          , Uu          , Uu          , Uu          , Uu          , Xu          , Xu          , Xu          , Xu          , Xu          , Xu          , Xu          , Xu          , Xu          , Uu          , Cud         , Cud         , Cud         , Uu          , Uu          , Uu          , Wo          , Cud         , 4 Kud       , Cud         , Rr          , Rr          , Uu          , Cud         , Cud         , Rr          , Rr          , Uu          , Uu^Vud      , Uu          , Rr          , Xu          , Xu          
Xu          , Xu          , Uu          , Uu          , Uu          , Uu          , Re          , Uu          , Uu          , Xu          , Xu          , Xu          , Xu          , Xu          , Xu          , Xu          , Uh          , Uh          , Uu          , Uu          , Uu          , Uu          , Uu          , Uu          , Rr          , Rr          , Rr          , Cud         , Uu          , Rr          , Rr          , Rr          , Rr          , Rr          , Uu          , Uu          , Uh          , Uh          , Uu^Vud      , Rr          , Xu          , Xu          
Xu          , Xu          , Uu          , Uu          , Uu          , Chr         , Re          , Uu          , Uu          , Xu          , Xu          , Xu          , Xu          , Xu          , Xu          , Xu          , Uu          , Uu          , Uu          , Uu          , Uu          , Uu          , Rd          , Re          , Uu          , Uu          , Uu          , Uu          , Uu          , Cud         , Cud         , Rr          , Rr          , Rr          , Uu          , Uu^Vud      , Uh          , Uh          , Uu          , Rr          , Xu          , Xu          
Xu          , Xu          , Uu          , Uu          , Uu^Ii       , Chr         , Rd          , Uu^Ii       , Xu          , Xu          , Xu          , Xu          , Uu^Vu       , Xu          , Uu          , Uu          , Uu          , Uu          , Rd          , Rd          , Rd          , Rd          , Uu          , Uu          , Uh          , Uu          , Uu          , Uu          , Uu          , Cud         , Xu          , Xu          , Rr          , Rr          , Rr          , Uu          , Uh          , Uh          , Uh          , Rr          , Xu          , Xu          
Xu          , Xu          , Xu          , Uu^Vu       , Ce          , Uu^Ii       , Uu^Ii       , Uu^Ii       , Uu^Vu       , Uu          , Uu          , Uu          , Uu          , Uu          , Uu          , Uu          , Uu          , Ch          , Re          , Re          , Uu          , Uu          , Uu          , Uu^Vu       , Chr         , Chr         , Uu^Vu       , Uu          , Xu          , Xu          , Rr          , Rr          , Uu^Vud      , Uu          , Rr          , Uh          , Uu          , Uh          , Uu^Vud      , Rr          , Xu          , Xu          
Xu          , Xu          , Xu          , Xu          , Ce          , Ce          , Uu^Ii       , Uu^Ii       , Uu^Ii       , Uu          , Uu          , Uu          , Re          , Uu          , Uu          , Uu          , Re          , Re          , Uu          , Uu          , Uu          , Uu          , Uu          , Uh          , Uu^Vu       , Chr         , Xu          , Xu          , Xu          , Rr          , Uu          , Uu          , Uh          , Uh          , Uh          , Rr          , Rr          , Uu          , Uu          , Rr          , Xu          , Xu          
Xu          , Xu          , Gg          , Ce          , 1 Ke        , Ce          , Ce          , Uu^Ii       , Uu^Ii       , Uu          , Uu          , Re          , Chr         , Re          , Uu          , Uu          , Uu          , Uu          , Uh          , Uu          , Uu          , Uu          , Uu          , Chr         , Xu          , Xu          , Xu          , Xu          , Rr          , Rr          , Uu^Vud      , Uh          , Uh          , Uh          , Uu^Vud      , Uh          , Uu          , Rr          , Rr          , Rr          , Xu          , Xu          
Gg          , Gg^Vh       , Gg          , Ce          , Ce          , Ce          , Xu          , Xu          , Uu^Vu       , Uu          , Uu          , Uu          , Uu          , Chr         , Uu          , Uu          , Uu          , Uu          , Uh          , Uh          , Uu^Vu       , Uu          , Xu          , Xu          , Xu          , Xu          , Xu          , Rr          , Rr          , Uu          , Rr          , Uu          , Rr          , Uu          , Rr          , Uu          , Rr          , Uu^Vud      , Rr          , Rr          , Xu          , Xu          
Gg          , Gg          , Gg^Vh       , Gg          , Gg^Vh       , Xu          , Xu          , Xu          , Xu          , Xu          , Xu          , Xu          , Xu          , Xu          , Xu          , Xu          , Xu          , Xu          , Xu          , Xu          , Xu          , Xu          , Xu          , Xu          , Xu          , Xu          , Xu          , Rr          , Xu          , Rr          , Xu          , Rr          , Xu          , Rr          , Xu          , Rr          , Xu          , Rr          , Xu          , Xu          , Xu          , Xu          
Gg          , Gg          , Gg          , Gg          , Gg          , Xu          , Xu          , Xu          , Xu          , Xu          , Xu          , Xu          , Xu          , Xu          , Xu          , Xu          , Xu          , Xu          , Xu          , Xu          , Xu          , Xu          , Xu          , Xu          , Xu          , Xu          , Xu          , Xu          , Xu          , Xu          , Xu          , Xu          , Xu          , Xu          , Xu          , Xu          , Xu          , Xu          , Xu          , Xu          , Xu          , Xu          
