Hh          , Hh          , Hh          , Mm          , Hh          , Mm          , Mm          , Mm          , Hh^Vhh      , Hh          , Hh          , Hh          , Chr         , Chr         , Chr         , Chr         , Chr         , Mm          , Ww          , Ww          , Wo          , Wo          , Wo          , Wo          , Ww          , Ww          , Ds          , Ce          , Ce          , Ce          
Mm          , Mm          , Mm          , Mm          , Mm          , Mm          , Mm          , Mm          , Mm          , Mm          , Mm          , Mm          , Hh          , Chr         , 7 Kh        , Chr         , Mm          , Mm          , Mm          , Ww          , Ww          , Ww          , Ww          , Ww          , Ww          , Ww          , Gs^Fp       , Ce          , 1 Ke        , Ce          
Mm          , Mm^Vhh      , Mm          , Mm          , Mm          , Mm          , Mm          , Mm          , Mm          , Mm          , Mm          , Mm          , Mm          , Mm          , Chr         , Re          , Mm          , Hh          , Hh          , Ds          , Ww          , Ds          , Ds          , Gs^Fp       , Gs^Fp       , Wwf         , Re          , Re          , Ce          , Ce          
Mm          , Mm          , Mm          , Mm          , Mm          , Mm          , Mm          , Mm          , Mm          , Mm          , Mm^Vhh      , Mm          , Mm          , Mm          , Mm          , Hh          , Re          , Re          , Re^Gvs      , Re^Gvs      , Ww          , Gg^Vh       , Gg          , Re          , Re          , Gs^Fp       , Ww          , Ss          , Gs^Fp       , Gs^Fp       
Mm          , Mm          , Mm          , Mm          , Mm          , Mm          , Mm          , Hh          , Mm          , Mm          , Mm          , Mm          , Mm          , Mm          , Mm          , Hh          , Hh          , Gg          , Re          , Re          , Ww          , Re          , Re          , Gg          , Gs^Fp       , Gs^Fp       , Gs^Fp       , Ss          , Gs^Fp       , Gg^Ve       
Mm          , Hh          , Hh          , Hh          , Hh          , Hh          , Hh          , Hh          , Mm          , Mm          , Mm          , Mm          , Mm          , Hh^Vhh      , Mm          , Hh          , Gg^Vh       , Ggf         , Gg          , Re          , Ww          , Re          , Gg          , Gs^Fp       , Gg^Vh       , Gs^Fp       , Gs^Fp       , Ss          , Gs^Fp       , Gs^Fp       
Hh          , Hh          , Hh          , Mm          , Hh          , Hh          , Ggf         , Gg^Vh       , Hh          , Mm          , Mm          , Mm          , Mm          , Mm          , Mm          , Mm          , Mm          , Mm          , Re^Gvs      , Re          , Wwf         , Ww          , Gs^Fp       , Gs^Fp       , Gs^Fp       , Gs^Fp       , Gs^Fp       , Gs^Fp       , Ss          , Ww          
Mm          , Mm          , Mm          , Mm          , Mm          , Hh          , Hh          , Hh          , Hh          , Hh          , Mm          , Mm          , Mm          , Mm          , Mm          , Mm          , Mm          , Mm          , Re^Gvs      , Re^Gvs      , Re          , Ww          , Gs^Fp       , Gg^Fet      , Gg^Fet      , Gs^Fp       , Gs^Fp       , Gs^Fp       , Gs^Fp       , Ww          
Mm          , Mm          , Mm          , Mm          , Mm          , Mm          , Mm          , Mm          , Mm          , Mm          , Mm          , Mm          , Mm          , Mm          , Mm          , Mm          , Mm          , Mm          , Gg^Vh       , Re          , Re          , Ww          , Gs^Fp       , Gs^Fp       , Gs^Fp       , Gg^Ve       , Gs^Fp       , Gs^Fp       , Ss          , Hh          
Mm          , Mm          , Mm          , Mm          , Mm          , Mm          , Mm          , Mm          , Mm          , Mm          , Mm          , Mm          , Mm          , Mm          , Mm          , Mm          , Mm          , Hh          , Re          , Re          , Re^Gvs      , Ww          , Gs^Fp       , Gs^Fp       , Gs^Fp       , Gs^Fp       , Gs^Fp       , Ww          , Ww          , Mm          
Mm          , Mm          , Mm          , Hh^Vhh      , Mm          , Mm          , Mm          , Mm          , Mm          , Mm          , Mm          , Ch          , Mm          , Ch          , Mm          , Hh          , Hh          , Re^Gvs      , Re          , Re^Gvs      , Gs^Fp       , Gs^Fp       , Ww          , Ss          , Gs^Fp       , Gs^Fp       , Gs^Fp       , Ww          , Mm          , Mm^Vhh      
Mm          , Mm          , Mm          , Mm          , Mm          , Mm          , Mm          , Mm          , Mm          , Ch          , Ch          , Re          , 3 Kh        , Re          , Ch          , Ch          , Re^Gvs      , Re          , Re          , Re^Gvs      , Gs^Fp       , Gs^Fp       , Gs^Fp       , Ss          , Gs^Fp       , Gs^Fp       , Gs^Fp       , Ss          , Hh          , Hh          
Mm          , Mm          , Mm          , Mm          , Mm          , Mm          , Mm          , Re^Gvs      , Ch          , Re          , Re          , Gg^Vh       , Ch          , Gg^Vh       , Re          , Re          , Ch          , Re          , Re^Gvs      , Gg^Vh       , Gs^Fp       , Ss          , Ss          , Gs^Fp       , Gs^Fp       , Gs^Fp       , Gs^Fp       , Ss          , Gs^Fp       , Hh          
Mm          , Mm          , Mm          , Mm          , Mm          , Mm          , Re^Gvs      , Re^Gvs      , Ch          , Re          , Gg^Vh       , Ch          , Ch          , Ch          , Gg^Vh       , Re          , Ch          , Re^Gvs      , Re^Gvs      , Gs^Fp       , Gs^Fp       , Ss          , Gs^Fp       , Gs^Fp       , Gg^Ve       , Ww          , Ss          , Gs^Fp       , Gs^Fp       , Hh          
Mm          , Mm          , Mm          , Mm          , Mm          , Re^Gvs      , Re^Gvs      , Re^Gvs      , Ch          , Ch          , Gg^Vh       , Ch          , Ch          , Ch          , Gg^Vh       , Ch          , Ch          , Re^Gvs      , Ggf         , Gs^Fp       , Gs^Fp       , Ss          , Gs^Fp       , Gs^Fp       , Ss          , Ss          , Gs^Fp       , Gs^Fp       , Hh          , Mm          
Mm          , Mm          , Mm          , Gg^Vh       , Re^Gvs      , Re^Gvs      , Re^Gvs      , Re^Gvs      , 6 Kh        , Ch          , Ch          , Ch          , 2 Kh        , Ch          , Ch          , Ch          , 4 Kh        , Re^Gvs      , Re^Gvs      , Ww          , Ss          , Gs^Fp       , Gs^Fp       , Gs^Fp       , Gs^Fp       , Gs^Fp       , Ss          , Ww          , Mm          , Mm          
Mm          , Mm          , Mm          , Gg^Vh       , Gg^Vh       , Re^Gvs      , Re^Gvs      , Re^Gvs      , Ch          , Re          , Gg^Vh       , Ch          , Ch          , Ch          , Gg^Vh       , Re          , Ch          , Re^Gvs      , Ww          , Gs^Fp       , Gs^Fp       , Gs^Fp       , Gg^Fet      , Gs^Fp       , Gs^Fp       , Ww          , Ww          , Hh          , Mm          , Mm          
Mm          , Mm          , Mm          , Mm          , Mm          , Mm          , Mm          , Mm          , Ch          , Re          , Gg^Vh       , Gg^Vh       , Ch          , Gg^Vh       , Gg^Vh       , Re          , Ch          , Re^Gvs      , Ww          , Gs^Fp       , Gs^Fp       , Gs^Fp       , Gs^Fp       , Gs^Fp       , Gs^Fp       , Ww          , Hh          , Mm          , Mm          , Mm^Vhh      
Mm          , Mm          , Mm          , Hh          , Hh          , Hh          , Mm          , Mm          , Ch          , Ch          , Re          , Re          , Ch          , Re          , Re          , Ch          , Ch          , Gs^Fp       , Ww          , Gs^Fp       , Gs^Fp       , Gs^Fp       , Gg^Ve       , Gs^Fp       , Gs^Fp       , Ss          , Mm          , Hh          , Mm          , Mm          
Mm          , Mm          , Mm          , Mm          , Hh          , Hh          , Mm          , Mm          , Re^Gvs      , Re^Gvs      , Ch          , Ch          , 5 Kh        , Ch          , Ch          , Re^Gvs      , Gs^Fp       , Ww          , Ww          , Gs^Fp       , Gs^Fp       , Gs^Fp       , Gs^Fp       , Gs^Fp       , Gs^Fp       , Ss          , Gs^Fp       , Hh          , Mm          , Mm          
Mm          , Mm          , Mm          , Mm          , Mm          , Mm          , Mm          , Mm          , Re^Gvs      , Re^Gvs      , Re^Gvs      , Re^Gvs      , Re          , Re^Gvs      , Re^Gvs      , Ww          , Ww          , Gs^Fp       , Gs^Fp       , Gs^Fp       , Gs^Fp       , Gs^Fp       , Gs^Fp       , Gs^Fp       , Gs^Fp       , Ss          , Gs^Fp       , Hh          , Mm          , Mm          
Hh          , Hh          , Hh^Vhh      , Mm          , Mm          , Mm          , Mm          , Mm          , Mm          , Re^Gvs      , Re^Gvs      , Re          , Re          , Gs^Fp       , Gs^Fp       , Ww          , Gs^Fp       , Gs^Fp       , Gs^Fp       , Gg          , Gs^Fp       , Gg^Fet      , Gs^Fp       , Gs^Fp       , Gs^Fp       , Gs^Fp       , Ww          , Gs^Fp       , Mm          , Gs^Fp       
Hh          , Hh          , Mm          , Mm          , Mm          , Mm          , Mm          , Mm          , Mm          , Gg^Vh       , Re^Gvs      , Re          , Re^Gvs      , Gs^Fp       , Gs^Fp       , Gs^Fp       , Ww          , Ss          , Gs^Fp       , Gs^Fp       , Gs^Fp       , Gs^Fp       , Gs^Fp       , Gg^Fet      , Gs^Fp       , Gs^Fp       , Ww          , Ww          , Gs^Fp       , Ww          
Hh          , Mm          , Mm          , Mm          , Mm          , Mm          , Mm          , Mm          , Mm          , Re^Gvs      , Re^Gvs      , Re          , Re^Gvs      , Gs^Fp       , Gs^Fp       , Gs^Fp       , Gs^Fp       , Ss          , Gs^Fp       , Gs^Fp       , Gs^Fp       , Gs^Fp       , Gs^Fp       , Gs^Fp       , Ss          , Ww          , Ww          , Mm          , Ww          , Mm          
Mm          , Mm          , Mm          , Hh          , Mm          , Mm          , Mm          , Hh          , Hh          , Re^Gvs      , Re          , Re          , Re^Gvs      , Re^Gvs      , Gs^Fp       , Gg          , Gs^Fp       , Ss          , Ss          , Gs^Fp       , Gs^Fp       , Gs^Fp       , Gs^Fp       , Ww          , Ww          , Hh          , Hh          , Mm          , Mm          , Mm          
Mm          , Mm          , Mm          , Mm          , Mm          , Mm          , Mm          , Hh          , Hh          , Re^Gvs      , Re^Gvs      , Re          , Gg^Vh       , Re^Gvs      , Re^Gvs      , Gs^Fp       , Gs^Fp       , Ss          , Gs^Fp       , Gs^Fp       , Gg^Ve       , Gs^Fp       , Gs^Fp       , Ss          , Hh          , Mm          , Mm^Vhh      , Mm          , Mm          , Mm          
Mm          , Mm          , Mm^Vhh      , Mm          , Mm          , Mm          , Mm          , Mm          , Hh          , Hh          , Re          , Re          , Re^Gvs      , Re^Gvs      , Gg          , Gs^Fp       , Gs^Fp       , Ss          , Gs^Fp       , Gs^Fp       , Gs^Fp       , Gs^Fp       , Gs^Fp       , Ss          , Hh          , Mm          , Mm          , Mm          , Mm          , Mm          
Hh          , Mm          , Mm          , Mm          , Mm          , Mm          , Mm          , Mm          , Hh          , Mm          , Gg^Vh       , Re          , Re^Gvs      , Re^Gvs      , Re^Gvs      , Gs^Fp       , Gg^Fet      , Gs^Fp       , Ww          , Ww          , Ss          , Ss          , Ss          , Ss          , Gs^Fp       , Gs^Fp       , Hh          , Mm          , Mm          , Mm          
Mm          , Mm          , Mm          , Mm          , Mm          , Hh^Vhh      , Mm          , Mm          , Mm          , Mm          , Mm          , Mm          , Re          , Re^Gvs      , Re^Gvs      , Gs^Fp       , Gs^Fp       , Ww          , Ww          , Hh          , Hh          , Hh          , Hh          , Hh          , Ww          , Gs^Fp       , Hh          , Mm          , Mm          , Mm^Vhh      
Mm          , Mm          , Mm          , Mm          , Mm          , Mm          , Mm          , Mm          , Mm          , Mm          , Mm          , Mm          , Re          , Re^Gvs      , Gg^Vh       , Ww          , Ww          , Ww          , Gs^Fp       , Gs^Fp       , Hh          , Mm          , Mm^Vhh      , Mm          , Ww          , Gs^Fp       , Hh          , Hh          , Mm          , Mm          
