Mm          , Mm          , Mm          , Mm          , Mm          , Mm          , Mm          , Mm          , Mm          , Mm          , Mm          , Mm          , Mm          , Mm          , Mm          , Mm          , Mm          , Mm          , Mm          , Mm          , Mm          , Mm          , Mm          , Mm          , Mm          , Mm          , Mm          , Mm          , Mm          , Mm          , Mm          , Mm          , Mm^Vhh      , Mm          , Mm          , Mm          , Mm          , Mm          , Mm          , Mm          
Mm          , Mm          , Mm^Vhh      , Mm          , Mm          , Mm          , Mm          , Mm          , Mm          , Mm          , Mm          , Mm          , Mm          , Mm          , Mm          , Mm          , Mm          , Mm          , Mm          , Mm          , Mm          , Mm          , Mm          , Mm          , Mm          , Mm          , Mm^Vhh      , Mm          , Mm          , Mm          , Mm^Vhh      , Mm          , Mm          , Mm          , Mm^Vhh      , Mm          , Mm          , Mm          , Mm          , Mm          
Mm          , Mm          , Mm          , Mm          , Mm          , Mm          , Mm          , Mm          , Mm          , Mm          , Mm          , Mm          , Mm          , Mm          , Mm          , Mm          , Mm          , Mm          , Mm          , Mm          , Mm          , Mm          , Mm          , Mm          , Mm          , Mm^Vhh      , Mm          , Mm^Vhh      , Mm          , Mm^Vhh      , Mm          , Mm          , Mm^Vhh      , Mm          , Mm          , Mm          , Mm          , Mm          , Mm          , Mm          
Mm          , Mm          , Mm^Vhh      , Mm          , Mm          , Mm          , Mm          , Mm          , Mm          , Mm^Vhh      , Mm          , Mm          , Mm          , Mm          , Mm^Vhh      , Mm          , Mm          , Mm          , Mm          , Mm          , Mm          , Mm          , Mm          , Mm          , Mm          , Mm          , Mm          , Mm          , Mm          , Mm          , Mm          , Mm^Vhh      , Mm          , Mm          , Mm          , Mm          , Mm          , Mm          , Mm          , Mm          
Mm          , Mm          , Mm          , Mm          , Mm          , Mm          , Mm          , Mm^Vhh      , Mm          , Mm          , Mm          , Mm          , Mm          , Mm          , Mm          , Mm          , Mm^Vhh      , Mm          , Mm          , Mm          , Mm          , Mm          , Mm          , Mm          , Mm          , Mm          , Mm^Vhh      , Mm          , Mm          , Ce          , Mm          , Mm          , Mm          , Mm          , Gs^Fp       , Gs^Fp       , Mm          , Gs^Fp       , Mm          , Mm          
Mm          , Mm          , Mm^Vhh      , Mm          , Mm          , Mm          , Mm          , Mm          , Mm          , Mm          , Mm          , Mm^Vhh      , Mm          , Mm          , Mm          , Mm          , Mm          , Mm          , Mm^Vhh      , Mm          , Mm          , Mm          , Mm          , Mm          , Mm          , Mm          , Mm          , Mm          , Ce          , 7 Ke        , Ce          , Ce          , Mm          , Gs^Fp       , Gs^Fp       , Gs^Fp       , Gs^Fp       , Gs^Fp       , Gs^Fp       , Mm          
Mm          , Mm          , Mm          , Hh          , Hh          , Hh          , Mm          , Mm          , Mm          , Mm          , Mm          , Mm          , Mm          , Mm          , Mm          , Mm          , Mm          , Mm          , Mm          , Mm          , Mm          , Mm          , Mm          , Mm          , Mm          , Mm          , Mm^Vhh      , Mm          , Ce          , Ce          , Ce          , Ce          , Gs^Fp       , Gg          , Gs^Fp       , Gg          , Gs^Fp       , Gg^Vh       , Gg          , Gg          
Hh          , Mm          , Hh          , Hh          , Hh          , Ch          , Kh          , Ch          , Mm          , Hh          , Hh          , Mm          , Mm^Vhh      , Mm          , Mm          , Mm          , Mm          , Mm          , Mm^Vhh      , Mm          , Mm          , Mm          , Mm          , Mm          , Mm          , Gg^Ve       , Mm          , Hh          , Mm          , Hh          , Ce          , Gg          , Gs^Fp       , Gg          , Gg^Vh       , Gg          , Gg          , Gg          , Gg          , Gg          
Hh          , Hh          , Hh          , Ch          , Ch          , Gg^Vh       , Ch          , Gg^Vh       , Ch          , Ch          , Hh          , Mm          , Mm          , Mm          , Mm          , Mm          , Mm          , Mm          , Mm          , Mm          , Mm^Vhh      , Mm          , Gs^Fp       , Gs^Fp       , Gs^Fp       , Gs^Fp       , Hh          , Hh          , Hh          , Gg          , Gg          , Gg^Vh       , Gg          , Ce          , Gg          , Gg          , Gg^Vh       , Re          , Gg^Vh       , Gg^Vh       
Gg          , Ch          , Ch          , Re          , Re          , Ch          , Ch          , Ch          , Hh          , Re          , Ch          , Ch          , Gs^Fp       , Gs^Fp       , Mm          , Mm          , Mm          , Mm          , Mm          , Mm          , Mm          , Gs^Fp       , Gs^Fp       , Gg^Ve       , Gs^Fp       , Gs^Fp       , Gs^Fp       , Gg          , Gg          , Gg          , Gg          , Gg          , Ce          , Ce          , Ce          , Re          , Re          , Gg^Vh       , Re          , Gg          
Ch          , Gg^Vh       , Kh          , Ch          , Ch          , Ch          , 3 Kh        , Ch          , Ch          , Ch          , Gg^Vh       , Kh          , Ch          , Gs^Fp       , Gs^Fp       , Gs^Fp       , Mm          , Mm          , Mm          , Mm          , Hh          , Gs^Fp       , Gs^Fp       , Gs^Fp       , Gs^Fp       , Gg          , Gs^Fp       , Gg          , Gg          , Gg          , Gg^Vh       , Re          , Ce          , 1 Ke        , Ce          , Gs^Fp       , Gg          , Ds          , Gg          , Ww          
Gg^Vh       , Gg^Vh       , Ch          , Ch          , Ch          , Gg          , Gg^Vh       , Gg          , Ch          , Ch          , Ch          , Gg^Vh       , Ch          , Gs^Fp       , Gs^Fp       , Gs^Fp       , Mm          , Mm          , Mm          , Hh          , Hh          , Gg          , Gg          , Gg          , Gg          , Gg          , Gg          , Gg          , Gg          , Re          , Re          , Gg          , Ce          , Ce          , Ce          , Ww          , Gs^Fp       , Ww          , Ww          , Ww          
Gg^Vh       , Gg^Vh       , Ch          , 6 Kh        , Gg          , Ch          , Ch          , Ch          , Gg          , 5 Kh        , Ch          , Re          , Ch          , Gg          , Gs^Fp       , Gs^Fp       , Hh          , Hh          , Hh          , Hh          , Gg          , Gg          , Gg^Vh       , Gg          , Gg          , Re          , Gg          , Re          , Re          , Gg          , Gg^Vh       , Gs^Fp       , Gs^Fp       , Ww          , Ww          , Ww          , Ww          , Gs^Fp       , Ds          , Ds          
Gg^Vh       , Gg^Vh       , Re          , Kh          , Gg^Vh       , Ch          , 2 Kh        , Ch          , Gg^Vh       , Kh          , Re          , Re          , Re          , Gg          , Gg          , Re          , Re          , Re          , Gg          , Re          , Gg          , Re          , Re          , Re          , Re          , Gg^Vh       , Re          , Gg          , Gg          , Gg          , Gg          , Ds          , Ds          , Ww          , Ww          , Gs^Fp       , Gg^Ve       , Gs^Fp       , Gs^Fp       , Gs^Fp       
Gg^Vh       , Gg^Vh       , Ch          , Ch          , Gg          , Gg          , Ch          , Gg          , Gg          , Ch          , Ch          , Gg^Vh       , Ch          , Re          , Re          , Ww          , Ww          , Ww          , Re          , Ww          , Re          , Ds          , Gg          , Gg          , Gg          , Gg          , Gg          , Ww          , Ds          , Ww          , Ww          , Ww          , Ww          , Ds          , Gg^Ve       , Gs^Fp       , Gs^Fp       , Gs^Fp       , Gg^Ve       , Ww          
Gg^Vh       , Hh          , Ch          , Ch          , Ch          , Ch          , Gg^Vh       , Ch          , Ch          , Ch          , Ch          , Kh          , Ch          , Ww          , Ww          , Ww          , Ww          , Ww          , Ww          , Gs^Fp       , Ww          , Ww          , Ds          , Ww          , Ds          , Ww          , Ds          , Ww          , Ww          , Ww          , Ww          , Ww          , Ww          , Ww          , Gs^Fp       , Ww          , Gg^Ve       , Ww          , Ww          , Ww          
Ch          , Ch          , Kh          , Re          , Ch          , Ch          , 4 Kh        , Ch          , Ch          , Re          , Gg^Vh       , Ch          , Ch          , Ww          , Ww          , Ww          , Ds          , Gs^Fp       , Gs^Fp       , Gs^Fp       , Gs^Fp       , Ww          , Ww          , Ww          , Ww          , Ds          , Ww          , Gs^Fp       , Ww          , Gs^Fp       , Ww          , Gg^Ve       , Ds          , Ds          , Ww          , Ds          , Ww          , Gs^Fp       , Gs^Fp       , Gs^Fp       
Mm          , Mm          , Ch          , Ch          , Re          , Gg^Vh       , Ch          , Gg^Vh       , Re          , Ch          , Ch          , Ww          , Ww          , Ww          , Ww          , Gg          , Gg          , Gs^Fp       , Gs^Fp       , Gg^Ve       , Ww          , Ds          , Ds          , Ww          , Ww          , Gg^Ve       , Gs^Fp       , Gs^Fp       , Gs^Fp       , Gs^Fp       , Gs^Fp       , Gs^Fp       , Gs^Fp       , Gs^Fp       , Gs^Fp       , Gs^Fp       , Gs^Fp       , Gs^Fp       , Gs^Fp       , Hh          
Mm          , Mm          , Mm          , Mm          , Ch          , Ch          , Ch          , Ch          , Ch          , Re          , Re          , Ww          , Ww          , Ww          , Gg^Ve       , Gs^Fp       , Gs^Fp       , Gs^Fp       , Gs^Fp       , Ww          , Ww          , Ww          , Ww          , Gs^Fp       , Gs^Fp       , Gs^Fp       , Gs^Fp       , Mm          , Gg^Ve       , Mm          , Gs^Fp       , Hh          , Hh          , Mm          , Mm          , Mm          , Hh          , Hh          , Hh          , Mm          
Mm          , Mm          , Gs^Fp       , Gs^Fp       , Mm          , Hh          , Kh          , Re          , Re          , Re          , Re          , Ww          , Ww          , Ds          , Gs^Fp       , Gs^Fp       , Gs^Fp       , Gs^Fp       , Gs^Fp       , Ww          , Ww          , Ds          , Gs^Fp       , Gs^Fp       , Gs^Fp       , Gs^Fp       , Gs^Fp       , Gs^Fp       , Mm          , Mm          , Mm          , Mm          , Mm          , Mm          , Mm          , Mm          , Hh          , Hh          , Hh          , Mm          
Mm          , Gs^Fp       , Gs^Fp       , Gg^Ve       , Mm          , Mm          , Re          , Re          , Re          , Re          , Gg          , Ww          , Ww          , Ds          , Gs^Fp       , Gs^Fp       , Gg^Ve       , Ds          , Ww          , Ww          , Ds          , Gg^Ve       , Gs^Fp       , Gs^Fp       , Gs^Fp       , Mm          , Gs^Fp       , Hh          , Hh          , Hh          , Mm          , Mm          , Mm^Vhh      , Mm          , Mm          , Mm          , Mm          , Mm          , Mm          , Mm          
Mm          , Gs^Fp       , Gs^Fp       , Gs^Fp       , Gs^Fp       , Gg          , Gg          , Re          , Re          , Gg^Vh       , Gg          , Gg          , Ww          , Ww          , Gs^Fp       , Ds          , Ds          , Ww          , Ww          , Ww          , Ds          , Gs^Fp       , Gs^Fp       , Gg^Ve       , Mm          , Mm          , Hh          , Hh          , Hh          , Hh          , Mm          , Mm          , Mm          , Mm          , Mm          , Mm          , Mm          , Mm          , Mm          , Mm          
Mm          , Gs^Fp       , Gs^Fp       , Gs^Fp       , Gg          , Gg          , Gg^Vh       , Re          , Re          , Gg          , Gg          , Gg          , Gg          , Gs^Fp       , Ww          , Ww          , Ww          , Ww          , Ww          , Ww          , Gs^Fp       , Gs^Fp       , Gs^Fp       , Mm          , Mm          , Mm          , Mm^Vhh      , Mm          , Mm          , Mm          , Mm          , Mm          , Mm          , Mm          , Mm          , Mm          , Mm          , Mm^Xm       , Mm^Xm       , Mm^Xm       
Mm          , Gs^Fp       , Gs^Fp       , Gg          , Gg          , Gg          , Re          , Gg          , Gg          , Gg          , Gg          , Gg^Ve       , Gs^Fp       , Gs^Fp       , Ww          , Gs^Fp       , Ww          , Ww          , Ww          , Gs^Fp       , Gg^Ve       , Gs^Fp       , Gs^Fp       , Mm          , Mm          , Mm          , Mm          , Mm          , Mm          , Mm          , Mm          , Mm          , Mm          , Mm          , Mm          , Mm          , Mm          , Mm^Xm       , Mm^Xm       , Mm^Xm       
Mm          , Hh          , Gg^Ve       , Gg          , Gg          , Gg          , Re          , Re          , Gg          , Gg          , Gg          , Gs^Fp       , Gs^Fp       , Ww          , Ww          , Gs^Fp       , Gg          , Ww          , Ww          , Gs^Fp       , Gs^Fp       , Gs^Fp       , Gs^Fp       , Hh          , Hh          , Hh          , Mm          , Mm          , Mm          , Mm          , Mm          , Mm          , Mm          , Mm          , Mm          , Mm          , Mm          , Mm^Xm       , Mm^Xm       , Mm^Xm       
Mm          , Mm          , Hh          , Hh          , Gg          , Gg          , Gg          , Gg          , Re          , Gg          , Gs^Fp       , Gs^Fp       , Ww          , Ww          , Gs^Fp       , Gg^Ve       , Ds          , Ww          , Ww          , Ww          , Ds          , Ds          , Gs^Fp       , Gs^Fp       , Hh          , Hh          , Mm          , Mm          , Mm          , Mm          , Mm          , Mm          , Mm          , Mm          , Mm          , Mm          , Mm          , Mm^Xm       , Mm^Xm       , Mm^Xm       
Mm          , Mm          , Mm          , Mm          , Mm^Vhh      , Mm          , Mm          , Gg          , Re          , Gg^Vh       , Gg          , Gg          , Ww          , Ww          , Ds          , Ww          , Ww          , Ds          , Ww          , Ww          , Ww          , Ds          , Gg^Ve       , Gs^Fp       , Gs^Fp       , Hh          , Mm          , Mm          , Mm          , Mm          , Mm          , Mm          , Mm          , Mm          , Mm          , Mm^Xm       , Mm^Xm       , Mm^Xm       , Mm^Xm       , Mm^Xm       
Mm          , Mm          , Mm          , Mm          , Mm          , Gs^Fp       , Gg          , Gg          , Re          , Gg          , Gg          , Gg          , Ww          , Ds          , Ww          , Gg          , Ww          , Gs^Fp       , Gs^Fp       , Ww          , Ww          , Gs^Fp       , Gs^Fp       , Gs^Fp       , Gs^Fp       , Mm          , Mm^Vhh      , Mm          , Mm          , Mm          , Mm          , Mm          , Mm          , Mm          , Mm          , Mm^Xm       , Mm^Xm       , Mm^Xm       , Mm^Xm       , Mm^Xm       
Mm          , Mm          , Mm          , Mm          , Mm          , Gs^Fp       , Gs^Fp       , Gg          , Re          , Re          , Gg          , Gg^Vh       , Ww          , Ww          , Ww          , Gs^Fp       , Gg^Ve       , Gs^Fp       , Ww          , Ds          , Gg^Ve       , Gs^Fp       , Gs^Fp       , Hh          , Mm          , Mm          , Mm          , Mm          , Mm          , Mm          , Mm          , Mm          , Mm          , Mm^Xm       , Mm          , Mm^Xm       , Mm^Xm       , Mm^Xm       , Mm^Xm       , Mm^Xm       
Mm          , Mm          , Mm^Vhh      , Gs^Fp       , Gs^Fp       , Gs^Fp       , Gg          , Gg^Vh       , Gg          , Re          , Gg          , Gg          , Ww          , Ww          , Ww          , Gs^Fp       , Gs^Fp       , Ww          , Ww          , Gs^Fp       , Gs^Fp       , Gs^Fp       , Gg^Ve       , Hh          , Hh          , Mm          , Mm          , Mm          , Mm          , Mm          , Mm          , Mm          , Mm          , Mm          , Mm^Xm       , Mm^Xm       , Mm^Xm       , Mm^Xm       , Mm^Xm       , Mm^Xm       
