border_size=1
usage=map

Ww          , Ww          , Wo          , Ww          , Ww          , Ww          , Gg          , Ggf         , Gg          , Ggf         , Ggf         , Ggf         , Gs^Fp       , Gs^Fp       , Ce          , Ce          , Ce          , Hh          , Hh          , Mm          , Gs^Fp       , Gs^Fp       , Gs^Fp       , Gs^Fp       , Gg          , Gs^Fp       , Gs^Fp       , Gs^Fp       , Gs^Fp       , Gs^Fp       
Ww          , Ww          , Wo          , Ww          , Ww          , Ww          , Gg          , Ggf         , Gg          , Ggf         , Ggf         , Ggf         , Gs^Fp       , Gs^Fp       , Ce          , Ce          , Ce          , Hh          , Hh          , Mm          , Gs^Fp       , Gs^Fp       , Gs^Fp       , Gs^Fp       , Gg^Ve       , Gs^Fp       , Gs^Fp       , Gs^Fp       , Gs^Fp       , Gs^Fp       
Ww          , Ww          , Ww          , Wo          , Ww          , Ww          , Wwf         , Gg          , Gg          , Gg^Vh       , Gg          , Ggf         , Gs^Fp       , Ce          , Ce          , 1 Ke        , Ce          , Ce          , Gs^Fp       , Gs^Fp       , Mm          , Gs^Fp       , Gs^Fp       , Gs^Fp       , Gs^Fp       , Gs^Fp       , Gg^Fet      , Gs^Fp       , Gg^Ve       , Gg          
Ww          , Ww          , Ww          , Wo          , Wo          , Ww          , Wwf         , Gg          , Gg          , Gg          , Gg          , Gg          , Gg          , Gs^Fp       , Gs^Fp       , Ce          , Gs^Fp       , Gs^Fp       , Gs^Fp       , Mm          , Mm          , Hh          , Gs^Fp       , Gs^Fp       , Gs^Fp       , Gs^Fp       , Gg          , Gs^Fp       , Gs^Fp       , Gs^Fp       
Gg          , Gg          , Gg          , Wwf         , Wwf         , Wwf         , Ww          , Wwf         , Ww          , Gg          , Gg          , Gg          , Gg          , Gs^Fp       , Gs^Fp       , Gs^Fp       , Gs^Fp       , Gs^Fp       , Gs^Fp       , Gg^Fet      , Gs^Fp       , Hh          , Gg^Ve       , Gs^Fp       , Gg          , Gg          , Gg          , Gg          , Gs^Fp       , Gs^Fp       
Gg          , Gg          , Gg          , Gg          , Gg          , Wwf         , Ww          , Ww          , Ww          , Gg          , Gg          , Gg          , Gg          , Ggf         , Gg          , Gs^Fp       , Gg          , Gg^Ve       , Gs^Fp       , Gs^Fp       , Gs^Fp       , Gs^Fp       , Gs^Fp       , Gg          , Gg          , Gg          , Gg          , Gg          , Gs^Fp       , Gs^Fp       
Gg          , Gg^Vc       , Hh          , Gg          , Gg          , Ww          , Ww          , Ww          , Ww          , Ww          , Ww          , Gg          , Gg          , Gg^Vh       , Gg          , Gg          , Gg          , Gs^Fp       , Gs^Fp       , Gs^Fp       , Gg^Fet      , Gs^Fp       , Gg          , Gg          , Gg          , Gs^Fp       , Gs^Fp       , Gg          , Hh          , Hh          
Gg          , Gg          , Gs^Fp       , Hh          , Gg          , Gg          , Hh          , Ww          , Ww          , Ww          , Ww          , Hh          , Gg          , Gg          , Gg          , Gg          , Gg          , Gg          , Ggf         , Gs^Fp       , Gs^Fp       , Gg          , Gg          , Gg          , Gg          , Gs^Fp       , Ggf         , Ggf         , Hh          , Hh          
Ggf         , Ggf         , Ggf         , Hh          , Gg          , Gg          , Hh          , Ww          , Ww          , Ww          , Wo          , Hh          , Gg          , Gg          , Gg          , Gg          , Gg          , Gg          , Ggf         , Gs^Fp       , Gg          , Gg          , Gg          , Gg          , Ggf         , Ggf         , Gg^Vh       , Gg          , Hh          , Hh          
Gg          , Gg          , Ggf         , Gg          , Gg          , Gg          , Hh          , Ww          , Hh          , Hh          , Wo          , Hh          , Wo          , Gg          , Ch          , Gg          , Gg          , Gg          , Gg          , Gg          , Gg          , Gg          , Gg          , Gg^Vh       , Ggf         , Ggf         , Gg          , Gg          , Hh          , Hh          
Gg          , Gg          , Ggf         , Gg          , Gg          , Gg          , Ch          , Hh          , Wo          , Wo          , Ch          , Wo          , Ch          , Wo          , Wo          , Ch          , Gg          , Gg          , Gg          , Gg          , Gg          , Gg          , Gg          , Gg          , Ggf         , Gg          , Gg          , Gg          , Gg          , Gg          
Gg          , Gg          , Ggf         , Gg          , Ch          , Gg          , Ww^Bw|      , Wo          , Ch          , Ch          , Rr          , Rr          , Rr          , Ch          , Ch          , Ww^Bw|      , Ww^Bw/      , Ch          , Ch          , Gg          , Gg          , Gg          , Gg          , Ggf         , Gg          , Gg          , Ch          , Gg          , Gg          , Gg          
Gg          , Gg          , Gg          , Gg          , Ch          , Ww^Bw\      , Rr          , Ch          , Rr          , Rr          , Wo          , Rr          , Wo          , Rr          , Rr          , Rr          , Ch          , Wo          , Gg          , Gg          , Gg          , Gg          , Gg          , Gg          , Gg          , Ch          , 2 Kh        , Ch          , Gg          , Gg          
Gg          , Gg^Vc       , Gg          , Gg          , Gg          , Wo          , Ch          , Rr          , Rr          , Wo          , Ch          , Ch          , Ch          , Wo          , Rr          , Rr          , Ch          , Wo          , Hh          , Gg          , Gg          , Gg^Vh       , Gg          , Gg          , Gg          , Ch          , Ch          , Ch          , Gg          , Gg          
Gg          , Gg          , Gg          , Gg          , Gg          , Wo          , Ch          , Rr          , Rr          , Wo          , Ch          , Rr          , Ch          , Wo          , Rr          , Rr          , Ch          , Wo          , Wo          , Hh          , Hh          , Gg          , Gg          , Gg          , Gg          , Ch          , Gg          , Ch          , Gg          , Gg          
Ggf         , Ggf         , Gg          , Gg          , Ch          , Wo          , Rr          , Rr          , Rr          , Wo          , Wo          , Ch          , Wo          , Wo          , Rr          , Rr          , Ch          , Wo          , Ch          , Wo          , Wo          , Gg          , Gg          , Gg          , Gg          , Gg          , Gg          , Gg          , Gg          , Gg          
Ggf         , Ggf         , Gg          , Gg          , Ch          , Ww^Bw/      , Ww^Bw|      , Ch          , Ch          , Rr          , Rr          , Rr          , Rr          , Rr          , Ch          , Rr          , Ww^Bw\      , Wo          , Hh          , Ch          , Ww          , Gg          , Gg          , Gg          , Gg          , Gg          , Gg^Vh       , Gg          , Gg          , Gg          
Gg          , Gg          , Gg          , Gg          , Gg          , Gg          , Ch          , Wo          , Wo          , Ch          , Ch          , Rr          , Ch          , Ch          , Wo          , Ww^Bw|      , Hh          , Hh          , Ww          , Ww          , Ww          , Gg          , Gg          , Gg^Vh       , Gg          , Gg          , Gg          , Gg          , Hh          , Hh          
Gg          , Gg^Vc       , Gs^Fp       , Gg          , Gg          , Gg          , Gg          , Ch          , Gg          , Wo          , Wo          , Wo          , Wo          , Wo          , Hh          , Hh          , Ww          , Ww          , Ww          , Ww          , Ww          , Ww          , Ww          , Gg          , Gg          , Gg          , Gg          , Ggf         , Hh          , Hh          
Gs^Fp       , Gs^Fp       , Gs^Fp       , Gg          , Gg          , Gg          , Gg          , Gg          , Gg          , Gg          , Gg          , Ggf         , Gg          , Ch          , Gg          , Ch          , Hh          , Ww          , Ww          , Ww          , Wo          , Ww          , Ww          , Ww          , Ww          , Gg          , Hh          , Gg          , Mm          , Mm          
Gs^Fp       , Gs^Fp       , Gs^Fp       , Ggf         , Gs^Fp       , Gg          , Gs^Fp       , Gg          , Gg^Vc       , Gg          , Gg          , Gg          , Gg          , Gg          , Ggf         , Ggf         , Ggf         , Hh          , Gs^Fp       , Ww          , Wo          , Wo          , Wo          , Ww          , Ww          , Ww          , Hh          , Hh          , Mm          , Mm          
Gs^Fp       , Gs^Fp       , Gs^Fp       , Ggf         , Gs^Fp       , Gg          , Gs^Fp       , Gg          , Gg          , Gg          , Gg          , Gg          , Gg          , Gg          , Ggf         , Ggf         , Ggf         , Hh          , Gs^Fp       , Ww          , Wo          , Wo          , Wo          , Ww          , Ww          , Ww          , Hh          , Hh          , Mm          , Mm          
