Gg^Vh       , Gg^Vh       , Gg          , Gg          , Gg          , Xu          , Xu          , Uu          , Xu          , Chr         , Xu          , Uu^Vu       , Xu          , Xu          , Xu          , Xu          , Xu          , Xu          , Xu          , Xu          , Xu          , Xu          , Xu          , Xu          , Xu          , Xu          , Xu          , Xu          , Xu          , Xu          , Xu          , Xu          , Xu          , Xu          , Xu          , Xu          , Xu          , Xu          , Xu          , Xu          
Gg          , Gg          , Gg          , Uu^Ii       , Xu          , Uu          , Uu          , Re          , Chr         , 2 Kh        , Chr         , Uu          , Uu          , Uu^Vu       , Xu          , Uh          , Uu^Vu       , Uu          , Uu          , Uu          , Uu          , Chr         , Uu          , Uh          , Uu^Uf       , Rd          , Uu^Vu       , Uu^Uf       , Uu          , Uu^Vu       , Uu^Vu       , Uu          , Chr         , Uu          , Xu          , Xu          , Uu^Vu       , Uu          , Uh          , Xu          
Gg          , Xu          , Xu          , Uu          , Uu          , Rd          , Uu          , Rd          , Chr         , Chr         , Chr         , Xu          , Rd          , Xu          , Xu          , Uu^Vu       , Uh          , Chr         , Uu          , Uu          , Chr         , 8 Kh        , Chr         , Uu          , Uu          , Uu          , Uu^Uf       , Re          , Uu          , Uu          , Rd          , Re          , Uu          , Uu^Vu       , Chr         , Uu          , Uu          , Uu^Vu       , Uu^Uf       , Xu          
Xu          , Uu          , Uu^Uf       , Re          , Re          , Xu          , Uu          , Uu          , Uu^Vu       , Xu          , Uu          , Uu^Vu       , Xu          , Uu^Uf       , Rd          , Uu          , Uu          , Uu          , Re          , Uu          , Chr         , Chr         , Chr         , Uu          , Uu          , Xu          , Re          , Uu^Uf       , Uu          , Chr         , Re          , Xu          , Uu          , Uu          , Uu          , Chr         , Xu          , Xu          , Uu^Vu       , Xu          
Xu          , Uu^Vu       , Uu          , Xu          , Xu          , Uu          , Uu^Vu       , Uu          , Xu          , Rd          , Xu          , Xu          , Xu          , Uu^Vu       , Re          , Uu          , Uu^Vu       , Uu          , Re          , Rd          , Uu          , Uu          , Uu          , Uu          , Uu          , Uu^Uf       , Xu          , Re          , Rd          , Xu          , Xu          , Uu^Uf       , Uu^Uf       , Uu          , Uu^Vu       , Uu          , Xu          , Xu          , Xu          , Xu          
Xu          , Rd          , Re          , Xu          , Uu^Vu       , Rd          , Re          , Re          , Uu          , Uu          , Uu^Vu       , Re          , Xu          , Xu          , Uu^Uf       , Chr         , Uu          , Uu          , Uh          , Uu          , Uu^Uf       , Uu^Uf       , Uu          , Rd          , Uu          , Uu^Vu       , Xu          , Uu          , Uh          , Xu          , Uu^Vu       , Re          , Chr         , Xu          , Re          , Xu          , Uu          , Xu          , Uu^Uf       , Uh          
Xu          , Rd          , Uu          , Xu          , Re          , Uu          , Chr         , Rd          , Uu          , Re          , Rd          , Uu          , Re          , Uu          , Xu          , Xu          , Uu^Vu       , Xu          , Xu          , Uu          , Xu          , Xu          , Xu          , Xu          , Xu          , Xu          , Xu          , Uu          , Uu          , Xu          , Uu^Uf       , Xu          , Xu          , Uu^Uf       , Xu          , Chr         , Xu          , Uu          , Uu^Vu       , Xu          
Xu          , Chr         , Uu          , Uu^Uf       , Xu          , Uu^Vu       , Uu          , Re          , Uu^Vu       , Rd          , Uu          , Uu          , Uu^Vu       , Uu          , Uu          , Xu          , Xu          , Uu          , Chr         , Rd          , Uu^Vu       , Uu          , Uh          , Uh          , Uu^Vu       , Uu          , Uu^Uf       , Rd          , Uh          , Uh          , Xu          , Kud         , Uu^Vu       , Uu          , Uu^Vu       , Rd          , Uu^Vu       , Uu^Vu       , Uu          , Uu^Vu       
Xu          , Chr         , Uu          , Uu          , Xu          , Xu          , Uu          , Re          , Re          , Re          , Rd          , Rd          , Chr         , Uu          , Uu          , Xu          , Uu^Vu       , Uu          , Uu^Uf       , Rd          , Uu          , Uu          , Uu          , Uu          , Uu          , Chr         , Uu          , Re          , Uu          , Uu          , Xu          , Uu^Vu       , Uh          , Rd          , Re          , Re          , Uu          , Uu          , Re          , Xu          
Xu          , Uu^Vu       , Uu          , Rd          , Re          , Xu          , Xu          , Xu          , Uu^Vu       , Uu          , Uu          , Uu^Vu       , Re          , Re          , Uu^Vu       , Xu          , Uu          , Uu          , Uh          , Uu          , Uu^Uf       , Uu          , Uu          , Uu          , Uu          , Uu          , Uu          , Rd          , Chr         , Uu^Uf       , Xu          , Xu          , Uu          , Uu^Vu       , Uu          , Uu^Vu       , Chr         , Uu^Vu       , Uu^Uf       , Xu          
Xu          , Xu          , Uu          , Uu          , Uu          , Uu          , Uu^Vu       , Uu          , Xu          , Xu          , Xu          , Xu          , Xu          , Xu          , Xu          , Xu          , Chr         , Uu          , Uu          , Uu          , Uu^Vu       , Chr         , Kh          , Re          , Uu          , Re          , Uu          , Uu          , Uu^Uf       , Uu^Vu       , Xu          , Uu^Vu       , Chr         , Uu          , Uu          , Xu          , Uu^Uf       , Xu          , Uu^Vu       , Xu          
Uu^Ii       , Uu^Ii       , Xu          , Xu          , Uu          , Ce          , Ce          , Ce          , Uu          , Uu^Uf       , Uu          , Re          , Re          , Uu^Uf       , Uh          , Uu          , Uu          , Uu          , Uu          , Chr         , Re          , Re          , Rd          , Re          , Chr         , Chr         , Uu          , Uu          , Uu          , Uu          , Uu          , Uu          , Rd          , Uu          , Xu          , Chr         , Xu          , Chr         , Xu          , Chr         
Uu^Ii       , Re          , Uu^Vu       , Uu          , Uu          , Ce          , Ce          , 1 Ke        , Ce          , Rd          , Uu          , Re          , Uu          , Uu^Vu       , Uu^Uf       , Uu          , Uu          , Rd          , Uu          , Uh          , Uh          , Re          , Chr         , Chr         , Uu^Uf       , Uu^Uf       , Uu          , Rd          , Uu          , Rd          , Uu          , Chr         , Chr         , Chr         , Uu          , Re          , Uu          , Re          , Uh          , Re          
Uu^Ii       , Re          , Uu^Uf       , Uu          , Uu          , Uu          , Ce          , Ce          , Ce          , Uu          , Re          , Uu^Vu       , Rd          , Rd          , Re          , Rd          , Uu          , Uu          , Re          , Re          , Rd          , Chr         , Kh          , Re          , Re          , Uu          , Re          , Rd          , Re          , Uh          , Uu          , Chr         , 6 Kh        , Chr         , Re          , Re          , Rd          , Uh          , Rd          , Re          
Uu^Ii       , Re          , Re          , Uu^Uf       , Uu          , Uu          , Rd          , Uu          , Uu          , Uh          , Re          , Re          , Uh          , Uu^Vu       , Uu^Uf       , Uu          , Uu          , Uu          , Uu          , Re          , Rd          , Re          , Chr         , Uu          , Rd          , Chr         , Uu          , Uu          , Uh          , Uu          , Uu          , Re          , Chr         , Uu          , Uu          , Chr         , Uu          , Chr         , Uh          , Chr         
Re          , Re          , Uu^Vu       , Xu          , Xu          , Rd          , Re          , Xu          , Uu          , Chr         , Uh          , Xu          , Xu          , Xu          , Chr         , Xu          , Uu          , Uu^Uf       , Uu^Uf       , Uu          , Chr         , Chr         , Uu          , Chr         , Re          , Uu^Vu       , Uu          , Uu          , Uu          , Chr         , Uu          , Uu          , Rd          , Uu          , Uu^Vu       , Xu          , Xu          , Xu          , Xu          , Xu          
Uh^Ii       , Xu          , Xu          , Uu          , Uu          , Uu          , Chr         , Xu          , Xu          , Xu          , Xu          , Ww          , Uh          , Uh          , Xu          , Xu          , Uu          , Uu          , Uu          , Uu          , Rd          , Uu          , Kh          , Uu          , Uu          , Uu          , Uu          , Uu^Uf       , Uu          , Uu          , Xu          , Uu^Vu       , Re          , Uu          , Uu          , Xu          , Xu          , Xu          , Xu          , Xu          
Xu          , Chr         , Uu          , Uu          , Uu^Vu       , Xu          , Xu          , Uu^Uf       , Xu          , Ww          , Ww          , Ww          , Uu^Uf       , Rd          , Uu          , Xu          , Uu^Vu       , Re          , Uh          , Uh          , Uu          , Uu          , Uu          , Uh          , Uu          , Uu          , Uu          , Uu          , Uu          , Uu          , Xu          , Xu          , Uu          , Uu          , Rd          , Re          , Xu          , Xu          , Xu          , Xu          
Xu          , Uu          , Rd          , Uh          , Xu          , Uu^Vu       , Uu^Uf       , Uu^Vu       , Xu          , Ww          , Ww          , Chr         , Uu          , Uu^Vu       , Uu          , Xu          , Re          , Re          , Rd          , Uu          , Re          , Uu          , Uu          , Uu          , Re          , Uu^Uf       , Uu          , Re          , Uu          , Re          , Xu          , Uu^Vu       , Xu          , Xu          , Uu^Vu       , Re          , Uu^Vu       , Xu          , Xu          , Xu          
Xu          , Uu          , Rd          , Re          , Xu          , Uu^Uf       , Re          , Uu^Uf       , Xu          , Ww          , Uu^Vu       , Re          , Uu^Uf       , Re          , Uu          , Xu          , Uh          , Rd          , Uu          , Xu          , Re          , Xu          , Uu^Vu       , Xu          , Uu^Uf       , Xu          , Uu^Vu       , Xu          , Re          , Xu          , Xu          , Uu          , Cud         , Cud         , Xu          , Xu          , Uu          , Uu          , Xu          , Xu          
Xu          , Uu^Vu       , Uh          , Uu^Uf       , Xu          , Uu^Vu       , Re          , Uu^Uf       , Xu          , Uu^Uf       , Ww          , Ww          , Uu^Uf       , Uu          , Uu^Uf       , Xu          , Xu          , Re          , Uu^Uf       , Xu          , Xu          , Uu^Vu       , Xu          , Uu^Vu       , Xu          , Xu          , Xu          , Cud         , Xu          , Xu          , Cud         , Uu          , Cud         , Cud         , Cud         , Xu          , Chr         , Rd          , Uu          , Uu          
Xu          , Uu^Uf       , Re          , Uu          , Xu          , Uh          , Re          , Uu^Vu       , Xu          , Uu^Vu       , Uu^Uf       , Uu^Vu       , Ww          , Ww          , Uu^Vu       , Xu          , Chr         , Uu          , Uu^Uf       , Xu          , Re^Gvs      , Re^Gvs      , Uu^Ii       , Uu^Ii       , Re^Gvs      , Xu          , Xu          , Uu          , Uu          , Uu          , Uu          , Cud         , Uu          , Uu          , 4 Kud       , Cud         , Xu          , Xu          , Re          , Uu          
Xu          , Uu          , Re          , Rd          , Xu          , Uu^Vu       , Re          , Xu          , Xu          , Re          , Uu          , Ww          , Ww          , Chr         , Ww          , Xu          , Chr         , Rd          , Re          , Xu          , Uu^Vu       , Uu^Ii       , Uu^Ii       , Re^Gvs      , Uu^Vu       , Rd          , Uu^Ii       , Re          , Xu          , Xu          , Cud         , Kud         , Uu          , Uu          , Cud         , Cud         , Cud         , Xu          , Chr         , Uu          
Xu          , Uh          , Uu          , Uh          , Xu          , Uu^Vu       , Rd          , Xu          , Re          , Ww          , Ww          , Re          , Uu^Uf       , Uu^Uf       , Uu^Vu       , Xu          , Rd          , Uu          , Uu          , Xu          , Re^Gvs      , Uu^Vu       , Re^Gvs      , Uu^Vu       , Uu^Ii       , Chr         , Xu          , Xu          , Uu          , Re          , Xu          , Xu          , Uu          , Uu^Vu       , Uu          , Uu          , Cud         , Xu          , Uu          , Uu          
Xu          , Uh          , Rd          , Uu          , Uu          , Re          , Rd          , Xu          , Ww          , Uu^Vu       , Uu^Uf       , Uu^Uf       , Rd          , Uu          , Xu          , Uu          , Re          , Uu          , Chr         , Chr         , Xu          , Xu          , Chr         , Re^Gvs      , Uu^Vu       , Re^Gvs      , Uu^Vu       , Xu          , Uu          , Xu          , Xu          , Uu^Vu       , Uu          , Uu^Uf       , Uu          , Uu          , Uu^Uf       , Xu          , Rd          , Uu^Uf       
Xu          , Uu          , Re          , Uu          , Xu          , Xu          , Uu^Vu       , Xu          , Ww          , Ww          , Uu^Uf       , Re          , Uu^Vu       , Uu          , Uu          , Uh          , Re          , Rd          , Uu^Uf       , Uu^Uf       , Uu^Vu       , Re          , Xu          , Uu^Vu       , Uu^Ii       , Xu          , Xu          , Uu          , Uu          , Xu          , Uu^Vu       , Uu^Vu       , Uu^Uf       , Xu          , Uu^Vu       , Xu          , Uu^Vu       , Xu          , Re          , Uu^Uf       
Xu          , Uu          , Rd          , Chr         , Uu          , Uu^Vu       , Xu          , Ww          , Ww          , Ww          , Uu^Vu       , Re          , Rd          , Re          , Uh          , Uu          , Uu          , Chr         , Uu          , Uu          , Uu          , Uu          , Xu          , Xu          , Xu          , Uu          , Uu          , Re          , Rd          , Xu          , Xu          , Xu          , Xu          , Uu          , Xu          , Uu          , Xu          , Xu          , Uu          , Uu^Uf       
Xu          , Uu          , Chr         , 3 Kh        , Chr         , Uu          , Xu          , Ww          , Uu^Vu       , Chr         , Ww          , Ww          , Uu          , Uu          , Uu          , Uu          , Chr         , 7 Kh        , Chr         , Uu          , Uh          , Uu          , Uu          , Xu          , Chr         , Uu          , Rd          , Xu          , Xu          , Uu          , Uu^Vu       , Uu          , Uu^Vu       , Chr         , Chr         , Chr         , Uu          , Uu^Vu       , Re          , Chr         
Xu          , Re          , Chr         , Chr         , Chr         , Uu          , Xu          , Ww          , Uu^Uf       , Uu^Uf       , Uu^Uf       , Ww          , Uu^Vu       , Uu^Uf       , Uu          , Uu^Uf       , Chr         , Chr         , Chr         , Uu          , Uh          , Re          , Chr         , Uu^Uf       , Xu          , Uu          , Xu          , Uu          , Uu          , Rd          , Re          , Xu          , Uu          , Chr         , 5 Kh        , Chr         , Rd          , Re          , Uu          , Uu          
Xu          , Xu          , Xu          , Xu          , Xu          , Xu          , Xu          , Ww          , Xu          , Xu          , Xu          , Ww          , Uu^Uf       , Ww          , Xu          , Xu          , Uu          , Xu          , Uu^Vu       , Xu          , Uu^Uf       , Xu          , Uu^Vu       , Xu          , Xu          , Uu^Vu       , Re          , Xu          , Chr         , Xu          , Uu          , Xu          , Uu^Vu       , Xu          , Chr         , Xu          , Uu^Vu       , Xu          , Xu          , Xu          
