border_size=1
usage=map

Mm          , Mm          , Mm          , Mm          , Mm          , Mm          , Mm          , Mm          , Mm          , Mm          , Hh          , Mm          , Mm          , Mm          , Mm          , Mm          , Hh          , Mm          , Ww          , Hh          , Hh          , Mm          , Mm          , Mm          , Mm          , Mm          , Hh          , Mm          , Mm          , Mm          , Mm          , Mm          
Mm          , Mm          , Mm          , Mm^Vhm      , Mm          , Mm          , Mm          , Mm          , Mm          , Mm          , Hh          , Mm          , Mm          , Mm          , Mm          , Mm          , Hh          , Mm          , Ww          , Hh          , Hh          , Mm          , Mm          , Mm          , Mm          , Mm          , Hh          , Mm          , Mm          , Mm          , Mm          , Mm          
Mm          , Mm          , Hh          , Mm          , Mm          , Mm          , Mm          , Mm          , Mm          , Mm          , Mm          , Mm          , Mm          , Mm          , Mm          , Mm          , Hh          , Ww          , Ww          , Ww          , Hh          , Mm          , Hh          , Hh^Vhh      , Gs^Fp       , Mm          , Hh          , Hh          , Mm          , Mm          , Mm          , Mm          
Gs^Fp       , Gs^Fp       , Gs^Fp       , Hh          , Hh          , Mm          , Hh          , Mm          , Hh          , Mm          , Mm^Vhm      , Mm          , Mm          , Mm          , Mm          , Mm^Vhm      , Mm          , Hh          , Hh          , Ww          , Gg          , Hh          , Rr          , Gg          , Rr          , Gs^Fp       , Rr          , Hh          , Hh          , Hh          , Mm          , Mm          
Gs^Fp       , Ce          , Ce          , Ce          , Ce          , Hh          , Rr          , Hh          , Rr          , Hh          , Hh          , Hh          , Hh          , Mm          , Mm          , Mm          , Hh          , Hh          , Hh          , Gg^Vh       , Rr          , Rr          , Gg          , Rr          , Hh          , Rr          , Hh          , Rr          , Rr          , Hh          , Hh          , Hh          
Gs^Fp       , Ce          , Ce          , 1 Ke        , Ce          , Rr          , Hh          , Rr          , Hh          , Rr          , Rr          , Hh          , Rr          , Hh          , Hh          , Hh          , Gg^Efm      , Gg^Efm      , Rr          , Rr          , Hh          , Hh          , Mm          , Mm          , Hh          , Cud         , 2 Kud       , Cud         , Hh          , Rr          , Rr          , Rr          
Gs^Fp       , Ce          , Hh          , Ce          , Mm          , Hh          , Mm          , Hh          , Gg^Ve       , Hh          , Gg          , Rr          , Gg          , Rr          , Rr          , Hh          , Rr          , Rr          , Hh          , Hh          , Mm          , Mm          , Mm          , Mm          , Mm          , Cud         , Cud         , Cud         , Hh          , Rr          , Gg          , Gg          
Mm          , Mm          , Mm          , Mm          , Mm          , Mm          , Mm          , Mm          , Hh          , Gg          , Hh          , Hh          , Mm          , Hh          , Hh          , Rr          , Hh          , Hh          , Hh^Vhh      , Mm          , Mm          , Mm          , Mm          , Mm          , Mm          , Mm          , Mm          , Hh          , Rr          , Rr          , Gg^Ve       , Gg          
Mm          , Mm          , Mm^Vhm      , Mm          , Hh          , Mm          , Mm          , Mm          , Mm          , Hh          , Mm          , Mm          , Mm          , Mm          , Mm          , Gg          , Hh          , Hh          , Mm          , Mm          , Mm          , Hh          , Mm          , Mm          , Mm          , Mm          , Mm          , Mm          , Mm          , Rr          , Hh          , Hh          
Hh          , Hh          , Hh          , Hh          , Hh          , Hh          , Mm^Vhm      , Mm          , Mm          , Mm          , Hh          , Hh          , Ww          , Hh          , Ww          , Gg^Vh       , Hh          , Hh          , Hh          , Mm          , Hh          , Mm          , Hh          , Mm          , Mm          , Mm          , Hh          , Mm          , Mm          , Rr          , Hh          , Hh          
Ss          , Ss          , Ss          , Ss          , Hh          , Mm          , Hh          , Mm          , Hh          , Mm          , Hh          , Ww          , Wo          , Ww          , Ww          , Wwf         , Wwf         , Hh          , Ww          , Hh          , Ww          , Hh          , Ww          , Hh          , Ww          , Hh          , Ww          , Hh          , Hh          , Rr          , Mm          , Mm          
Ww          , Ww          , Ww          , Ww          , Ww          , Hh          , Ww          , Hh          , Ss          , Hh          , Ww          , Ww          , Wo          , Wo          , Wo          , Ww          , Wwf         , Ww          , Wo          , Ww          , Wo          , Ww          , Wo          , Ww          , Wo          , Ww          , Ww          , Ww          , Gg^Ve       , Rr          , Mm          , Mm          
Wo          , Wo          , Wo          , Wo          , Wo          , Ww          , Wo          , Ww          , Ww          , Ww          , Ww          , Ww          , Wo          , Wo          , Wo          , Ww          , Wwf         , Ww          , Wo          , Wo          , Wo          , Wo          , Ww          , Wo          , Ww          , Wo          , Ww          , Hh          , Hh          , Rr          , Mm          , Mm          
Wo          , Wo          , Wo          , Wo          , Wo          , Wo          , Wo          , Wo          , Wo          , Wo          , Wo          , Wo          , Wo          , Wo          , Ww          , Ww          , Wwf         , Ww          , Ww          , Ww          , Ww          , Ww          , Hh          , Ww          , Hh          , Ww          , Ww          , Mm          , Hh          , Rr          , Hh          , Hh          
Wo          , Wo          , Wo          , Wo          , Wo          , Wo          , Wo          , Wo          , Wo          , Wo          , Wo          , Wo          , Ww          , Ww          , Ww          , Ww          , Wwf         , Wwf         , Hh          , Ww          , Hh          , Hh          , Mm          , Mm          , Hh          , Gg^Ve       , Rr          , Ww          , Ww          , Ww^Bw|      , Ww          , Ww          
Ww          , Ww          , Ww          , Wo          , Ww          , Wo          , Ww          , Wo          , Wo          , Wo          , Wo          , Wo          , Ww          , Hh          , Hh          , Hh          , Mm          , Hh          , Hh          , Hh          , Mm          , Mm          , Hh          , Hh          , Rr          , Rr          , Mm          , Rr          , Rr          , Rr          , Mm          , Mm          
Ww          , Ww          , Ss          , Ww          , Ss          , Ww          , Gg^Vh       , Ww          , Ww          , Ww          , Ww          , Ww          , Hh          , Hh          , Mm          , Mm          , Mm          , Mm          , Gg          , Mm          , Mm          , Mm          , Hh          , Mm          , Rr          , Hh          , Hh          , Mm          , Mm          , Gg^Ve       , Mm          , Mm          
Hh          , Hh          , Hh          , Ss          , Hh          , Hh          , Mm          , Hh          , Hh          , Ss          , Hh          , Ss          , Hh          , Hh          , Mm          , Mm          , Hh          , Gg^Ve       , Gg          , Hh          , Hh          , Hh          , Hh          , Hh          , Rr          , Hh          , Mm          , Mm          , Mm          , Mm          , Mm          , Mm          
Mm          , Mm          , Mm          , Hh          , Mm          , Mm          , Mm          , Hh          , Mm          , Hh          , Mm          , Hh          , Mm          , Mm          , Hh          , Mm          , Hh          , Hh          , Hh          , Hh          , Gs^Fp       , Gs^Fp       , Gs^Fp       , Gg          , Rr          , Gg          , Hh          , Mm          , Mm          , Mm          , Mm          , Mm          
Mm          , Mm          , Mm          , Mm          , Mm          , Mm          , Mm          , Mm          , Mm          , Mm          , Mm          , Mm          , Mm          , Mm          , Hh          , Hh          , Gg          , Hh          , Gg          , Hh          , Rr          , Rr          , Rr          , Rr          , Hh          , Hh          , Hh          , Mm          , Mm          , Mm          , Mm          , Mm          
Mm          , Mm          , Mm          , Mm          , Gg^Ve       , Mm          , Hh          , Mm          , Hh          , Mm          , Hh          , Gg^Ve       , Hh          , Hh          , Hh          , Gg          , Rr          , Rr          , Rr          , Rr          , Hh          , Hh          , Mm          , Gg^Ve       , Hh          , Hh          , Mm          , Mm          , Mm          , Mm          , Mm          , Mm          
Mm          , Mm          , Hh          , Hh          , Gg          , Hh          , Hh          , Hh          , Hh          , Hh          , Hh          , Gg          , Gg          , Hh          , Rr          , Rr          , Mm          , Hh          , Gg^Ve       , Mm          , Mm          , Mm          , Mm          , Hh          , Hh          , Hh          , Mm          , Mm          , Mm          , Mm          , Mm          , Mm          
Hh          , Hh          , Hh          , Gg          , Hh          , Hh          , Chr         , Hh          , Hh          , Hh          , Hh          , Hh          , Gg          , Rr          , Hh          , Mm          , Mm          , Mm          , Mm          , Mm          , Mm          , Mm          , Mm          , Mm          , Mm          , Mm          , Mm          , Chr         , Mm          , Mm          , Mm          , Mm          
Hh          , Hh          , Re          , Re          , Re          , Re          , Re          , Rr          , Rr          , Mm          , Rr          , Rr          , Rr          , Rr          , Mm          , Mm          , Mm          , Mm          , Mm          , Mm          , Mm          , Mm          , Mm          , Mm          , Mm          , Mm          , Chr         , Chr         , Chr         , Mm          , Mm          , Mm          
Gg          , Gg          , Re          , Gg          , Gs^Fp       , Gg          , Hh          , Chr         , Hh          , Rr          , Hh          , Hh          , Hh          , Mm          , Mm          , Mm          , Mm          , Mm          , Mm          , Mm          , Hh          , Mm          , Mm          , Mm          , Mm          , Chr         , Chr         , 3 Kh        , Chr         , Mm          , Mm          , Mm          
Re          , Re          , Gg          , Gs^Fp       , Hh          , Hh          , Mm          , Hh          , Mm          , Gg^Ve       , Mm          , Mm          , Mm          , Mm          , Mm          , Mm          , Mm          , Mm          , Mm          , Mm          , Hh          , Hh          , Mm          , Mm          , Mm          , Chr         , Chr         , Chr         , Chr         , Mm          , Mm          , Mm          
Re          , Re          , Gg          , Hh          , Mm          , Mm          , Mm          , Mm          , Mm          , Mm          , Mm          , Mm          , Mm          , Mm          , Mm          , Gg^Ve       , Mm          , Mm          , Mm          , Mm          , Mm          , Mm          , Mm          , Mm          , Mm          , Mm          , Mm          , Mm          , Mm          , Mm          , Mm          , Mm          
Re          , Re          , Re          , Hh          , Mm          , Mm          , Mm          , Mm          , Mm          , Mm          , Mm          , Mm          , Mm          , Mm          , Mm          , Mm          , Mm          , Mm          , Mm          , Mm          , Mm          , Mm          , Mm          , Mm          , Mm          , Mm          , Mm          , Mm          , Mm          , Mm          , Mm          , Mm          
Gg          , Gg          , Re          , Hh          , Hh          , Mm          , Gg^Ve       , Hh          , Hh          , Hh          , Hh          , Mm          , Hh          , Mm          , Mm          , Mm          , Mm          , Mm          , Mm          , Mm          , Mm          , Mm          , Mm          , Mm          , Hh          , Mm          , Hh          , Mm          , Hh          , Gg^Ve       , Hh          , Hh          
Gg          , Gg          , Re          , Gg^Efm      , Gg          , Hh          , Hh          , Hh          , Hh          , Hh          , Hh          , Hh          , Hh          , Hh          , Mm          , Mm          , Gg^Ve       , Hh          , Hh          , Mm          , Mm          , Mm          , Hh          , Mm          , Hh          , Hh          , Gs^Fp       , Hh          , Hh          , Gs^Fp       , Gg          , Gg          
Gg          , Gg^Ve       , Hh          , Re          , Re          , Gg^Efm      , Gg          , Gg^Efm      , Gg^Efm      , Gg          , Gg          , Hh          , Gg          , Hh          , Hh          , Hh          , Gs^Fp       , Hh          , Hh          , Hh          , Hh          , Hh          , Hh          , Hh          , Gs^Fp       , Gs^Fp       , Gs^Fp       , Hh          , Hh          , Hh          , Gg          , Gg          
Hh          , Hh          , Hh          , Hh          , Hh          , Re          , Re          , Re          , Re          , Gg          , Gg          , Gg          , Re          , Gg          , Re          , Gg          , Gs^Fp       , Gs^Fp       , Gs^Fp       , Gs^Fp       , Gs^Fp       , Gs^Fp       , Gs^Fp       , Gs^Fp       , Gg^Ve       , Gs^Fp       , Gs^Fp       , Gs^Fp       , Hh          , Hh          , Gg^Ve       , Gg          
Mm          , Mm          , Mm          , Mm          , Hh          , Hh          , Hh          , Gg          , Gg          , Re          , Re          , Re          , Gg^Efm      , Re          , Gg^Efm      , Re          , Re          , Hh          , Hh          , Gs^Fp       , Gs^Fp       , Gs^Fp       , Gs^Fp       , Gs^Fp       , Gs^Fp       , Gs^Fp       , Hh          , Gs^Fp       , Hh          , Gs^Fp       , Gg          , Gg          
Mm          , Mm          , Mm          , Hh          , Gg^Ve       , Hh          , Mm          , Hh          , Gg          , Gg          , Gg          , Gg          , Gg^Efm      , Gg^Efm      , Gg^Efm      , Gg^Efm      , Re          , Hh          , Hh          , Hh          , Gg          , Gs^Fp       , Hh          , Hh          , Hh          , Hh          , Hh          , Hh          , Gs^Fp       , Hh          , Hh          , Hh          
Mm          , Mm          , Hh          , Hh          , Hh          , Hh          , Hh          , Hh          , Gg          , Gg          , Gg          , Ss          , Gg          , Gg          , Gg          , Re          , Hh          , Hh          , Hh          , Hh          , Hh          , Hh          , Hh          , Hh          , Gs^Fp       , Gs^Fp       , Gs^Fp       , Gs^Fp       , Gs^Fp       , Hh          , Hh          , Hh          
Hh          , Hh          , Gg^Ve       , Hh          , Gs^Fp       , Hh          , Gs^Fp       , Hh          , Gg          , Gg          , Gs^Fp       , Gg          , Gg          , Gg          , Gg          , Re          , Hh          , Hh          , Gg^Ve       , Hh          , Hh          , Hh          , Hh          , Gs^Fp       , Gs^Fp       , Gs^Fp       , Gs^Fp       , Gs^Fp       , Gs^Fp       , Gs^Fp       , Gs^Fp       , Gs^Fp       
Hh          , Hh          , Gs^Fp       , Gs^Fp       , Gs^Fp       , Gs^Fp       , Gs^Fp       , Gs^Fp       , Gs^Fp       , Gs^Fp       , Gs^Fp       , Gs^Fp       , Gg^Ve       , Gg          , Re          , Re          , Gg          , Hh          , Hh          , Hh          , Hh          , Hh          , Hh          , Hh          , Hh          , Gs^Fp       , Gs^Fp       , Gg^Ve       , Gs^Fp       , Gs^Fp       , Gs^Fp       , Gs^Fp       
Gs^Fp       , Gs^Fp       , Gs^Fp       , Gs^Fp       , Gs^Fp       , Gs^Fp       , Ss          , Gs^Fp       , Gs^Fp       , Gs^Fp       , Gs^Fp       , Gs^Fp       , Gg^Efm      , Gg          , Re          , Ce          , Re          , Gs^Fp       , Gs^Fp       , Gs^Fp       , Gs^Fp       , Gs^Fp       , Gs^Fp       , Hh          , Gs^Fp       , Hh          , Gs^Fp       , Gs^Fp       , Ss          , Ss          , Gs^Fp       , Gs^Fp       
Gs^Fp       , Gs^Fp       , Gg^Ve       , Gs^Fp       , Gs^Fp       , Gs^Fp       , Gs^Fp       , Gs^Fp       , Gs^Fp       , Gs^Fp       , Gs^Fp       , Gs^Fp       , Gs^Fp       , Re          , Gg          , Re          , Re          , Gs^Fp       , Gs^Fp       , Gs^Fp       , Gs^Fp       , Gs^Fp       , Gs^Fp       , Gs^Fp       , Gs^Fp       , Gs^Fp       , Gs^Fp       , Gs^Fp       , Gs^Fp       , Ss          , Gs^Fp       , Gs^Fp       
Gs^Fp       , Gs^Fp       , Gg          , Gs^Fp       , Gs^Fp       , Gs^Fp       , Gs^Fp       , Gs^Fp       , Gs^Fp       , Gs^Fp       , Gs^Fp       , Gs^Fp       , Gs^Fp       , Re          , Gg          , Re          , Re          , Gs^Fp       , Gs^Fp       , Gs^Fp       , Gs^Fp       , Gs^Fp       , Gs^Fp       , Gs^Fp       , Gs^Fp       , Gs^Fp       , Gs^Fp       , Gs^Fp       , Gs^Fp       , Ss          , Gs^Fp       , Gs^Fp       
