Mm          , Mm          , Mm          , Mm          , Mm          , Mm          , Mm          , Mm          , Mm          , Hh^Vhh      , Hh          , Hh          , Mm          , Mm          , Mm          , Gs^Fp       , Gg^Ve       , Mm          , Mm^Xm       , Mm^Xm       
Mm          , Ce          , Ce          , Ce          , Mm          , Gg^Fet      , Hh          , Mm          , Mm          , Mm          , Gs^Fp       , Gs^Fp       , Hh          , Hh          , Gs^Fp       , Gs^Fp       , Mm          , Mm          , Mm          , Mm^Xm       
Mm          , Ce          , 2 Ke        , Ce          , Gs^Fp       , Gs^Fp       , Hh          , Gs^Fp       , Mm          , Gg          , Gs^Fp       , Gg          , Gg          , Gg^Vh       , Hh          , Chr         , Chr         , Mm          , Mm          , Hh^Vhh      
Mm          , Mm          , Ce          , Gg          , Gg          , Gg          , Gs^Fp       , Gg^Vh       , Gg          , Gg          , Gg          , Gg          , Gg          , Gg          , Gg          , Gg          , Gg          , Gg          , Chr         , Mm          
Chr         , Chr         , Gg          , Gg          , Gg          , Gg          , Gg          , Gg          , Gg          , Gg          , Gg          , Gg          , Gg          , Gg          , Gg          , Gg          , Gg          , Gg          , Chr         , Hh          
Hh^Vhh      , Gg          , Gg          , Gg          , Gg          , Gg          , Gg          , Gg          , Gg          , Gg          , Gg          , Gg          , Gg          , Ggf         , Ggf         , Ggf         , Ggf         , Gs^Fp       , Hh          , Gg^Fet      
Gs^Fp       , Gs^Fp       , Gg          , Gs^Fp       , Gg          , Gg          , Gg          , Gg          , Gg          , Chr         , Gg          , Gg          , Gg          , Gg          , Ggf         , Ggf         , Ggf         , Gs^Fp       , Gs^Fp       , Hh          
Hh          , Hh          , Gg^Ve       , Gs^Fp       , Gg          , Gg          , Gg          , Gg          , Chr         , Gs^Fp       , Gg          , Gg          , Gg          , Gg          , Gg          , Gg          , Gs^Fp       , Hh          , Hh          , Hh^Vhh      
Mm          , Mm          , Mm          , Mm          , Gs^Fp       , Gg          , Gg          , Ggf         , Ggf         , Gg^Ve       , Gs^Fp       , Gs^Fp       , Gg          , Gg          , Gg          , Gg          , Hh          , Mm          , Mm          , Mm          
Mm          , Mm          , Mm          , Mm          , Mm          , Gg          , Gg          , Ggf         , Ggf         , Gs^Fp       , Gs^Fp       , Gs^Fp       , Gg          , Gg          , Gg          , Gg          , Hh          , Mm          , Mm          , Mm          
Mm          , Mm          , Mm          , Hh          , Gg^Vh       , Gg          , Ggf         , Hh          , Hh          , Mm          , Gs^Fp       , Gs^Fp       , Gg          , Gg          , Gg          , Mm          , Mm          , Mm          , Mm          , Mm          
Mm          , Mm          , Hh          , Hh          , Gg          , Gg          , Hh          , Hh          , Mm          , Mm          , Mm          , Mm          , Gg^Vh       , Gg          , Gg          , Hh          , Mm          , Gs^Fp       , Gs^Fp       , Hh^Vhh      
Mm          , Hh          , Hh          , Gg          , Gg          , Ggf         , Mm          , Hh          , Mm          , Mm          , Mm          , Mm          , Mm          , Gg          , Gg          , Gg          , Hh          , Gs^Fp       , Hh          , Hh          
Hh          , Hh          , Hh          , Gg          , Gg          , Ggf         , Mm          , Mm          , Hh          , Mm          , Mm          , Mm          , Gs^Fp       , Gg          , Gg          , Gg          , Gg          , Gs^Fp       , Hh          , Hh          
Hh          , Gs^Fp       , Gg^Vh       , Gg          , Gg          , Ggf         , Gg^Vh       , Chr         , Mm          , Mm          , Mm          , Gs^Fp       , Gs^Fp       , Gg          , Gg          , Gg          , Gg          , Ggf         , Hh          , Chr         
Hh          , Gg^Ve       , Gs^Fp       , Gg          , Gg          , Ggf         , Ggf         , Chr         , Chr         , Mm          , Mm          , Gs^Fp       , Gg^Vh       , Gg          , Gg          , Gs^Fp       , Gg          , Gg          , Ggf         , Ggf         
Gs^Fp       , Gs^Fp       , Gs^Fp       , Gg          , Gg          , Gg          , Gg          , Mm          , Hh          , Mm          , Gg^Fet      , Gg          , Gg          , Gg          , Gg          , Gs^Fp       , Gs^Fp       , Gg^Ve       , Ggf         , Ggf         
Hh          , Mm          , Hh          , Chr         , Gg          , Gg          , Gg          , Gg          , Hh          , Gg          , Gg          , Gg          , Gg          , Gg          , Gg          , Gg          , Gs^Fp       , Hh          , Hh          , Hh          
Mm          , Mm          , Hh          , Gg          , Gg          , Gg          , Gg          , Gg          , Gg          , Gg          , Gg          , Gg          , Ggf         , Ggf         , Gg          , Mm          , Mm          , Mm          , Hh          , Hh          
Mm          , Mm          , Gg^Ve       , Gg          , Gg          , Gg          , Gg          , Gg          , Gg          , Chr         , Gg          , Ggf         , Ggf         , Ggf         , Gs^Fp       , Gs^Fp       , Mm          , Mm          , Hh          , Mm          
Chr         , Mm          , Gs^Fp       , Gg          , Gg          , Gg          , Gg          , Gg          , Hh          , Mm          , Hh          , Gs^Fp       , Gg          , Ggf         , Ggf         , Gs^Fp       , Mm          , Mm          , Mm          , Mm          
Chr         , Chr         , Gs^Fp       , Ce          , Ce          , Ce          , Gg          , Gg^Vh       , Hh          , Mm          , Hh          , Hh          , Gs^Fp       , Gs^Fp       , Gs^Fp       , Gs^Fp       , Hh          , Mm          , Mm          , Mm          
Xu          , Xu          , Gg          , Ce          , 1 Ke        , Ce          , Gg          , Hh          , Mm          , Mm          , Mm          , Mm          , Hh          , Gs^Fp       , Gg^Ve       , Gs^Fp       , Hh          , Hh^Vhh      , Mm          , Mm^Xm       
Uu          , Gg          , Gg          , Gg          , Ce          , Mm          , Hh          , Mm          , Mm          , Mm          , Mm          , Mm^Xm       , Mm^Xm       , Mm          , Gg^Fet      , Gg^Fet      , Hh          , Mm          , Mm          , Mm^Xm       
Uu          , Uu          , Xu          , Xu          , Mm          , Chr         , Chr         , Chr         , Hh^Vhh      , Mm          , Mm          , Mm          , Mm          , Mm^Xm       , Mm          , Mm          , Mm          , Mm^Xm       , Mm^Xm       , Mm^Xm       
