Gs^Fp, Hh, Hh, Hh, Hh, Hh, Hh, Hh, Rp, Hh^Fds, Gs^Fp, Hh^Fds, Gs^Fp, Gs^Fp, Md, Md, Md, Mm, Mm, Mm, Wo, Mm, Mm, Mm, Mm, Md, Md, Md, Gs^Fp, Gs^Fds, Gs^Fp, Gs^Fds, Gs^Fds, Gs, Gs^Fp, Gs, Gs, Gs^Fp, Gs, Gs, Gs, Gs^Fp
Gs^Fp, Gs^Fp, Gs^Fp, Hh, Hh, Hh, Hh, Hh, Rp, Gs^Fp, Gs^Fp, Gs^Fp, Gs^Fp, Gs^Fp, Md, Md, Md, Mm, Mm, Mm, Wo, Mm, Mm, Mm, Mm, Md, Md, Md, Gs^Fp, Gs^Fp, Gs^Fp, Gs^Fp, Gs^Fms, Gs^Fp, Gs^Fp, Gs, Gs, Gs, Gs, Gs, Gs, Gs^Fp
Gs^Fp, Gs^Fp, Gs^Fp, Gs^Fp, Gs^Fp, Hh, Gs^Fds, Hh, Gs^Fds, Rp, Gs^Fp, Gs^Fp, Gs^Fp, Gs^Fp, Gs^Fms, Md, Md, Md, Md, Md, Wo, Md, Md, Mm, Md, Md, Md, Md, Hh^Fds, Gs^Fp, Gs^Fds, Gs^Fds, Gs^Fds, Gg^Fet, Gs^Fp, Gs, Gs^Fp, Gs, Gs, Gs, Gs, Gs
Gs^Fp, Gs^Fp, Gs^Fp, Gs^Fms, Gs^Fp, Gs^Fds, Gs^Fds, Gs^Fds, Gs^Fds, Rp, Gs^Fp, Gs^Fp, Gs^Fp, Gs^Fp, Gs^Fp, Gs^Fp, Gs^Fp, Md, Hd, Gs^Fp, Wo, Md, Md, Md, Gs^Fp, Gs^Fp, Gs^Fp, Gs^Fp, Gs^Fds, Gs^Fds, Gs^Fds, Gs^Fds, Gg^Ve, Gs^Fds, Gs^Fds, Gs^Fp, Gs^Fp, Gs^Fp, Gs^Fp, Gs, Gs, Gs
Gs^Fp, Gs^Fp, Gs^Fp, Gs^Fp, Gs^Fp, Gg^Ve, Gs^Fds, Gg^Fet, Gs^Fds, Rp, Gs^Fp, Gs^Fp, Gs^Fp, Gs^Fms, Hh^Fds, Hh^Fds, Gs^Fp, Gs^Fp, Gs^Fp, Hd, Gs^Fp, Wo, Gs^Fp, Gs^Fp, Hh^Fds, Gs^Fp, Gs^Fds, Gs^Fp, Gs^Fds, Gg^Fet, Gs^Fds, Gs^Fds, Gs^Fds, Gs^Fds, Gs^Fds, Gs^Fms, Gs^Fds, Gs^Fds, Gs^Fp, Gs, Gs, Gs
Gs^Fp, Gs^Fp, Gs^Fp, Gs^Fp, Gs^Fp, Gs^Fds, Gs^Fds, Gs^Fds, Gs^Fds, Rp, Rp, Gs^Fp, Gg^Fet, Hh^Fds, Gg^Ve, Hh^Fds, Gs^Fds, Gs^Fms, Gs^Fp, Hd, Gs^Fp, Wo, Gs^Fp, Gs^Fp, Gs^Fms, Gs^Fds, Gs^Fds, Gs^Fms, Gs^Fds, Gs^Fds, Gs^Fds, Gs^Fds, Gs^Fds, Gs^Fds, Gg^Efm, Gs^Fds, Gs^Fds, Gg^Fet, Gs^Fp, Gs^Fp, Gs, Gs
Gs^Fp, Gs^Fp, Gs^Fp, Gs, Gs, Gs^Fp, Gs^Fms, Gs^Fds, Gs^Fds, Gs^Fds, Rp, Gs^Fp, Hh^Fds, Hh^Fds, Gs^Fds, Gs^Fds, Gg^Fet, Gs^Fds, Gs^Fp, Hd, Gs^Fp, Ww, Ww, Hh^Fds, Gs^Fds, Gs^Fds, Gs^Fds, Gg^Ve, Gs^Fds, Gs^Fds, Gs^Fds, Gs^Fds, Gg^Efm, Gg^Efm, Cv, Gg^Efm, Gg^Efm, Gs^Fp, Gs^Fp, Gs^Fp, Gs, Gs
Gs, Gs^Fp, Gs, Gs, Gs, Gs^Fp, Gs^Fds, Gs^Fds, Gg^Ve, Gs^Fds, Gs^Fds, Rp, Rp, Hh^Fds, Gs^Fds, Gs^Fds, Gs^Fds, Gs^Fds, Hh^Fds, Gs^Fp, Gs^Fds, Gs^Fds, Ww, Gs^Fds, Gs^Fds, Gs^Fds, Gs^Fds, Gs^Fds, Gs^Fds, Gg^Fet, Gs^Fds, Gs^Fds, Gg^Efm, Cv, 2 Kv, Cv, Gg^Efm, Gs^Fp, Gs^Fp, Gs, Gs, Gs
Gs, Gs, Gs, Gs, Gs^Fp, Gs^Fp, Gs^Fds, Gs^Fds, Gs^Fds, Gs^Fds, Gs^Fds, Hh^Fds, Rp, Gs^Fds, Gs^Fds, Gs^Fds, Gs^Fds, Gs^Fds, Gs^Fds, Gs^Fds, Ww, Ww, Hh^Fds, Gs^Fds, Gs^Fds, Gs^Fds, Gs^Fds, Gs^Fds, Gs^Fds, Gs^Fds, Gs^Fds, Gs^Fds, Rp, Cv, Cv, Cv, Gg^Efm, Gs^Fp, Gs^Fp, Gs, Gs, Gs
Gs, Gs, Gs, Gs, Gs, Gs^Fp, Gs^Fp, Gs^Fms, Gs^Fds, Gs^Fds, Gs^Fds, Hh^Fds, Hh^Fds, Rp, Gs^Fds, Gg^Fet, Gs^Fds, Gg^Ve, Gs^Fds, Gs^Fds, Ww, Hh^Fds, Gs^Fds, Gs^Fds, Rp, Rp, Rp, Rp, Rp, Rp, Rp, Rp, Gs^Fds, Gg^Efm, Gg^Efm, Gg^Efm, Gs^Fp, Gs^Fp, Gs, Gs, Gs, Gs
Gs^Fp, Gs, Gs, Gs, Gs, Gs, Gs^Fp, Gs^Fds, Gg^Fet, Gs^Fds, Gs^Fds, Hh^Fds, Hh^Fds, Rp, Rp, Gs^Fds, Gs^Fds, Gs^Fds, Gs^Fds, Ww, Hd, Hh^Fds, Gs^Fds, Rp, Gs^Fds, Gs^Fds, Gs^Fds, Gs^Fds, Gs^Fds, Gs^Fds, Gs^Fds, Gs^Fds, Gs^Fds, Gs^Fds, Gs^Fds, Gs^Fds, Gs^Fp, Gs, Gs^Fp, Gs, Gs, Gs
Gs, Gs, Gs, Gs, Gs^Fp, Gs, Gs^Fp, Gs^Fds, Gs^Fds, Gs^Fds, Gs^Fds, Hh^Fds, Gs^Fds, Gs^Fds, Gs^Fds, Rp, Rp, Gs^Fds, Gs^Fds, Ww, Hd, Gs^Fds, Rp, Rp, Gs^Fds, Gs^Fds, Gs^Fds, Gg^Fet, Gs^Fds, Gs^Fds, Gs^Fds, Gs^Fds, Gs^Fds, Gs^Fds, Gs^Fds, Gs^Fms, Gs^Fp, Gs^Fp, Gs^Fp, Gs^Fp, Gs, Gs
Gs, Gs, Gs, Gs^Fp, Gs^Fp, Gs^Fp, Gs^Fds, Gs^Fds, Gs^Fds, Gs^Fds, Gs^Fds, Hh^Fds, Gg^Fet, Gs^Fds, Gs^Fds, Gs^Fds, Gs^Fds, Rp, Gs^Fds, Ww, Ww^Bw/, Rp, Hh^Fds, Gs^Fds, Gs^Fds, Gs^Fds, Gs^Fds, Gs^Fds, Gs^Fds, Gg^Fet, Gs^Fds, Gg^Ve, Gs^Fds, Gs^Fds, Gs^Fds, Gs^Fds, Gs^Fp, Gg^Ve, Gs^Fp, Gs^Fds, Gs, Gs
Gs, Gs, Gs, Gs^Fp, Gs^Fds, Gs^Fds, Gs^Fds, Gg^Fet, Gg^Ve, Gs^Fds, Gs^Fds, Hh^Fds, Hh^Fds, Gs^Fds, Gg^Ve, Gs^Fds, Gs^Fds, Rp, Rp, Rp, Gs^Fds, Ww, Hh^Fds, Hh^Fds, Gs^Fds, Gg^Ve, Gs^Fds, Gs^Fds, Gs^Fds, Gs^Fds, Gs^Fds, Gs^Fds, Gs^Fds, Gg^Fet, Gs^Fds, Gs^Fp, Gs^Fp, Gs^Fp, Gs, Gs, Gs, Gs
Gs^Fp, Gs, Gs, Gs^Fp, Gs^Fp, Gs^Fms, Gs^Fds, Gs^Fds, Gs^Fds, Gs^Fds, Hh^Fds, Hh^Fds, Hh^Fds, Gs^Fds, Gs^Fds, Gs^Fds, Gs^Fds, Gs^Fds, Rp, Gs^Fds, Gg^Fet, Ww, Ww, Hh^Fds, Ww, Gs^Fds, Gs^Fds, Gs^Fds, Gg^Fet, Gs^Fds, Gs^Fds, Gs^Fds, Gs^Fms, Gs^Fds, Gs^Fds, Gs^Fp, Gs^Fp, Gs^Fp, Gs, Gs, Gs, Gs
Gs^Fp, Gs, Ce, Gs, Gs^Fp, Gs^Fp, Gs^Fp, Gs^Fds, Gs^Fds, Gs^Fds, Gg^Fet, Md, Md, Hh^Fds, Gs^Fds, Gs^Fds, Gs^Fds, Gs^Fds, Rp, Gs^Fds, Wwf, Ww, Gs^Fds, Ww, Wwf, Hh^Fds, Hh^Fds, Gs^Fds, Gs^Fds, Gs^Fds, Gs^Fds, Gs^Fds, Gs^Fds, Gs^Fds, Gs^Fds, Gs^Fms, Gs^Fp, Gs^Fp, Gs^Fp, Gs, Gs, Gs
Gs^Fp, Ce, 1 Ke, Ce, Gs, Gs^Fp, Rp, Gs^Fds, Rp, Gs^Fds, Gs^Fds, Hh^Fds, Hh^Fds, Hh^Fds, Gs^Fds, Gs^Fds, Gs^Fds, Gs^Fds, Rp, Ww, Ww, Gs^Fds, Gs, Gs^Fds, Ww, Hh^Fds, Hh^Fds, Hh^Fds, Hh^Fds, Gs^Fds, Gg^Ve, Gs^Fds, Rp, Rp, Rp, Gs^Fds, Rp, Gs^Fp, Gs^Fp, Gs, Gs, Gs
Gs^Fp, Ce, Ce, Ce, Re, Rp, Gs^Fp, Rp, Gs^Fds, Rp, Rp, Gs^Fds, Rp, Gs^Fds, Rp, Gs^Fds, Rp, Rp, Ww, Ww, Gs^Fds, Wwf, Ww, Gs^Fds, Ww, Hh^Fds, Hh^Fds, Hh^Fds, Gs^Fp, Hh^Fds, Rp, Rp, Gs^Fds, Gs^Fds, Gs^Fds, Rp, Gs^Fds, Rp, Rp, Gs, Re, Re
Gs^Fp, Gs, Re, Re, Gs, Gs^Fp, Gg^Ve, Gs^Fds, Gs^Fds, Gs^Fds, Gs^Fds, Rp, Gs^Fds, Rp, Gg^Ve, Rp, Ww^Bw\, Ww, Gs^Fds, Gs^Fds, Hh^Fds, Gs^Fds, Gs^Fds, Ww, Ww, Gg^Ve, Gs^Fp, Gs^Fp, Rp, Rp, Gs^Fds, Gs^Fds, Gs^Fds, Gg^Fet, Gs^Fds, Gg^Ve, Gs^Fds, Gs^Fp, Gs^Fp, Re, Gs, Gs
Re, Re, Gs, Gs, Gs^Fp, Gs^Fds, Gg^Fet, Hh^Fds, Hh^Fds, Hh^Fds, Hh^Fds, Gs^Fds, Gs^Fds, Gs^Fds, Ww, Ww, Gs^Fds, Rp, Rp, Rp, Rp, Hh^Fds, Hh^Fds, Gs^Fds, Gs^Fds, Ww, Ww, Gs^Fp, Rp, Gs^Fds, Gs^Fds, Gs^Fds, Gs^Fds, Gs^Fds, Gs^Fds, Gs^Fds, Gs^Fds, Gs^Fds, Gs^Fp, Gs, Gs, Gs
Gs^Fp, Gs, Gs, Gs, Gs^Fp, Gs^Fds, Gs^Fds, Gs^Fds, Hh^Fds, Hh^Fds, Hh^Fds, Gs^Fds, Ww, Ww, Gs^Fds, Gs^Fds, Gs^Fds, Gs^Fds, Rp, Gs^Fp, Hd, Rp, Rp, Gg^Ve, Gg^Fet, Gs^Fds, Rp, Wwf, Ww, Gs^Fds, Gg^Fet, Gs^Fds, Gs^Fds, Gs^Fds, Gg^Fet, Gs^Fds, Gs^Fms, Gs^Fds, Gg^Ve, Gs^Fp, Gs^Fp, Gs^Fds
Gs^Fp, Gs, Gs, Gs, Gs^Fp, Gs^Fp, Gs^Fds, Gs^Fds, Gs^Fds, Hh^Fds, Hh^Fds, Gs^Fds, Ww, Gs^Fds, Gs^Fds, Gs^Fds, Rp, Rp, Gs^Fp, Gs^Fp, Hd, Hd, Rp, Gs^Fp, Gs^Fp, Rp, Gs^Fp, Gs^Fp, Ww, Gs^Fds, Gs^Fds, Gs^Fds, Gs^Fds, Gs^Fds, Gs^Fds, Gs^Fds, Gs^Fds, Gs^Fds, Gs^Fp, Gs^Fp, Gs, Gs^Fp
Gs, Gs, Gs, Gs^Fp, Gs^Fp, Gs^Fds, Gs^Fds, Gg^Fet, Gs^Fds, Gs^Fds, Hh^Fds, Hh^Fds, Ww, Gs^Fds, Rp, Rp, Gs^Fp, Gg^Ve, Gs^Fp, Gs^Fp, Hh^Fds, Hh^Fds, Gs^Fds, Rp, Rp, Rp, Hh^Fp, Hh^Fp, Ww, Gs^Fds, Gg^Ve, Gs^Fds, Gs^Fds, Gs^Fms, Gs^Fds, Gs^Fds, Gs^Fms, Gs^Fds, Gs^Fp, Gs, Gs, Gs
Gs, Gs, Gs, Gs^Fp, Gs^Fds, Gs^Fds, Gs^Fds, Gs^Fds, Gg^Ve, Gg^Fet, Ww, Wwf, Rp, Rp, Hh^Fds, Gs^Fp, Gs^Fp, Gg^Fet, Gs^Fp, Hh^Fds, Hh^Fds, Hh^Fds, Gs^Fms, Rp, Rp, Gs^Fp, Hh^Fp, Hh^Fp, Gs^Fds, Ww, Ww, Gs^Fds, Gs^Fds, Gs^Fds, Gs^Fds, Gs^Fds, Gs^Fds, Gs^Fp, Gs^Fp, Gs, Gs, Gs
Gs^Fp, Gs, Gs^Fp, Gs^Fp, Gs^Fp, Gg^Fet, Gs^Fds, Gs^Fds, Gs^Fds, Gs^Fds, Ww, Hh, Rp, Hh^Fds, Hh^Fds, Hh^Fds, Hh^Fds, Gs^Fp, Gs^Fp, Hh^Fds, Gs^Fds, Gs^Fds, Gs^Fds, Gs^Fds, Rp, Gs^Fp, Gs^Fp, Hh^Fp, Gs^Fds, Gs^Fds, Gs^Fds, Ww, Ww, Gs^Fds, Gs^Fds, Gs^Fds, Gg^Ve, Gs^Fp, Gs, Gs, Gs, Gs^Fp
Gs, Gs, Gs, Gs^Fds, Gs^Fp, Gs^Fds, Gs^Fds, Gs^Fds, Ww, Ww, Gs^Fp, Hh, Rp, Gs^Fds, Gs^Fds, Hh^Fds, Hh^Fds, Hh^Fds, Gs^Fp, Hh^Fds, Gs^Fds, Gg^Ve, Gs^Fds, Gs^Fds, Gs^Fds, Rp, Rp, Hh^Fp, Gs^Fds, Gg^Fet, Gs^Fds, Gs^Fds, Gs^Fds, Ww, Gg^Fet, Gs^Fds, Gs^Fds, Gs^Fp, Gs^Fp, Gs, Gs, Gs^Fp
Gs, Gs, Ss, Gs^Fp, Ww, Ww, Ww, Ww, Gg^Efm, Gs^Fp, Gs^Fp, Gs^Fp, Rp, Gs^Fms, Gs^Fds, Gg^Fet, Gs^Fds, Hh^Fds, Hh^Fds, Hh^Fds, Gs^Fds, Gs^Fds, Gg^Fet, Gs^Fds, Gs^Fds, Gg^Fet, Rp, Gs^Fms, Gs^Fms, Gs^Fds, Gs^Fds, Gs^Fds, Gs^Fds, Ww, Ww, Gs^Fds, Gs^Fds, Gs^Fds, Gs^Fp, Gs, Gs, Gs
Gs^Fp, Ss, Ww, Ww, Gs^Fds, Gs^Fds, Gg^Efm, Gg^Efm, Cv, Gg^Efm, Rp, Rp, Gs^Fds, Gs^Fds, Gs^Fds, Gs^Fds, Gs^Fds, Hh^Fds, Hh^Fds, Hh^Fds, Gs^Fds, Gs^Fds, Gs^Fds, Gs^Fms, Gs^Fds, Gs^Fds, Rp, Gs^Fds, Gs^Fds, Gs^Fds, Chr, Chr, Chr, Gs^Fds, Gs^Fds, Ww, Gs^Fds, Gs^Fds, Gs^Fp, Gs, Gs^Fp, Gs
Ww, Ww, Ss, Gs^Fp, Gs^Fds, Gs^Fds, Gg^Efm, Cv, 3 Kv, Cv, Gg^Efm, Gs^Fds, Gs^Fds, Gs^Fds, Gs^Fds, Gg^Ve, Gs^Fds, Hh^Fds, Gs^Fds, Gs^Fds, Gs^Fds, Gs^Fds, Gs^Fds, Gs^Fds, Gs^Fms, Gs^Fds, Gs^Fds, Rp, Rp, Gs^Fds, Chr, 4 Kh, Chr, Gs^Fds, Gs^Fds, Ww, Gs^Fds, Gs^Fds, Gs^Fds, Gs^Fp, Gs^Fp, Gs^Fds
Ss, Ss, Ss, Gs^Fp, Gs^Fds, Gs^Fds, Gg^Efm, Cv, Cv, Cv, Gg^Efm, Gs^Fds, Gs^Fms, Gs^Fds, Hh^Fds, Gs^Fds, Hh^Fds, Hh^Fds, Gs^Fds, Gg^Ve, Gs^Fds, Gs^Fds, Gg^Fet, Gs^Fds, Gs^Fms, Gs^Fds, Gg^Ve, Gs^Fds, Gs^Fds, Rp, Gs^Fds, Chr, Gs^Fds, Gs^Fds, Gs^Fds, Ww, Gs^Fds, Gs^Fds, Gs^Fds, Gs^Fms, Gs^Fp, Gs^Fds
Ss, Ss, Gs^Fp, Gs^Fp, Gs^Fds, Gs^Fds, Gs^Fds, Gg^Efm, Gg^Efm, Gg^Efm, Gs^Fds, Gs^Fds, Gs^Fds, Gs^Fds, Hh^Fds, Hh^Fds, Hh^Fds, Gs^Fds, Gs^Fds, Gs^Fds, Hd, Gs^Fds, Gs^Fds, Gs^Fds, Gs^Fds, Gs^Fds, Gs^Fds, Gs^Fds, Rp, Rp, Gs^Fds, Gs^Fds, Gs^Fds, Gs^Fds, Gs^Fds, Ww, Ww, Gs^Fds, Gs^Fds, Gs^Fds, Gs^Fp, Gs^Fds
Gs, Gs, Gs, Gs^Fp, Gs^Fms, Gs^Fds, Gs^Fms, Gs^Fds, Gs^Fds, Gs^Fms, Gs^Fds, Gs^Fds, Gs^Fds, Gs^Fds, Hh^Fds, Hh^Fds, Hh^Fds, Gs^Fds, Gs^Fds, Hd, Hd, Gs^Fds, Hh^Fms, Hh^Fms, Hh^Fms, Gs^Fds, Gs^Fds, Rp, Gs^Fds, Gs^Fds, Gs^Fds, Gs^Fms, Gs^Fds, Gg^Fet, Gs^Fds, Gs^Fds, Gs^Fds, Ww, Gs^Fds, Gg^Fet, Gs^Fp, Gs^Fds
Gs, Gs, Gs, Gs^Fp, Gs^Fp, Gs^Fds, Gs^Fds, Gs^Fds, Hh^Fds, Gs^Fds, Gs^Fds, Gs^Fds, Gg^Ve, Gs^Fds, Gs^Fds, Hh^Fds, Hh^Fds, Gs^Fds, Gs^Fp, Hd, Hd, Gs^Fds, Hh^Fms, Hh^Fms, Hh^Fms, Hh^Fms, Gs^Fds, Rp, Gs^Fds, Gs^Fds, Gs^Fds, Gs^Fds, Gs^Fds, Gs^Fds, Gs^Fds, Gg^Fet, Gs^Fds, Ww, Gs^Fds, Gs^Fds, Gs^Fp, Gs^Fds
Gs^Fp, Gs, Gs, Gs^Fp, Gs^Fp, Gs^Fds, Hh^Fds, Hh^Fds, Hh^Fds, Gs^Fds, Gs^Fds, Gs^Fds, Gs^Fds, Gs^Fds, Gs^Fds, Gs^Fp, Gs^Fp, Gs^Fp, Gs^Fp, Gs^Fp, Hd, Hh^Fms, Hh^Fms, Hh^Fms, Hh^Fms, Hh^Fms, Hh^Fms, Rp, Gs^Fds, Gs^Fds, Gg^Fet, Gs^Fds, Gs^Fds, Gs^Fms, Gs^Fds, Gs^Fds, Gs^Fds, Ww, Gs^Fds, Gs^Fds, Gs^Fds, Gs^Fds
Hh^Fds, Gs^Fp, Gs^Fp, Gs^Fp, Gs^Fp, Gs, Gs^Fp, Hh^Fds, Hh^Fds, Gs^Fds, Hh^Fds, Gs^Fds, Hh^Fds, Gs^Fds, Gs^Fp, Gs^Fp, Gs^Fp, Gs^Fp, Gs^Fp, Gs^Fp, Md, Md, Md, Md, Md, Hh^Fms, Md, Rp, Rp, Gs^Fds, Hh^Fds, Gs^Fds, Gs^Fds, Gs^Fds, Gs^Fds, Gs^Fds, Hh^Fds, Ww, Ww, Gs^Fds, Gg^Fet, Gs^Fds
Md, Md, Md, Gs^Fp, Md, Gs^Fp, Gs^Fp, Hh^Fds, Gs^Fp, Gs^Fds, Gs^Fds, Hh^Fds, Gs^Fp, Md, Gs^Fp, Gs^Fp, Md, Md, Mm, Mm, Mm, Md, Mm, Mm, Mm, Mm, Mm, Md, Rp, Hh^Fds, Hh^Fds, Hh^Fds, Gs^Fds, Gs^Fms, Gs^Fds, Hh^Fds, Hh^Fds, Hh^Fds, Ww, Gs^Fds, Gs^Fds, Gs^Fds
Gs^Fp, Gs^Fp, Gs^Fp, Md, Gs, Gs, Gs^Fp, Hh^Fds, Hh^Fds, Gs^Fp, Gs^Fp, Gs^Fp, Gs^Fp, Gs^Fp, Gs^Fp, Hh^Fds, Gs^Fp, Md, Mm, Mm, Mm, Mm, Mm, Mm, Mm, Mm, Mm, Md, Rp, Hh^Fds, Hh^Fds, Hh^Fds, Gs^Fds, Gs^Fds, Gs^Fds, Hh^Fds, Hh^Fds, Hh^Fds, Ww, Gs^Fds, Gs^Fds, Gs^Fds
