border_size=1
usage=map

Hhd, Hhd, Hhd, Hhd, Hhd, Hhd, Hhd, Hhd, Hhd, Gd, Re, Gd, Gd, Hhd, Hhd, Hhd, Hhd^Fdf, Hhd^Fdf, Hhd^Fdf, Re, Re, Hhd, Hhd, Hhd^Fdf, Hhd^Fdf, Gs^Fdf, Gs^Fdf, Gs^Fdf, Gs, Gd, Gd, Re, Gs, Gd, Re, Gs, Gd, Gd, Gs, Gs, Gs^Fmf, Gs^Fmf
Hhd, Hhd, Hhd^Fdf, Hhd^Fdf, Hhd, Hhd, Hhd, Hhd, Hhd, Gd, Re, Gd, Gd, Hhd, Hhd, Hhd, Hhd^Fdf, Hhd^Fdf, Gs^Fdf, Re, Re, Hhd, Hhd, Hhd^Fdf, Hhd^Fdf, Hhd^Fdf, Gs^Fdf, Gs^Fdf, Gs, Gd, Gd, Re, Gs, Gd, Re, Gs, Re, Gd, Gs, Gs, Gs^Fmf, Gs^Fmf
Hhd, Hhd, Hhd, Hhd^Fdf, Hhd, Gd, Re, Gd, Gd, Re, Re, Re, Re, Gd, Gs^Fdf, Hhd, Hhd, Hhd^Fdf, Gs^Fdf, Re, Gs^Fdf, Gs^Fdf, Gs^Fdf, Gd, Gd^Vh, Gs^Fdf, Gs^Fdf, Gs^Fdf, Gs, Gs, Gs^Vh, Re, Gs, Re, Gs^Fdf, Gs, Gs, Gs, Gs, Gs^Fdf, Gs^Fmf, Gs^Fp
Hhd^Fdf, Hhd^Fdf, Hhd^Fdf, Hhd, Hhd, Re^Ecf, Gs, Re, Re, Ce, 2 Ke, Ce, Re, Gd, Gs^Fdf, Gs^Fdf, Gs^Fdf, Gs^Fdf, Gs^Vh, Gs^Fdf, Gs^Fdf, Gs^Fdf, Re, Gs, Gs, Gs, Re, Gs, Gd, Gs, Re, Re, Gd, Gs, Gs^Fdf, Gs^Fdf, Gs^Fdf, Gs^Fdf, Gs^Fmf, Gs^Fdf, Gs^Fp, Gs^Fp
Gs^Fdf, Hhd^Fdf, Hhd^Fdf, Hhd, Hhd, Hhd, Gs^Vh, Gs, Re, Ce, Re, Ce, Re, Re, Gs^Fdf, Gs^Vh, Gs^Fdf, Gs^Fdf, Gs^Fdf, Gs^Fdf, Gs, Gs, Gd, Re, Re, Re, Ss, Re, Re, Re, Gd, Gd, Gs, Gd, Gs^Fdf, Gs^Fmf, Gs^Fdf, Gs^Fmf, Gs^Fdf, Gs^Fdf, Gs^Fmf, Gs^Fp
Gs^Fdf, Gs^Fdf, Gs^Fdf, Hhd, Hhd^Fdf, Hhd, Hhd, Re, Gd, Re, Ss, Re, Gs^Ecf, Gd, Gs^Fdf, Gs^Fdf, Gs^Fdf, Gs^Fdf, Gs^Fdf, Gs^Fdf, Gs, Gs, Re, Gd, Re, Re, Gs, Gs, Rr, Gs, Gs, Rd, Gs, Gs^Vh, Gs^Fdf, Gs^Fdf, Gs^Fmf, Gs^Fdf, Gs^Fdf, Gs^Fmf, Gs^Fp, Gs^Fp
Gs, Gs, Re, Gs^Fdf, Gs^Fdf, Gs^Fdf, Gs, Gd, Gd, Ss, Ss, Gs, Gs^Vh, Gs, Gs, Gs^Fdf, Gs, Gs^Fdf, Gs^Fdf, Gs^Fdf, Gs, Re, Gs, Re, Gs, Re, Gd, Gs, Rr, Gs, Chr, Chr, Chr, Gs, Gs, Gs^Fmf, Gs^Fmf, Gs^Fmf, Gs^Fdf, Gs^Fmf, Gs^Fmf, Gs^Fp
Gs, Gs, Gs, Gs^Fdf, Gs^Fdf, Gs^Fdf, Gd, Gs^Fdf, Gd, Ss, Gs^Fdf, Gs^Fdf, Gs^Fdf, Gs^Fdf, Gs^Fdf, Gs, Re, Gs, Gs^Fdf, Gs, Re, Re, Gd, Gs^Vh, Gs^Fdf, Gs, Gs, Gs, Rr, Rr, Chr, 1 Khr, Chr, Gd, Gs, Gs^Fdf, Gs^Fmf, Gs^Fdf, Hhd^Fmf, Gs^Fmf, Gs^Fdf, Gs^Fmf
Ww, Ww, Ww, Gs, Gs, Re, Re, Re, Re, Gd, Gs^Fdf, Gs^Fdf, Gd, Gs, Gd, Gs, Gd, Gs, Gd, Gs, Gs, Gs, Gs, Gs^Fdf, Gs^Fdf, Gs^Fdf, Gs^Fdf, Re, Gd, Re, Re, Chr, Re, Re, Gs, Gs, Hhd, Hhd^Fdf, Hhd^Fdf, Gs^Fmf, Gs, Gs
Ww, Ww, Ww, Ww, Gs, Gs, Gs^Vh, Re, Gd, Re, Re, Gd, Re, Gd, Gs, Re, Gd, Gd, Gd, Re, Gs, Gs, Gs^Fdf, Gs^Fdf, Gs^Fdf, Gs, Gd, Rr, Gd, Gd, Gs, Gs, Ss, Ss, Gs, Hhd, Hhd^Fdf, Hhd, Hhd^Fdf, Gs^Fdf, Gd, Gd
Gs, Gs, Ww, Ww, Ww, Ww, Ww, Gs, Ww, Re, Ww, Re, Re, Gd, Re, Gd, Re, Gd, Gs, Gd, Gs, Gs, Gs, Gd^Vh, Gs, Gs, Gd, Re, Gd, Gd, Gd^Vh, Gs, Ss, Ss, Gs, Gs, Hhd^Fdf, Hhd, Gs^Fdf, Gs, Rd, Gd
Gs^Fdf, Gs^Fdf, Hhd^Fdf, Ww, Ww, Ww, Ww, Ww, Ww, Ww, Ww, Ww, Ww, Re, Re, Gd, Gs, Gs^Fdf, Gs^Fdf, Gs, Re, Ss, Ss, Gs, Gd, Gs, Re, Re, Re, Gs, Gs, Gs, Gs, Gs, Gs^Fdf, Gs, Gs^Fdf, Gs^Fdf, Gs^Fdf, Gs^Fdf, Gs, Rd
Hhd, Hhd^Fdf, Hhd^Fdf, Gs^Fdf, Hhd, Gs, Gs^Fdf, Ww, Ss, Ss, Gs, Ww, Ww, Ww, Ww, Gs, Gs, Gs^Fdf, Gs, Gs, Gs, Ss, Gd, Gd, Rr, Rr, Gs, Gd, Gs, Re, Re, Gd, Gs, Gs^Vh, Gs^Fdf, Gs^Fdf, Gs, Gs^Fdf, Gs^Fdf, Gs^Fdf, Gs, Gs
Hhd, Hhd, Hhd, Hhd, Gs, Gs, Gs^Fdf, Gs, Ss, Ss, Gs, Gd, Gs, Ww, Ww, Ww, Gd, Gs, Rd, Gd, Gs, Gd, Re, Re, Gd, Re, Gd, Gd, Gs, Gd, Re, Gs, Re, Gs^Fdf, Gs^Fdf, Gs^Fdf, Re, Gs, Gd, Gs, Gd, Gd
Hhd, Hhd, Hhd, Hhd, Hhd, Hhd^Fdf, Hhd^Fdf, Gs, Gs, Gd, Hhd, Gs, Gd, Gs^Fdf, Ww, Ww, Gs, Gs, Gs, Gd, Gd, Re, Gd, Gs, Gd, Gs, Gs^Fdf, Re, Gs, Gd, Re, Gs, Gd, Gs, Gs, Gs, Gd, Gs, Gs, Re, Re, Re
Hhd, Hhd, Hhd^Fdf, Hhd, Hhd^Fdf, Hhd, Hhd, Gs, Hhd, Gs, Gs, Gs, Gs, Gs^Fdf, Gs^Fdf, Ww, Ww, Gd, Gs, Gs, Re, Re, Gd, Gs, Gs, Gs^Fdf, Gs^Fdf, Gs, Gd, Re, Gs, Gs, Gs, Re, Gs, Re, Re, Gs^Fdf, Gs, Gs, Gs, Gs
Hhd, Hhd^Fdf, Hhd^Fdf, Hhd, Hhd^Fdf, Hhd, Hhd, Hhd, Gs, Gs, Hhd, Hhd, Hhd, Gs, Gs, Ww, Ww, Ww, Gs^Vh, Re, Gs^Fdf, Gd, Gs, Gd, Gs^Fdf, Gs^Fdf, Gs, Gs, Gs, Re, Gs, Re, Gs, Re, Gs, Gd, Gs, Gs, Gs, Gd, Gs, Gs
Gs^Fdf, Gs^Fdf, Gs^Fdf, Gs^Fdf, Gs^Fdf, Gs^Fdf, Gs^Fdf, Gs^Fdf, Gd, Gs^Fdf, Gs^Fdf, Hhd, Gd, Hhd, Gd, Gs, Ww, Ww, Ww^Bw/, Re, Gs^Fdf, Gs, Gs, Re, Gs^Fdf, Gs^Fdf, Gs^Fdf, Gs, Gd, Re, Gs, Gs, Ss, Gs, Gs^Fdf, Gs, Gs^Fdf, Re, Gs^Fdf, Gs, Gd, Gd
Gs^Fdf, Gs^Fdf, Ww, Ww, Ww, Gs^Fdf, Ww, Gs^Fdf, Ss, Gs, Gs^Fdf, Gs^Fdf, Gs, Gd, Gs, Gs, Re, Ww^Bw/, Ww, Ww, Ww, Gs^Fdf, Gs^Fdf, Re, Gs^Fdf, Gs^Fdf, Gs, Re, Gs, Re, Gs, Ss, Ss, Re, Re, Gs^Fdf, Gs, Gs^Fdf, Gs^Fdf, Gs, Gs, Gs
Ww, Ww, Gs^Fdf, Gs, Gs, Ww, Gd, Ww, Ww, Ww, Ww, Gs^Vh, Gs, Gd, Re, Re, Gs^Vh, Ww, Ww, Wo, Ww, Gs^Fdf, Gs^Fdf, Gs, Gs, Gs^Fdf, Gs^Fdf, Gs^Vh, Gd, Re, Gd, Ss, Ss, Ss, Re, Re, Re, Gs^Fdf, Gs, Gs, Gs^Fdf, Gs^Fdf
Gs^Fdf, Gs^Fdf, Gs^Fdf, Gs^Fdf, Gs^Fdf, Gs^Fdf, Gs, Gs, Gs, Gd, Gs, Ww, Ww^Bw/, Re, Ss, Gs, Gs, Hhd, Ww, Wo, Wo, Ww, Re, Re, Re, Gs^Fdf, Gs, Gs, Gs, Re, Gs, Ss, Ss, Ss, Re, Gd, Gs, Gs, Gs^Fdf, Gs^Fdf, Gs^Fdf, Gs^Fdf
Gs^Fdf, Gs^Fdf, Gs^Fdf, Gs^Fdf, Re, Gs^Fdf, Gs, Gs^Fdf, Gs^Fdf, Gd, Gd, Re, Gs^Vh, Ww, Ww, Gs, Gs, Gs^Vh, Re, Ww, Wo, Ww, Ww, Re, Re, Re, Re, Gd, Gs, Re, Gs^Vh, Gs, Re, Ss, Re, Gs, Gs^Fdf, Gs^Fdf, Gs^Fdf, Gs^Fdf, Gd, Gd
Hhd^Fdf, Gs^Fdf, Hhd^Fdf, Gs^Fdf, Gs, Gs, Hhd, Hhd, Gs, Gd, Gd, Re, Gd, Gs, Gs, Ww, Ww, Ww, Ww, Ww, Ww, Wo, Wo, Ww, Ww, Ww, Ww, Re, Gs, Re, Re, Gs, Gs, Gd, Gd, Gs, Gs^Fdf, Gs^Fdf, Gs^Fdf, Gs^Fdf, Gs^Fdf, Gd
Hhd^Fdf, Hhd^Fdf, Hhd, Hhd, Hhd, Hhd, Hhd, Gs, Hhd, Gd, Gs, Rr, Gd, Rd, Gs^Fdf, Gs, Gs, Gs^Fdf, Gs^Fdf, Gs^Fdf, Gs, Ww, Ww, Wo, Wo, Wo, Wo, Ww, Ww, Gs, Re, Gs, Ww, Ss, Ww, Gs^Fdf, Gs, Gs^Fdf, Gd, Gs^Fdf, Gs^Fdf, Gs^Fdf
Hhd, Hhd, Hhd^Fdf, Hhd^Fdf, Hhd, Hhd, Hhd, Hhd, Hhd, Hhd, Gs, Re, Gs, Gs^Fdf, Gs^Fdf, Gs^Fdf, Re, Gs, Re, Gs^Fdf, Gs, Ss, Ss, Ww, Ww, Ww, Ww, Wo, Wo, Ww, Ww^Bw|, Ww, Wo, Ww, Wo, Ww, Ww, Ss, Ss, Gs^Fdf, Gs^Fdf, Gs^Fdf
Hhd, Hhd, Hhd, Hhd^Fdf, Hhd, Hhd, Gs, Gs, Gd^Vh, Gd, Gd, Rr, Rr, Gs, Gs, Gs, Gs, Gs, Gs, Gs, Ss, Ss, Ss, Ss, Gs, Gs, Gs, Ww, Ww, Ww, Ww^Bw|, Ww, Wo, Wo, Wo, Wo, Wo, Ww, Ww, Gs, Gs, Gs
Hhd, Hhd, Hhd, Hhd, Hhd, Hhd^Fdf, Gs^Fdf, Gs^Fdf, Gs^Fdf, Gs, Gs, Re, Gs, Rr, Re, Gs, Gd^Vh, Gs, Ss, Gs, Gs, Ss, Gs, Ss, Gs, Re, Gs^Fdf, Ss, Ss, Ss, Re, Ww, Ww, Ww, Ww, Ww, Ww, Wo, Wo, Ww, Ww, Ww
Hhd, Hhd, Hhd, Hhd, Gs, Gs, Gs^Fdf, Gs^Fdf, Gs^Fdf, Gs, Ch, Rr, Chr, Gd, Re, Gs, Gd, Gs, Gs, Gs, Gs^Fdf, Gs, Gs, Gd, Gd, Gd, Gs, Gs^Fdf, Gs^Fdf, Gs^Fdf, Re, Gd^Vh, Ss, Ss, Ss, Hhd, Hhd, Ww, Ww, Wo, Wo, Wo
Hhd, Hhd, Hhd, Hhd, Gs, Gs, Hhd^Fdf, Hhd^Fdf, Re^Ecf, Rr, Ch, 3 Khr, Chr, Gd, Re, Gs, Gs, Gd, Gs, Gd, Gs^Fdf, Gs^Fdf, Gs^Fdf, Gd, Gd, Gd^Vh, Gs, Gs^Fdf, Gs^Fdf, Gs^Fdf, Gs^Fdf, Re, Re, Ss, Gd^Vh, Hhd, Gs, Gs, Gs, Ww, Ww, Ww
Hhd^Fdf, Hhd^Fdf, Hhd^Fdf, Hhd, Gs, Hhd^Fdf, Hhd^Fdf, Gs^Fdf, Gs^Fdf, Rr, Re, Rr, Re, Gd, Re, Hhd, Hhd, Gs, Gs, Gs, Gs^Fdf, Gs^Fdf, Gs^Fdf, Gs^Fdf, Gs, Gd, Gs, Re, Gs^Fdf, Gs^Fdf, Gs^Fdf, Re, Re, Re, Gd, Gs, Gs^Fdf, Gs^Fdf, Gs^Fdf, Gs^Vh, Gs^Fdf, Gs^Fdf
Hhd, Hhd, Hhd^Fdf, Hhd^Fdf, Hhd^Fdf, Gs^Fdf, Gs^Fdf, Gs^Fdf, Gs^Fdf, Gd, Gd, Re, Hhd, Hhd, Re, Gs, Hhd, Hhd, Gs, Gs, Gs, Gs^Fdf, Gs^Fdf, Gs^Fdf, Gs, Gs^Fdf, Gs^Fdf, Gs, Gs^Fdf, Gs^Fdf, Chr, Ch, Rr, Re, Re, Re, Re, Gs^Fdf, Gs^Fmf, Gs^Fdf, Gs^Fmf, Gs^Fmf
Hhd, Hhd, Hhd, Hhd^Fdf, Gs^Fdf, Gs^Fdf, Gs^Fdf, Gs^Vh, Gs^Fdf, Gs, Gs, Gs, Gs, Hhd, Re, Gs, Hhd, Hhd, Gs, Gd, Re, Re, Gs^Fdf, Gs^Fdf, Gs^Fdf, Gs^Fdf, Gs^Fdf, Gs^Fdf, Gs^Fdf, Gs^Fdf, Gs^Fdf, 4 Khr, Chr, Re, Gs^Fdf, Gs^Fdf, Re, Gs^Fdf, Gs^Fdf, Gs^Fmf, Gs^Fmf, Gs^Fp
Hhd, Hhd, Hhd, Hhd^Fdf, Gs^Fdf, Gs^Fdf, Gs^Fdf, Gs^Fdf, Hhd, Hhd, Gs, Gd, Rr, Rr, Gs, Gs^Vh, Gd, Gs, Re, Re, Re, Gs, Gs, Gs^Fdf, Gs^Fdf, Gs^Fdf, Gs^Fdf, Gs^Fdf, Ss, Gs^Fdf, Gs^Fdf, Ch, Gs^Fdf, Re, Gs^Fdf, Gs^Fmf, Re, Gs^Fmf, Re, Gs^Fmf, Gs^Fmf, Gs^Fp
Hhd, Hhd, Hhd, Hhd, Hhd, Gs^Fdf, Hhd, Hhd, Hhd, Hhd, Gs, Rr, Gs, Gs, Hhd, Gs, Gs, Re, Re, Re, Re, Re, Gs^Vh, Gs^Fdf, Gs^Fdf, Gs^Fdf, Re^Vh, Ss, Ss, Ss, Gs^Fdf, Gs^Fdf, Gs^Fdf, Gs^Fdf, Gs, Gs^Vh, Re, Gs, Gs, Gs^Fdf, Gs^Fmf, Gs^Fp
Hhd, Hhd, Hhd, Hhd, Hhd, Hhd, Hhd, Hhd, Gs, Gs, Re, Re, Gs, Hhd, Hhd, Hhd, Gs, Gs, Gd, Gd, Gd, Re, Gs, Gs^Fdf, Gs^Fdf, Gs^Fdf, Gs, Ss, Ss, Ss, Ss, Gs^Fdf, Gs^Fdf, Gs^Fmf, Gs^Fdf, Gs, Re, Gs, Re^Ecf, Re, Gs^Fdf, Gs^Fp
Hhd^Fdf, Hhd, Hhd^Fdf, Hhd, Hhd, Hhd, Hhd, Hhd, Hhd, Gs, Re, Gs, Gs, Gd, Hhd, Hhd, Hhd, Gs, Hhd, Gd, Gs, Re, Gs, Gs, Gs, Gs, Re, Gs, Gs, Gs^Fdf, Gs^Fdf, Gs^Fdf, Gs^Fdf, Gs^Fmf, Gs^Fmf, Gs^Fmf, Re, Gs^Fdf, Gs^Fmf, Gs^Fdf, Gs^Fmf, Gs^Fdf
Gd^Fdf, Gd^Fdf, Hhd^Fdf, Hhd^Fdf, Hhd^Fdf, Hhd, Hhd, Hhd, Hhd, Gs, Re, Gs, Gs, Gs, Hhd, Hhd, Hhd, Hhd, Hhd, Gs, Gs, Gs, Gs, Gs, Gs, Gs, Gs, Gs, Gs, Gs^Fdf, Gs^Fdf, Gs^Fdf, Gs^Fmf, Gs^Fmf, Gs^Fmf, Gs^Fdf, Re, Gs^Fdf, Gs^Fmf, Gs^Fmf, Gs^Fp, Gs^Fp
Gd^Fdf, Gd^Fdf, Gd^Fdf, Hhd^Fdf, Hhd^Fdf, Hhd, Hhd, Hhd, Hhd, Gs, Gs, Re, Re, Gs, Gs, Hhd, Hhd^Fdf, Hhd, Hhd, Gs, Gs, Gg, Gg, Gg, Gs, Gg, Gs, Gs, Gd^Fdf, Gd^Fdf, Gd^Fdf, Gs, Gll^Fmf, Gll^Fmf, Gll^Fmf, Gs, Re, Gs, Gll^Fmf, Gll^Fmf, Gll^Fp, Gll^Fp
Hhd^Fdf, Hhd^Fdf, Hhd^Fdf, Gd^Fdf, Gd^Fdf, Hhd, Hhd, Hhd, Hhd, Hhd, Gs, Gs, Re, Gs, Gs, Hhd^Fdf, Hhd^Fdf, Hhd^Fdf, Hhd, Hhd, Hhd, Gs, Gd, Gs, Gs, Gs, Gs, Gs, Gd^Fdf, Gd^Fdf, Gd^Fdf, Gll^Fmf, Gll^Fmf, Gll^Fmf, Gll^Fmf, Gs, Gs, Re, Gs, Gll^Fp, Gll^Fp, Gll^Fp
Hhd, Hhd^Fdf, Gd^Fdf, Gd^Fdf, Hhd^Fdf, Hhd^Fdf, Hhd, Hhd, Hhd, Hhd, Gs, Gs, Re, Gs, Gs, Gd^Fdf, Hhd^Fdf, Hhd^Fdf, Hhd, Hhd, Gs, Gs, Gg, Gg, Gs, Gs, Gg, Gs, Gd^Fdf, Gd^Fdf, Gg, Gll^Fmf, Gll^Fmf, Gll^Fmf, Gg, Gg, Gs, Re, Gs, Gll^Fp, Gll^Fp, Gll^Fp


