border_size=1
usage=map

Ms, Ms, Ms, Ms, Ms, Ms, Ms, Ms, Ai, Ms, Ms, Ms, Ms, Ms, Ha, Ms, Ms, Ms, Ms, Ms, Ms, Ha, Ha, Ha, Aa, Aa, Rr, Rr, Aa, Aa, Aa, Ha, Ha, Ha, Ha, Ha, Ha
Ms, Ms, Ms, Ms, Ms, Ms, Ms, Ms, Ai, Ms, Ms, Ms, Ms, Ms, Ha, Ms, Ms, Ms, Ms, Ms, Ms, Ha, Ha, Ha, Aa, Aa, Rr, Rr, Aa, Aa, Aa, Ha, Ha, Ha, Ha, Ha, Ha
Ha, Ha, Ha, Ms, Ms, Ms, Ms, Ai, Ms, Ms, Ms, Ms, Ms, Ms, Ha^Vhha, Ms, Ms, Ms, Ms, Ms, Ms, Ha, Ha, Aa, Ha, Aa, Rr, Aa, Ai, Aa^Vha, Ha, Ha, Ha, Ha, Ms, Ms, Ms
Ha, Ha, Ha, Ha, Ha, Ms, Ms, Ms, Ms, Ms, Ms, Ms, Ai, Ai, Ms, Ms, Ms, Ms, Ms, Ms, Ha, Ha, Ha, Ha, Aa^Vha, Aa, Rr, Ai, Ai, Ai, Ha, Ha, Ha, Ms, Ms, Ms, Ms
Ha, Ha, Ha, Ha, Ha, Ha, Ha, Ha, Ha, Ha, Ai, Ai, Ha, Ms, Ms, Ms, Ms, Ms, Ha, Ha, Ha, Ha, Ha, Ha, Rr, Rr, Ha, Ha, Ha, Ha, Ha, Ha, Ms, Ms, Ms, Ms, Ms
Aa, Aa, Ha, Ha, Ha^Vhha, Ha, Ha, Ha, Ha, Ai, Aa, Aa, Ha, Ms, Ms, Ms, Ms, Ms, Ha, Ha, Aa, Ha, Chr, Aa, Rr, Cha, Cha, Ha, Ha, Ha, Ha, Ms, Ms, Ms, Ms, Ms, Ms
Aa^Fpa, Aa^Fpa, Aa^Fpa, Ha, Ha, Ha, Ha, Ha, Ai, Ai, Ha, Ha, Ha, Ms, Ms, Ms, Ms, Ms, Ha, Aa, Aa, Ha, Aa, Rr, Cha, 3 Kha, Ha, Ha, Ha, Ha, Ha, Ms, Ms, Ms, Ms, Ms, Ms
Aa^Fpa, Aa^Fpa, Aa^Fpa, Aa^Fpa, Aa^Fpa, Aa^Fda, Aa^Fda, Aa, Ai, Aa, Aa, Ha, Ha, Ha, Ha, Ms, Ms, Ha, Aa^Fpa, Ha, Aa, Aa, Rr, Rr, Aa^Fma, Cha, Ha, Ha, Ha, Ha, Ha, Ms, Ms, Ms, Ha^Vhha, Ms, Ms
Aa^Fpa, Aa^Fpa, Aa^Fma, Aa^Fma, Aa^Fma, Aa^Fma, Aa^Fda, Aa, Ai, Ai, Aa, Ha, Aa, Ha, Ha, Ms, Ms, Aa^Fpa, Aa^Fpa, Aa^Fpa, Rr, Rr, Aa^Vha, Aa^Fpa, Aa^Fpa, Aa^Fma, Aa, Ha, Ha, Ha, Ha, Ha, Ms, Ai, Ai, Ai, Ai
Aa^Fpa, Aa^Fma, Aa^Fma, Aa^Fma, Aa^Fma, Aa^Fma, Aa^Fda, Aa, Aa, Ai, Aa, Aa, Aa^Vha, Aa, Ai, Ms, Aa^Fma, Aa^Fpa, Aa^Fma, Aa^Fma, Rr, Aa, Aa, Aa^Fpa, Aa^Fma, Aa^Fma, Aa^Fma, Aa, Aa^Fda, Ha, Ha, Ha, Ai, Ai, Ms, Ms, Ms
Aa^Fpa, Aa^Fma, Aa^Fda, Ai, Cha, Aa^Fda, Aa, Aa, Ai, Ai, Ai, Aa, Ai, Ai, Aa, Aa^Fma, Aa^Fma, Aa^Fma, Aa^Fma, Rr, Aa, Aa, Ha, Ha, Ha, Ha, Ha, Aa^Fma, Aa^Fma, Aa^Fda, Ai, Ai, Ha, Ha, Ha, Ms, Ms
Aa^Fma, Aa^Fma, Aa^Fda, Cha, 2 Kha, Cha, Aa, Ai, Ai, Wo, Wo, Ai, Aa, Aa, Aa, Aa, Aa^Vha, Aa^Fma, Rr, Rr, Aa, Ha, Ha, Ha, Ha, Ha, Ha, Aa^Fda, Aa^Fda, Aa^Fda, Ai, Ha, Ha, Ha, Ha, Ha, Ha
Aa^Fda, Aa^Fma, Aa, Cha, Cha, Re, Re, Aa^Vha, Ai, Ai, Ai, Ai, Aa, Aa, Aa, Aa, Rr, Rr, Aa, Aa, Aa, Aa, Ha, Ha, Ha, Ha, Aa, Aa, Aa, Ai, Ha, Ha, Ha, Ha, Ha, Ha, Ha
Aa, Aa, Aa, Aa, Ai, Ai, Ai, Ai, Aa, Aa, Aa, Ai, Aa, Aa, Aa, Aa, Rr, Rr, Rr, Aa, Aa, Ha, Ha, Aa^Vha, Ai, Aa, Aa, Aa, Ai, Ai, Ha, Ha, Ha, Ha, Ha, Ha, Ha
Aa, Aa, Aa, Ai, Aa, Aa, Aa, Re, Re, Aa, Aa, Aa, Re, Aa, Re, Rr, Aa, Aa, Rr, Aa, Aa, Aa, Aa, Ai, Ai, Aa, Aa^Vha, Aa^Fda, Ai, Aa^Fda, Aa^Fda, Ha, Ha, Ha, Ai, Aa, Aa
Aa, Aa, Ai, Ai, Aa, Aa, Aa, Aa, Aa, Re, Re, Re, Aa^Vha, Re, Aa, Aa, Aa^Fda, Aa, Re, Aa^Vha, Aa, Aa, Ai, Ai, Wo, Ai, Ai, Ai, Aa^Fda, Aa^Fda, Aa^Fma, Aa, Aa, Aa, Aa^Fma, Aa, Aa
Ai, Ai, Aa, Aa, Aa, Aa, Aa, Aa, Aa, Aa, Aa, Aa, Ha, Ha, Ha, Aa^Fda, Aa^Fma, Aa^Fda, Re, Aa, Aa, Aa, Ai, Wo, Wo, Wo, Ai, Aa, Aa, Aa^Fda, Aa^Fda, Aa^Fma, Aa^Fma, Aa^Fma, Aa^Fma, Aa^Fma, Aa^Fma
Aa, Aa, Aa^Fma, Aa^Fma, Aa^Fma, Aa, Aa, Aa, Aa, Aa, Aa, Aa, Ha, Ha, Ha, Aa^Fma, Aa^Fma, Aa^Fda, Re, Aa, Aa, Ai, Aa^Vha, Ai, Ai, Ai, Aa, Aa, Aa, Aa^Fda, Aa^Fma, Aa^Fda, Aa^Fma, Aa^Fma, Aa^Fma, Aa^Fma, Aa^Fma
Aa, Aa, Aa^Fma, Aa^Fma, Aa^Fma, Aa^Fma, Aa^Fma, Aa, Aa, Aa, Ha, Ha, Ha, Ha, Aa^Fma, Aa^Fma, Aa^Fma, Aa^Fda, Re, Aa, Aa, Aa, Aa, Aa, Aa, Ai, Aa^Vha, Aa, Aa, Aa^Fma, Aa^Fma, Aa^Fma, Aa^Fma, Aa^Vha, Aa^Fma, Aa^Fma, Aa^Fma
Aa, Aa, Aa^Fma, Aa^Fma, Aa^Fma, Aa^Fma, Aa^Fma, Aa^Vha, Aa, Ha, Ha, Ha, Ai, Ha, Aa^Fma, Aa^Fma, Aa^Fma, Aa^Fda, Re, Aa, Aa, Aa, Aa, Aa, Aa, Ai, Aa, Aa, Aa, Aa, Aa, Aa^Fma, Aa^Fma, Aa^Fma, Ai, Aa^Fma, Aa^Fma
Aa, Aa, Aa^Fma, Aa^Fma, Aa^Fma, Aa^Fma, Aa^Fma, Aa^Fma, Aa^Fma, Ha, Ha, Ha, Ha, Ha, Ha, Aa^Fma, Aa^Fda, Aa^Fda, Re, Aa, Aa^Fda, Aa^Fda, Aa^Fda, Aa, Aa, Ai, Aa, Aa^Fda, Aa^Fda, Aa, Aa, Aa^Fma, Aa^Fma, Ai, Ai, Aa, Aa
Aa^Fma, Aa^Fma, Aa^Fma, Aa^Fma, Aa^Fma, Aa^Vha, Aa^Fma, Aa^Fma, Aa^Fma, Aa, Aa, Aa, Aa, Ha, Ha, Aa, Aa, Aa, Re, Aa, Aa^Fda, Aa^Fda, Aa^Fda, Aa, Aa, Ai, Ai, Aa^Fda, Aa^Fda, Aa^Vha, Aa, Aa, Aa, Aa, Ai, Aa, Aa
Aa^Fma, Aa^Fma, Aa^Fda, Aa^Fma, Aa^Fma, Aa^Fma, Aa, Aa^Fma, Aa, Aa, Aa, Aa, Ha, Ha, Ha, Aa, Aa, Aa, Re, Aa, Aa^Fda, Aa^Fda, Re, Aa^Fda, Aa^Vha, Ai, Ai, Ai, Ai, Aa, Aa, Aa, Aa, Aa, Aa, Aa, Aa
Aa^Fda, Aa^Fda, Ai, Aa^Fda, Aa^Fma, Aa^Fma, Aa, Aa, Aa, Ai, Ai, Aa, Aa, Ha, Aa^Fda, Aa^Fda, Aa^Fda, Aa, Aa, Re, Re, Re, Aa^Fda, Re, Re, Aa, Aa, Aa, Ai, Aa, Re, Aa, Cea, Cea, Cea, Aa, Aa
Aa^Fda, Aa^Fda, Ai, Aa^Fda, Aa, Aa, Aa^Vha, Aa, Aa, Ai, Ai, Aa, Aa^Fda, Aa^Fda, Aa^Fda, Aa^Fda, Aa^Fda, Aa^Fda, Aa, Re, Aa, Aa^Fda, Aa^Fda, Aa^Fda, Aa, Re, Re, Aa, Ai, Ai, Aa^Vha, Re, Cea, 1 Kea, Cea, Aa, Aa
Aa^Fda, Aa^Fda, Aa^Fda, Aa^Fda, Aa, Aa, Aa, Aa, Aa, Aa, Aa, Aa, Aa^Fda, Aa^Fda, Aa^Fda, Aa^Fda, Aa^Fda, Aa^Fda, Aa, Re, Aa^Vha, Aa^Fda, Aa^Fda, Aa^Fda, Aa^Fda, Aa^Fda, Re, Aa, Aa, Ww, Ww^Bw/, Re, Aa, Cea, Aa, Aa, Aa
Aa^Fda, Aa^Fda, Aa^Fda, Aa^Fda, Aa, Aa, Ha, Ha, Ha, Aa, Aa, Aa, Aa, Aa^Fda, Aa^Fda, Aa^Fda, Aa^Fda, Aa^Fda, Aa, Re, Aa, Aa^Fda, Aa^Fda, Aa^Fda, Aa^Fda, Aa^Fda, Aa^Fda, Re, Re, Re, Ww, Ww, Ww, Aa, Ww, Aa, Aa
Aa^Fda, Aa^Fda, Aa^Fda, Aa, Aa, Ha, Ha, Ha, Ha, Aa, Ha, Aa, Aa, Aa, Aa, Aa^Fda, Aa^Fda, Aa^Fda, Aa, Re, Aa, Aa, Aa^Fda, Aa^Fda, Aa^Fda, Aa^Fda, Aa, Aa, Aa, Aa^Vha, Ww, Ww, Ww, Ww, Ww, Ww, Ww
Aa^Fda, Aa^Fda, Aa^Fda, Aa^Fda, Aa, Ha, Ha, Ha, Ha, Ha, Ha, Ha, Ha, Aa^Vha, Ha, Ha, Ha, Aa, Re, Re, Aa^Fda, Aa^Fda, Aa^Fda, Aa^Fda, Aa^Fda, Aa, Ai, Aa, Aa, Aa, Ww, Ww, Ww, Ww, Ww, Ww, Ww
Aa^Fda, Aa^Fda, Aa^Fda, Aa^Fda, Ai, Aa, Ai, Ai, Ai, Ha, Ha, Ha, Ha, Ha, Ha, Ha, Ha, Aa, Re, Aa, Aa^Fda, Aa^Fda, Aa^Fda, Aa^Fda, Aa, Ai, Ai, Ai, Ww, Ww, Ww, Ww, Wo, Wo, Wo, Wo, Wo
Aa^Fda, Aa^Fda, Aa^Fda, Ai, Wo, Ai, Ai, Ai, Aa^Vha, Ha, Ha, Ai, Ha, Ha, Aa, Ha, Aa, Aa, Re, Aa, Aa, Aa^Fda, Aa^Fda, Aa^Fda, Aa, Ai, Ww, Ww, Ww, Ww, Wo, Ww, Wo, Wo, Wo, Wo, Wo
Aa^Fda, Aa^Fda, Aa^Fda, Ai, Ai, Wo, Ai, Aa, Ha, Ha, Ms, Ha, Ha, Ha, Re, Aa, Re, Re, Ha, Aa^Vha, Aa, Aa, Ai, Aa, Ww, Ww, Ww, Ww, Wo, Ww, Wo, Wo, Wo, Wo, Wo, Wo, Wo
Aa^Fda, Aa^Fda, Aa^Fda, Aa^Fda, Ai, Ai, Ha, Ha, Ms, Ms, Ms, Ms, Ms, Ms, Re, Re, Ha, Ha, Ha, Ha, Aa, Ai, Aa, Ai, Aa, Ww, Ww, Wo, Wo, Wo, Wo, Wo, Wo, Wo, Wo, Wo, Wo
Aa^Fda, Aa^Fda, Aa, Aa^Fda, Ai, Ha, Ha, Ha, Ha, Ha, Ms, Ms, Ha, Re, Ms, Ha, Ha, Ha, Aa, Aa, Aa^Fda, Aa^Fda, Aa^Fda, Aa, Aa, Ww, Ww, Wo, Wo, Wo, Wo, Wo, Wo, Wo, Wo, Wo, Wo
Aa, Aa, Aa, Aa, Ai, Ha, Ha, Ha, Ha, Ms, Ms, Ms, Ms, Re, Ms, Ha, Ha, Ha, Ha, Aa, Aa^Fda, Aa, Aa^Fda, Aa^Vha, Ai, Ai, Ww, Ww, Wo, Wo, Wo, Wo, Wo, Wo, Wo, Wo, Wo
Aa, Aa, Aa^Vha, Aa, Ww, Ha, Ha, Ha, Ms, Ms, Ms, Ms, Cud, Re, Ms, Ha, Ha, Ha, Ha, Aa^Fda, Aa^Fda, Aa^Fda, Aa^Fda, Aa, Ai, Ww, Ww, Ww, Wo, Wo, Wo, Wo, Wo, Wo, Wo, Wo, Wo
Ww, Ww, Ww, Ww, Aa, Aa, Ha, Ha, Ms, Ms, Ms, Cud, 4 Kud, Cud, Ms, Ms, Ha, Ha, Aa^Vha, Ha, Aa, Aa^Fda, Ai, Ai, Ww, Ww, Ww, Wo, Wo, Wo, Wo, Wo, Wo, Wo, Wo, Wo, Wo
Ww, Ww, Ww, Ww, Aa, Aa, Aa, Ha, Ha, Ms, Ms, Cud, Cud, Cud, Ms, Ms, Ha, Ha, Ha, Ha, Aa, Aa, Ai, Ww, Wo, Ww, Wo, Wo, Wo, Wo, Wo, Wo, Wo, Wo, Wo, Wo, Wo
Ww, Ww, Ww, Ww, Ai, Aa, Aa, Ha, Ha, Ha, Ha, Ms, Ms, Ms, Ms, Ms, Ha, Ha, Ha, Aa, Aa, Aa, Ai, Ww, Ww, Wo, Wo, Wo, Wo, Wo, Wo, Wo, Wo, Wo, Wo, Wo, Wo
Wo, Wo, Ww, Ww, Ai, Aa, Aa, Aa, Ha, Ha, Ha, Ha, Ha, Ha, Aa^Vha, Ha, Aa, Ha, Aa, Aa, Ai, Ai, Ww, Ww, Ww, Wo, Wo, Wo, Wo, Wo, Wo, Wo, Wo, Wo, Wo, Wo, Wo
Wo, Wo, Ww, Ww, Ww, Ai, Aa, Aa, Aa, Ha, Ha, Ha, Aa, Aa^Fda, Aa^Fda, Aa^Fda, Aa^Fda, Aa, Aa, Aa, Ai, Ww, Ww, Ww, Wo, Wo, Wo, Wo, Wo, Wo, Wo, Wo, Wo, Wo, Wo, Wo, Wo
Wo, Wo, Wo, Wo, Ww, Ai, Ai, Aa, Ai, Aa, Aa^Vha, Aa, Aa, Aa^Fda, Aa^Fda, Aa^Fda, Aa^Fda, Aa^Fda, Aa, Ai, Ai, Ww, Ww, Wo, Wo, Wo, Wo, Wo, Wo, Wo, Wo, Wo, Wo, Wo, Wo, Wo, Wo
Wo, Wo, Wo, Wo, Wo, Ww, Ww, Ai, Ai, Aa, Aa, Aa, Ai, Aa, Ai, Aa, Ai, Aa, Ai, Ai, Ww, Ww, Wo, Wo, Wo, Wo, Wo, Wo, Wo, Wo, Wo, Wo, Wo, Wo, Wo, Wo, Wo
Wo, Wo, Wo, Wo, Wo, Wo, Ww, Ai, Ww, Ai, Ai, Ai, Ai, Ai, Ww, Ai, Ai, Ai, Ai, Ai, Ww, Ww, Wo, Wo, Wo, Wo, Wo, Wo, Wo, Wo, Wo, Wo, Wo, Wo, Wo, Wo, Wo
Wo, Wo, Wo, Wo, Wo, Ww, Ww, Ww, Ww, Ww, Ww, Ww, Ww, Ww, Wo, Ww, Ww, Ww, Ww, Ww, Ww, Ww, Wo, Wo, Wo, Wo, Wo, Wo, Wo, Wo, Wo, Wo, Wo, Wo, Wo, Wo, Wo
Wo, Wo, Wo, Wo, Wo, Wo, Wo, Wo, Wo, Ww, Wo, Ww, Wo, Wo, Wo, Ww, Wo, Ww, Wo, Wo, Wo, Wo, Wo, Wo, Wo, Wo, Wo, Wo, Wo, Wo, Wo, Wo, Wo, Wo, Wo, Wo, Wo
Wo, Wo, Wo, Wo, Wo, Wo, Wo, Wo, Wo, Wo, Wo, Wo, Wo, Wo, Wo, Wo, Wo, Wo, Wo, Wo, Wo, Wo, Wo, Wo, Wo, Wo, Wo, Wo, Wo, Wo, Wo, Wo, Wo, Wo, Wo, Wo, Wo