border_size=1
usage=map

Wo          , Wo          , Ww          , Ww          , Ww          , Ww          , Ds          , Ds          , Ds          , Gs          , Gs          , Gs^Fds      , Gs^Fds      , Gs^Fds      , Gs          , Gs^Fds      , Gs^Fds      , Gs^Fds      , Gg          , Gg          , Gg          , Gg          , Gs^Fds      , Gs^Fds      , Gs^Fds      , Gs^Fds      , Gs^Fds      , Gs^Fds      , Gg          , Gs^Fds      , Gs^Fds      , Gg          , Gg          , Gg          , Ss          , Ss          , Ss          
Wo          , Wo          , Ww          , Ww          , Ww          , Ww          , Ds          , Ds          , Ds          , Gs          , Gs          , Gs^Fds      , Gs^Fds      , Gs^Fds      , Gs          , Gg^Vc       , Gs^Fds      , Gg          , Gg          , Gg          , Gg          , Gg          , Gs^Fds      , Gs^Fds      , Gs^Fds      , Gs^Fds      , Gs^Fds      , Gs^Fds      , Gg          , Gs^Fds      , Gs^Fds      , Gg          , Gg          , Gg          , Ss          , Ss          , Gg          
Wo          , Wo          , Wwr         , Ww          , Ww          , Ds          , Ce          , Ce          , Ds          , Ds          , Ds          , Gs          , Ds          , Gs          , Ds          , Gs^Fds      , Gs^Fds      , Gg          , Ss          , Gg          , Ss          , Gg          , Gg          , Gg          , Gs^Fds      , Ss          , Gs^Fds      , Gg          , Gg          , Gg          , Gg          , Gg          , Gg^Vc       , Gs^Fds      , Gs^Fds      , Gg          , Gs^Fds      
Wo          , Wo          , Wo          , Ww          , Ww          , Ds          , Ds          , 2 Ke        , Ce          , Ds          , Gs          , Ds          , Ds          , Ds          , Ds          , Gs          , Gg          , Ss          , Gs          , Ss          , Ss^Vhs      , Gg          , Gg          , Gg          , Gg^Vc       , Gs^Fds      , Gg          , Gg          , Gg          , Gg          , Ss          , Gg          , Gg          , Gs^Fds      , Gs^Fds      , Gs^Fds      , Gs^Fds      
Wo          , Wo          , Wo          , Wwr         , Ww          , Ww          , Ds          , Ce          , Ds          , Gs          , Gs^Vht      , Gs          , Ds          , Ds          , Gs          , Gs          , Gs          , Gs          , Gs          , Ss          , Ss          , Ss          , Ss          , Gg          , Gg          , Gg          , Gg          , Gg          , Gs          , Ss          , Ss          , Ss          , Ss          , Gg          , Gg          , Gg          , Gg          
Wo          , Wo          , Wwr         , Wwr         , Ww          , Ww          , Ww          , Ds          , Ds          , Ds          , Ds          , Ds          , Ds          , Ds          , Ds          , Ds          , Ds          , Ds          , Gs^Fds      , Gs^Fds      , Gs^Fds      , Ss          , Gg          , Gg          , Gg          , Gs^Fds      , Gs          , Gs          , Ds          , Gs          , Ss          , Ss          , Gg          , Gg          , Gg          , Gg          , Gg          
Wo          , Wo          , Wo          , Wwr         , Ww          , Ww^Vm       , Ww          , Ww          , Ww          , Ds          , Ds          , Ds          , Ds          , Gs          , Ds          , Ds          , Ds          , Ds          , Gs^Fds      , Gs^Fds      , Ss          , Ss          , Gg          , Ss          , Ss          , Gs^Fds      , Gs          , Ds          , Ds          , Gg          , Gg^Vc       , Ss          , Gg          , Gs^Fds      , Gs^Fds      , Gg          , Gg          
Wo          , Wo          , Wo          , Wo          , Wwr         , Ww          , Ww          , Ww          , Ww^Bw/      , Ds          , Gs          , Ds          , Gs          , Gs          , Gs          , Ds          , Gs          , Gg          , Gg          , Ss          , Ss          , Gg          , Gg          , Ss          , Ss          , Ss          , Gg          , Gs          , Gg          , Gg          , Gg          , Gg          , Gg          , Gs^Fds      , Gs^Fds      , Gg          , Gg          
Wo          , Wo          , Wo          , Wo          , Wo          , Ww          , Ww          , Ww          , Ww          , Ds          , Ds          , Ds          , Ds          , Ds          , Ds          , Gs          , Gs          , Ss          , Ss          , Ss          , Ss^Vhs      , Ss          , Gg          , Gg          , Ss          , Gg          , Gg          , Rd          , Rd          , Ss          , Ss          , Ss          , Ss          , Gg          , Gg          , Gg          , Gg          
Wo          , Wo          , Wo          , Wo          , Wo          , Wo          , Ww          , Ww          , Ww          , Ds          , Ds          , Ds          , Ds          , Ds          , Ds          , Gs          , Gs          , Ss          , Ss          , Gg          , Ss          , Ss          , Ss          , Ss          , Ss          , Gs^Fds      , Gs^Fds      , Gs^Fds      , Ss          , Rd          , Ww^Bw\      , Gs^Fp       , Ss          , Ss          , Ss          , Gg          , Gg          
Wo          , Wo          , Wo          , Wo          , Wo          , Wo          , Ww          , Ww          , Ww          , Ww          , Ds          , Gs          , Gg^Vc       , Ds          , Gg          , Gs          , Rd          , Gs          , Ww          , Ss          , Ww          , Ss          , Ss          , Ss          , Gs^Fds      , Gs^Fds      , Gs^Fds      , Gs^Fds      , Ss          , Ss          , Ss          , Rd          , Ss          , Ss          , Ss          , Gg          , Gg          
Wo          , Wo          , Wo          , Wo          , Wo          , Wo          , Wo          , Ww          , Ww^Vm       , Ww          , Gs          , Gg          , Gg          , Gg          , Ss          , Ss          , Ww^Bw|      , Ww          , Ww          , Ww          , Ww          , Ww          , Ww          , Ww          , Ww          , Gs^Fds      , Ww          , Ss          , Ss          , Ss^Vhs      , Ss          , Ww^Bw|      , Ss          , Ss          , Ss          , Ss          , Ss          
Wo          , Wo          , Wo          , Wo          , Wo          , Wo          , Wo          , Ww          , Ww          , Ww          , Gs          , Gs          , Ss          , Gs          , Ww          , Ww          , Ww^Bw|      , Ww          , Gs          , Ss          , Gs          , Ss          , Gg          , Ww          , Ww          , Ww          , Ww          , Ss          , Ww          , Ss          , Ww          , Rd          , Gs^Fds      , Gs^Fds      , Ss          , Gs^Fds      , Gs^Fds      
Wo          , Wo          , Wo          , Wo          , Wo          , Wo          , Wo          , Wo          , Wwr         , Ww          , Ww          , Ww          , Ww          , Ww          , Ss          , Ss          , Rd          , Gs          , Gs          , Ss          , Gg          , Gg          , Ss          , Ss          , Ss          , Ss          , Gg          , Ww          , Ww          , Ww          , Ww          , Rd          , Ww^Bw\      , Ww          , Ww          , Ww          , Ww          
Wo          , Wo          , Wo          , Wo          , Wo          , Wo          , Wwr         , Wo          , Wo          , Ww          , Ww          , Ww          , Gg          , Ss          , Ss          , Rd          , Ss          , Ss          , Ss          , Ss          , Gg          , Ss          , Ss          , Ss          , Gs^Fds      , Gs^Fds      , Gg          , Gg          , Gg          , Ss          , Ss          , Ww          , Ww          , Ww^Bw\      , Ww^Bw\      , Ss          , Ss          
Wo          , Wo          , Wo          , Wo          , Wo          , Wo          , Wo          , Wo          , Ww          , Ww          , Gg          , Gg          , Gg^Vc       , Ss          , Gg          , Rd          , Ss          , Ss^Vhs      , Ss          , Ss          , Ss          , Ss          , Ss          , Ss          , Gg          , Gs^Fds      , Gg          , Gg^Vc       , Gg          , Gg          , Gg          , Gg          , Ss          , Ss          , Gg          , Rd          , Rd          
Wo          , Wo          , Wo          , Wo          , Wo          , Wo          , Wwr         , Wwr         , Ww          , Ww          , Ds          , Gg          , Ds          , Gg          , Ds          , Gg          , Gs^Fds      , Gg          , Ss          , Ss          , Gg          , Ss          , Gg          , Ss          , Gg          , Gs^Fds      , Gg          , Gg          , Gg          , Gg          , Gg          , Ss          , Ch          , Ch          , Rd          , Rd          , Rd          
Wo          , Wo          , Wo          , Wo          , Wo          , Wo          , Wo          , Ww          , Ww          , Ww^Bw\      , Ds          , Gs          , Ds          , Ds          , Ds          , Gs          , Gs^Fds      , Gs^Fds      , Gs^Fds      , Gs          , Gs          , Gg          , Gg          , Gg          , Ss          , Gg          , Gg          , Gg          , Ds          , Gg          , Gg          , Ss          , Ss          , 1 Kh        , Ch          , Gg          , Gg          
Wo          , Wo          , Wo          , Wo          , Wo          , Wo          , Wo          , Ww          , Ww          , Ww          , Ww          , Ds          , Ds          , Gs          , Ds          , Gs          , Gs          , Gs^Fds      , Ds          , Ds          , Gs          , Gs          , Gs          , Ss          , Ss^Vhs      , Gg          , Gg          , Gg          , Ds          , Ds          , Gg          , Ss          , Ss          , Ch          , Gg          , Gg          , Gg          
Wo          , Wo          , Wo          , Wo          , Wo          , Wo          , Wwr         , Ww          , Ww^Vm       , Ww          , Ww          , Ds          , Ds          , Ds          , Gs          , Gs          , Gs          , Ds          , Ds          , Ds          , Ds          , Ds          , Gs          , Ss          , Ss          , Gg          , Gg          , Gg          , Gg          , Ds          , Gg          , Gg          , Gg          , Ss          , Gg          , Gg          , Gg          
Wo          , Wo          , Wo          , Wo          , Wo          , Wo          , Wwr         , Ww          , Ww          , Ww          , Ww          , Ds          , Ds          , Ds          , Ds          , Gs          , Gs          , Ds          , Ds          , Ds          , Ds          , Ds          , Ww          , Ww          , Ss          , Ss          , Ss          , Gg          , Gg          , Gg          , Gg          , Gs^Fds      , Gs^Fds      , Gg          , Gg          , Gg          , Gg          
Wo          , Wo          , Wo          , Wo          , Wwr         , Wo          , Ww          , Ww          , Ww          , Ww^Bw\      , Ds          , Ds          , Gs^Vht      , Ds          , Ds          , Ds          , Ds          , Gg          , Gg          , Gs          , Ds          , Gs          , Ss          , Ww          , Ss          , Ss          , Gg          , Ss          , Ss          , Ss          , Gg          , Gs^Fds      , Gg          , Gg          , Gg^Vc       , Gg          , Gg          
Wo          , Wo          , Wo          , Wo          , Wo          , Wo          , Ww          , Ww          , Ww          , Ww          , Ds          , Gs          , Gs          , Ds          , Ds          , Ds          , Gg          , Gg^Vc       , Gg          , Gs          , Gs          , Gs          , Gs          , Gg          , Gg          , Gg          , Gg          , Gg          , Ss          , Ss          , Gg          , Gg          , Gs^Fds      , Gs^Fds      , Gs^Fds      , Gg          , Gg          
Wo          , Wo          , Wo          , Wo          , Wwr         , Ww          , Ww          , Ww          , Ce          , Ds          , Ce          , Ds          , Ds          , Ds          , Gs          , Ds          , Gg          , Gg          , Gg          , Gg          , Gg          , Gg          , Gg          , Gg          , Gg          , Gg          , Gg          , Gg          , Gg          , Gg          , Ss          , Gg          , Gg          , Gs^Fds      , Gs^Fds      , Gg          , Gg          
Wo          , Wo          , Wo          , Wwr         , Ww          , Ww^Vm       , Ww          , Ds          , Ce          , 3 Ke        , Ce          , Ds          , Gs          , Ds          , Gs          , Gs          , Gg          , Gs^Fds      , Ds          , Gg          , Gg          , Gs^Fds      , Gs^Fds      , Gg^Vc       , Gs^Fds      , Gg          , Gg          , Gg          , Gg          , Ss          , Ss          , Ss          , Gg          , Gs^Fds      , Gs^Fds      , Gg          , Gs^Fds      
Wo          , Wo          , Wwr         , Wwr         , Ww          , Ww          , Ds          , Ds          , Ds          , Ds          , Gs          , Gs          , Gs          , Gs^Fds      , Gs^Fds      , Gs^Fds      , Gg          , Ds          , Ds          , Ds          , Ds          , Gs^Fds      , Gg          , Gs^Fds      , Gs^Fds      , Gs^Fds      , Gg          , Gg          , Gg          , Ss          , Gg          , Gg          , Gg          , Gs^Fds      , Gs^Fds      , Gs^Fds      , Gs^Fds      
Wo          , Wo          , Wwr         , Wwr         , Ww          , Ww          , Ds          , Ds          , Ds          , Ds          , Gs          , Gs          , Gs^Fds      , Gs^Fds      , Gs^Fds      , Gs^Fds      , Gs^Fds      , Gg          , Ds          , Ds          , Ds          , Gs^Fds      , Gg          , Gs^Fds      , Gg          , Gg          , Gg          , Gg          , Gg          , Gg          , Gg          , Gg          , Gg          , Gs^Fds      , Gs^Fds      , Gs^Fds      , Gs^Fds      
