border_size=1
usage=map

Mm          ,Mm          , Mm          , Mm          , Mm          , Mm          , Mm          , Mm          , Mm          , Mm          , Mm          , Mm          , Mm          , Mm          , Mm          , Mm          , Mm          , Mm          , Mm          , Mm          , Mm          , Mm          , Mm          , Mm          , Hh          , Gs^Fp       , Gs^Fp       , Re          , Gs^Fp       , Gs^Fp       , Mm          , Mm          
Mm          ,Mm          , Mm          , Mm          , Mm          , Mm          , Mm          , Mm          , Mm          , Mm          , Mm          , Mm          , Mm          , Mm          , Mm          , Mm          , Mm          , Mm          , Mm          , Mm          , Mm          , Mm          , Mm          , Mm          , Hh          , Gs^Fp       , Gs^Fp       , Re          , Gs^Fp       , Gs^Fp       , Mm          , Mm          
Mm          ,Mm          , Mm          , Mm          , Mm          , Mm          , Mm          , Mm          , Mm          , Mm          , Mm          , Mm          , Mm          , Mm          , Mm          , Mm          , Mm          , Mm          , Mm          , Mm          , Mm          , Mm          , Mm          , Hh          , Hh          , Gs^Fp       , Re          , Re          , Gs^Fp       , Hh          , Mm          , Mm          
Mm          ,Mm          , Mm          , Mm          , Mm          , Mm          , Mm          , Mm          , Mm          , Mm          , Mm          , Mm          , Mm          , Mm          , Mm          , Mm          , Mm          , Mm          , Mm          , Mm          , Mm          , Mm          , Mm          , Hh          , Hh          , Gs^Fp       , Re          , Gs^Fp       , Hh          , Hh          , Mm          , Mm          
Mm          ,Mm          , Mm          , Mm          , Mm          , Mm          , Mm          , Mm          , Hh          , Mm          , Mm          , Mm          , Mm          , Mm          , Mm          , Mm          , Mm          , Mm          , Mm          , Mm          , Mm          , Mm          , Hh          , Hh          , Gg^Vh       , Gg          , Re          , Gs^Fp       , Hh          , Hh          , Mm          , Mm          
Mm          ,Mm          , Mm          , Mm          , Mm          , Mm          , Mm          , Mm          , Uu^Vud      , Hh          , Mm          , Mm          , Mm          , Mm          , Mm          , Mm          , Mm          , Mm          , Hh          , Mm          , Mm          , Mm          , Hh          , Hh          , Gs          , Gg          , Re          , Gg          , Mm          , Mm          , Mm          , Mm          
Mm          ,Mm          , Mm          , Mm          , Mm          , Mm          , Mm          , Hh          , Mm          , Ww          , Ww          , Mm          , Ww          , Ww          , Ww          , Hh          , Hh          , Hh          , Ss          , Hh          , Ce          , Ce          , Ce          , Gs          , Re          , Re          , Gg^Vh       , Hh          , Mm          , Mm          , Mm          , Mm          
Mm          ,Mm          , Mm          , Mm          , Mm          , Mm          , Mm          , Mm          , Mm          , Ww          , Mm          , Ww          , Mm          , Hh          , Hh          , Ww          , Ww          , Hh          , Ww          , Ww          , Ce          , 1 Ke        , Ce          , Re          , Ss          , Gg          , Hh          , Hh          , Mm          , Mm          , Mm          , Mm          
Mm          ,Mm          , Mm          , Mm          , Mm          , Mm          , Mm          , Mm          , Mm          , Mm          , Mm          , Mm          , Mm          , Mm          , Hh          , Hh          , Gs^Fp       , Ww          , Ww          , Ww          , Ww          , Ww^Bw|      , Re          , Re          , Ss          , Ss          , Hh          , Hh          , Mm          , Mm          , Mm          , Mm          
Mm          ,Mm          , Mm          , Mm          , Mm          , Mm          , Mm          , Mm          , Mm          , Mm          , Mm          , Mm          , Mm          , Mm          , Mm          , Hh          , Gs^Fp       , Gs^Fp       , Gg^Vh       , Ss          , Re          , Re          , Ss          , Ss          , Hh          , Hh          , Mm          , Mm          , Mm          , Mm          , Mm          , Mm          
Mm          ,Mm          , Mm          , Mm          , Mm          , Mm          , Mm          , Mm          , Mm          , Mm          , Mm          , Mm          , Mm          , Mm          , Mm          , Mm          , Hh          , Gg          , Re          , Re          , Hh          , Hh          , Hh          , Hh          , Mm          , Mm          , Mm          , Mm          , Mm          , Mm          , Mm          , Mm          
Mm          ,Mm          , Mm          , Mm          , Mm          , Mm          , Mm          , Mm          , Mm          , Mm          , Mm          , Mm          , Mm          , Mm          , Gs^Fp       , Hh          , Gg          , Gg          , Re          , Hh          , Hh          , Mm          , Mm          , Mm          , Mm          , Mm          , Mm          , Mm          , Mm          , Mm          , Mm          , Mm          
Mm          ,Mm          , Mm          , Mm          , Mm          , Mm          , Mm          , Mm          , Mm          , Mm          , Mm          , Mm          , Hh          , Mm          , Gs^Fp       , Gs^Fp       , Gs^Fp       , Gg          , Re          , Hh          , Hh          , Mm          , Mm          , Mm          , Mm          , Mm          , Mm          , Mm          , Mm          , Mm          , Mm          , Mm          
Mm          ,Mm          , Mm          , Mm          , Mm          , Mm          , Mm          , Mm          , Mm          , Mm          , Hh          , Hh          , Gg          , Hh          , Gs^Fp       , Gs^Fp       , Gg          , Gg          , Re          , Hh          , Mm          , Mm          , Mm          , Mm          , Mm          , Mm          , Mm          , Mm          , Mm          , Mm          , Mm          , Mm          
Mm          ,Mm          , Mm          , Mm          , Mm          , Mm          , Mm          , Mm          , Hh          , Hh          , Gg          , Gg          , Re          , Gg          , Gg          , Gs^Fp       , Re          , Re          , Hh          , Mm          , Mm          , Mm          , Mm          , Mm          , Mm          , Mm          , Mm          , Mm          , Mm          , Mm          , Mm          , Mm          
Mm          ,Mm          , Mm          , Mm          , Mm          , Mm          , Mm          , Hh          , Gg          , Gg^Vh       , Re          , Re          , Gg          , Re          , Re          , Re          , Hh          , Hh          , Mm          , Mm          , Mm          , Mm          , Mm          , Mm          , Mm          , Mm          , Mm          , Mm          , Mm          , Mm          , Mm          , Mm          
Mm          ,Mm          , Mm          , Mm          , Mm          , Mm          , Mm          , Gs^Fp       , Gs^Fp       , Re          , Gg          , Gg          , Hh          , Gg^Vh       , Hh          , Hh          , Mm          , Mm          , Mm          , Mm          , Mm          , Mm          , Mm          , Mm          , Mm          , Mm          , Mm          , Mm          , Mm          , Mm          , Mm          , Mm          
Mm          ,Mm          , Mm          , Mm          , Hh          , Hh          , Gs^Fp       , Gs^Fp       , Re          , Re          , Hh          , Hh          , Mm          , Hh          , Mm          , Mm          , Mm          , Mm          , Mm          , Mm          , Mm          , Mm          , Mm          , Mm          , Mm          , Hh          , Hh          , Mm          , Mm          , Mm          , Mm          , Mm          
Mm          ,Mm          , Hh          , Hh          , Hh          , Gs^Fp       , Gs^Fp       , Re          , Gg^Vh       , Gg          , Mm          , Mm          , Mm          , Mm          , Mm          , Mm          , Mm          , Mm          , Mm          , Mm          , Mm          , Mm          , Mm          , Mm          , Mm          , Ww          , Gg^Vh       , Gs^Fp       , Mm          , Mm          , Mm          , Mm          
Mm          ,Mm          , Hh          , Hh          , Hh          , Gs^Fp       , Re          , Re          , Gg          , Gg          , Mm          , Mm          , Mm          , Mm          , Mm          , Mm          , Mm          , Mm          , Mm          , Mm          , Mm          , Mm          , Mm          , Mm          , Mm          , Ww          , Ww          , Hh          , Mm          , Mm          , Mm          , Mm          
Mm          ,Mm          , Hh          , Hh          , Hh          , Gg^Vh       , Re          , Gg          , Hh          , Hh          , Mm          , Mm          , Mm          , Mm          , Mm          , Mm          , Mm          , Mm          , Mm          , Mm          , Mm          , Mm          , Mm          , Mm          , Gs^Fp       , Ww          , Mm          , Mm          , Mm          , Mm          , Mm          , Mm          
Mm          ,Mm          , Hh          , Hh          , Hh          , Hh          , Re          , Re          , Hh          , Mm          , Mm          , Mm          , Mm          , Mm          , Mm          , Mm          , Mm          , Mm          , Mm          , Mm          , Mm          , Mm          , Mm          , Mm          , Ww          , Ww          , Mm          , Mm          , Mm          , Mm          , Mm          , Mm          
Mm          ,Mm          , Mm          , Hh          , Hh          , Gg^Vh       , Rr          , Re          , Ch          , Mm          , Mm          , Mm          , Mm          , Mm          , Mm          , Mm          , Mm          , Mm          , Mm          , Mm          , Mm          , Mm          , Mm          , Ww          , Ww          , Mm          , Mm          , Mm          , Mm          , Mm          , Mm          , Mm          
Mm          ,Mm          , Mm          , Mm          , Hh          , Rr          , Ch          , Rr          , Rr          , Hh          , Gs^Fp       , Hh          , Gs^Fp       , Hh          , Hh          , Mm          , Mm          , Mm          , Mm          , Mm          , Mm          , Mm          , Mm          , Mm          , Hh          , Ww          , Ww          , Mm          , Mm          , Mm          , Mm          , Mm          
Mm          ,Mm          , Mm          , Mm          , Mm          , Mm          , Hh          , Gs^Fp       , Gs^Fp       , Rd          , Rd          , Gs^Fp       , Gs^Fp       , Gs^Fp       , Hh          , Hh          , Hh          , Mm          , Mm          , Mm          , Mm          , Mm          , Mm          , Mm          , Mm          , Mm          , Mm          , Ww          , Mm          , Mm          , Mm          , Mm          
Mm          ,Mm          , Mm          , Mm          , Mm          , Mm          , Hh          , Hh          , Gs^Fp       , Gs^Fp       , Gg          , Rd          , Rd          , Gg^Vh       , Gs          , Hh          , Hh          , Hh          , Mm          , Mm          , Mm          , Mm          , Mm          , Mm          , Mm          , Mm          , Mm          , Ww          , Ww          , Mm          , Mm          , Mm          
Mm          ,Mm          , Mm          , Mm          , Mm          , Mm          , Mm          , Hh          , Hh          , Gs^Fp       , Hh          , Gg          , Gg          , Rd          , Gs          , Gs          , Hh          , Hh          , Mm          , Mm          , Mm          , Mm          , Mm          , Mm          , Mm          , Mm          , Mm          , Mm          , Mm          , Ww          , Mm          , Mm          
Mm          ,Mm          , Mm          , Mm          , Mm          , Mm          , Mm          , Mm          , Mm          , Hh          , Hh          , Hh          , Gg          , Rd          , Rd          , Gs          , Hh          , Hh          , Mm          , Mm          , Mm          , Mm          , Mm          , Mm          , Mm          , Mm          , Mm          , Mm          , Mm          , Ww          , Mm          , Mm          
Mm          ,Mm          , Mm          , Mm          , Mm          , Mm          , Mm          , Mm          , Mm          , Mm          , Mm          , Mm          , Hh          , Gg          , Rd          , Gs          , Hh          , Mm          , Mm          , Mm          , Mm          , Mm          , Mm          , Mm          , Mm          , Mm          , Hh          , Mm          , Ww          , Ww          , Mm          , Mm          
Mm          ,Mm          , Mm          , Mm          , Mm          , Mm          , Mm          , Mm          , Mm          , Mm          , Mm          , Hh          , Hh          , Gs^Fp       , Rd          , Gs          , Hh          , Mm          , Mm          , Mm          , Mm          , Mm          , Mm          , Mm          , Mm          , Mm          , Ww          , Ww          , Gs^Fp       , Mm          , Mm          , Mm          
Mm          ,Mm          , Mm          , Mm          , Mm          , Mm          , Mm          , Mm          , Mm          , Mm          , Mm          , Hh          , Hh          , Gs^Fp       , Rd          , Gg          , Hh          , Mm          , Mm          , Mm          , Mm          , Mm          , Mm          , Mm          , Mm          , Mm          , Ww          , Ss          , Gs^Fp       , Mm          , Mm          , Mm          
Mm          ,Mm          , Mm          , Mm          , Mm          , Mm          , Mm          , Mm          , Mm          , Mm          , Mm          , Hh          , Hh          , Gs^Fp       , Rd          , Gg^Vh       , Gs^Fp       , Hh          , Mm          , Mm          , Mm          , Mm          , Mm          , Mm          , Mm          , Mm          , Hh          , Ww          , Mm          , Mm          , Mm          , Mm          
Mm          ,Mm          , Mm          , Mm          , Mm          , Mm          , Mm          , Mm          , Mm          , Mm          , Mm          , Mm          , Hh          , Gg          , Rd          , Gs^Fp       , Hh          , Hh          , Mm          , Mm          , Mm          , Mm          , Mm          , Mm          , Mm          , Mm          , Hh          , Ww          , Mm          , Mm          , Mm          , Mm          
Mm          ,Mm          , Mm          , Mm          , Mm          , Mm          , Mm          , Mm          , Mm          , Mm          , Mm          , Mm          , Mm          , Gg          , Rd          , Gg          , Hh          , Hh          , Hh          , Mm          , Hh          , Mm          , Mm          , Mm          , Mm          , Hh          , Ww          , Ww          , Mm          , Mm          , Mm          , Mm          
Mm          ,Mm          , Mm          , Mm          , Mm          , Mm          , Mm          , Mm          , Mm          , Mm          , Mm          , Mm          , Mm          , Gg^Vh       , Rd          , Gg          , Gg          , Hh          , Hh          , Mm          , Hh          , Hh          , Hh          , Mm          , Hh          , Hh          , Gg^Vh       , Ww          , Hh          , Mm          , Mm          , Mm          
Mm          ,Mm          , Hh          , Mm          , Mm          , Mm          , Mm          , Mm          , Mm          , Mm          , Mm          , Mm          , Mm          , Hh          , Hh          , Rd          , Rd          , Gs          , Rd          , Hh          , Gs          , Hh          , Hh          , Hh          , Gs          , Gs^Fp       , Gs^Fp       , Ww          , Hh          , Ce          , 3 Ke        , 3 Ce        
Mm          ,Mm          , Hh          , Mm          , Mm          , Mm          , Mm          , Mm          , Mm          , Mm          , Mm          , Mm          , Mm          , Mm          , Mm          , Hh          , Hh          , Rd          , Rd          , Chr         , Rd          , Hh          , Gg^Vh       , Hh          , Gs^Fp       , Gs^Fp       , Gs^Fp       , Ww          , Gs          , Ce          , Ce          , Ce          
Mm          ,Mm          , Mm          , Mm          , Mm          , Mm          , Mm          , Mm          , Mm          , Mm          , Mm          , Mm          , Mm          , Mm          , Mm          , Mm          , Hh          , Chr         , Rd          , Rd          , Rd          , Rd          , Gs          , Gg          , Gs          , Gs^Fp       , Gs^Fp       , Ww          , Gs          , Gs^Fp       , Hh          , Hh          
Hh          ,Hh          , Mm          , Mm          , Mm          , Mm          , Mm          , Mm          , Mm          , Mm          , Mm          , Mm          , Mm          , Mm          , Hh          , Mm          , Hh          , Hh          , Gs^Fp       , Gs          , Gg^Vh       , Rd          , Rd          , Gs          , Gs^Fp       , Gs          , Gs          , Ww          , Ww          , Gs          , Hh          , Hh          
Mm          ,Mm          , Mm          , Mm          , Mm          , Mm          , Mm          , Mm          , Mm          , Mm          , Mm          , Mm          , Hh          , Hh          , Ce          , Hh          , Re          , Gs          , Gs          , Gs          , Gs          , Gg          , Rd          , Gs          , Gs^Fp       , Gs^Fp       , Gs^Fp       , Gs          , Ww^Bw\      , Gs          , Gs^Fp       , Gs^Fp       
Mm          ,Mm          , Mm          , Mm          , Mm          , Mm          , Mm          , Mm          , Mm          , Mm          , Mm          , Mm          , Mm          , Ce          , 2 Ke        , Ce          , Gs^Fp       , Gs^Fp       , Gs^Fp       , Gs^Fp       , Gg^Vh       , Gg          , Rd          , Gg          , Gs^Fp       , Gs^Fp       , Gs^Fp       , Ss          , Ww          , Gg          , Gg^Vh       , Gg       
Mm          ,Mm          , Mm          , Mm          , Mm          , Mm          , Mm          , Mm          , Mm          , Mm          , Mm          , Mm          , Mm          , Ce          , 2 Ce        , Ce          , Gs^Fp       , Gs^Fp       , Gs^Fp       , Gs^Fp       , Gg       , Gg          , Rd          , Gg          , Gs^Fp       , Gs^Fp       , Gs^Fp       , Ss          , Ww          , Gg          , Gg       , Gg       
