border_size=1
usage=map

Mm          , Mm          , Mm^Xm       , Mm          , Mm          , Mm^Xm       , Mm          , Mm          , Mm          , Ha          , Ha          , Ha          , Aa          , Aa          , Aa          , Aa^Fpa      , Aa^Fpa      , Aa^Fpa      , Aa          , Aa          , Aa          , Aa          , Aa          , Aa^Fpa      , Aa          , Aa^Fpa      , Aa^Fpa      , Aa^Fpa      , Ha          , Ha          , Ai          , Ha          , Ha          , Ha          , Aa          , Aa          , Ai          , Ai          , Ww          , Ww          , Wo          , Wo          
Mm          , Mm          , Mm^Xm       , Mm          , Mm          , Mm^Xm       , Mm          , Mm          , Mm          , Ha          , Ha          , Ha          , Aa          , Aa          , Aa          , Aa^Fpa      , Aa^Fpa      , Aa^Fpa      , Aa          , Aa          , Aa          , Aa          , Aa          , Aa^Fpa      , Aa          , Aa^Fpa      , Aa^Fpa      , Aa^Fpa      , Ha          , Ha          , Ai          , Ha          , Ha          , Ha          , Aa          , Aa          , Ai          , Ai          , Ww          , Ww          , Wo          , Wo          
Mm          , Mm          , Mm          , Mm^Xm       , Mm^Xm       , Mm^Xm       , Mm          , Mm          , Mm          , Mm          , Ha          , Ha          , Ha          , Aa          , Aa^Fpa      , Aa^Fpa      , Ai          , Aa^Fpa      , Ha          , Ha          , Ha          , Aa^Vha      , Ha          , Ha          , Ha          , Aa          , Gg          , Ha          , Ha          , Ai          , Ai          , Ha          , Ha          , Ha^Vhha     , Gs          , Aa          , Aa          , Ai          , Ai          , Ww          , Wo          , Wo          
Ha          , Ha          , Ha          , Mm          , Ha          , Ha          , Ha          , Mm          , Mm          , Mm          , Ha          , Ha          , Aa^Fpa      , Ha^Vhha     , Aa^Fpa      , Aa^Fpa      , Aa^Fpa      , Aa^Fpa      , Ha          , Ha          , Mm          , Ha          , Ha          , Ha          , Ha          , Ha          , Ha          , Ha          , Ha          , Ha          , Ha          , Ha          , Gs          , Gs          , Aa^Fpa      , Gs          , Aa          , Aa          , Ai          , Ww          , Wo          , Wo          
Aa          , Aa          , Ha^Vhha     , Mm          , Ha          , Aa          , Ha          , Ha          , Ha          , Ha          , Ha          , Ha          , Aa^Fpa      , Aa          , Aa          , Aa          , Aa          , Aa          , Ha          , Ha          , Mm          , Mm          , Ha          , Ha          , Ha          , Ha          , Ha          , Ha          , Ha          , Ha          , Ha          , Ha          , Gs          , Aa^Fpa      , Aa^Fpa      , Aa^Fpa      , Aa          , Aa          , Ai          , Ww          , Wo          , Wo          
Aa          , Aa          , Mm          , Mm          , Aa          , Aa^Vha      , Ha          , Aa^Fpa      , Aa^Fpa      , Ha          , Ha          , Aa^Fpa      , Aa^Fpa      , Aa          , Ch          , Ch          , Chr         , Aa          , Ha          , Ha          , Ha          , Ha          , Aa^Fpa      , Aa^Fpa      , Aa^Fpa      , Aa^Fpa      , Re          , Gg^Vh       , Re          , Re          , Re          , Gs          , Ha          , Ha          , Aa^Fpa      , Aa^Fpa      , Aa          , Aa^Vha      , Ai          , Ww          , Wo          , Wo          
Aa          , Aa          , Aa          , Aa          , Aa          , Ha          , Ha          , Aa^Fpa      , Gs          , Ha          , Re          , Re          , Re          , Aa          , Chr         , 5 Kh        , Ch          , Aa^Fpa      , Aa^Fpa      , Ha          , Ha          , Ha          , Aa^Fpa      , Aa^Fpa      , Aa          , Aa          , Re          , Re          , Aa          , Aa          , Aa          , Re          , Re          , Gs          , Gs          , Aa          , Ai          , Ai          , Ww          , Ww          , Wo          , Wo          
Gs          , Gs          , Re          , Aa          , Gs          , Aa^Vha      , Re          , Gs          , Re          , Re          , Re          , Ha          , Ha          , Re          , Aa          , Ch          , Aa^Fpa      , Aa^Fpa      , Aa          , Ha          , Aa^Vha      , Aa^Fpa      , Re          , Aa          , Re          , Re          , Aa          , Aa          , Ai          , Aa          , Aa          , Aa          , Aa          , Re          , Re          , Aa          , Ai          , Ai          , Ww          , Wo          , Wo          , Wo          
Re          , Re          , Re          , Re          , Re          , Re          , Re          , Re          , Re          , Re          , Ha          , Ha          , Ha          , Re          , Re          , Aa^Fpa      , Re          , Re          , Re          , Aa          , Aa          , Re          , Re          , Re          , Aa          , Aa          , Aa          , Ai          , Ww          , Ww          , Ww          , Ai          , Ai          , Gs          , Gs          , Gs          , Ai          , Ww          , Ww          , Wo          , Wo          , Wo          
Re          , Re          , Aa^Vha      , Re          , Re          , Re          , Re          , Re          , Aa^Fpa      , Aa^Fpa      , Ha          , Ai          , Ha          , Aa          , Aa          , Re          , Aa^Fpa      , Aa^Fpa      , Re          , Re          , Re          , Re          , Gg          , Gg^Vh       , Ww          , Ww          , Ww          , Ww          , Ww          , Wo          , Wo          , Ww          , Ww          , Ww          , Ww          , Ww          , Ww          , Ww          , Wo          , Wo          , Wo          , Wo          
Aa          , Aa          , Aa          , Aa          , Aa          , Gs          , Aa          , Re          , Aa^Fpa      , Aa^Fpa      , Aa          , Ha          , Aa          , Aa          , Aa          , Aa          , Aa          , Aa          , Gg^Vh       , Re          , Aa          , Aa          , Ww          , Ww          , Wo          , Ww          , Wo          , Wo          , Wo          , Wo          , Wo          , Wo          , Wo          , Ww          , Ww          , Ww          , Wo          , Ww          , Wo          , Wo          , Wo          , Wo          
Ai          , Ai          , Ww          , Aa          , Aa          , Aa          , Aa          , Re          , Aa^Vha      , Aa          , Aa          , Aa          , Gs          , Aa          , Ai          , Gs          , Gs          , Gg          , Ai          , Gg          , Ww          , Aa          , Ww          , Wo          , Wo          , Wo          , Wo          , Wo          , Wo          , Wo          , Wo          , Wo          , Wo          , Wo          , Wo          , Ww          , Ww          , Wo          , Wo          , Wo          , Wo          , Wo          
Ww          , Ww          , Ww          , Ww          , Ww          , Ww          , Ww          , Re          , Aa          , Gg          , Ww          , Ww          , Ww          , Ww          , Wo          , Ww          , Ww          , Ww          , Ww          , Ww          , Wo          , Ww          , Wo          , Wo          , Wo          , Wo          , Wo          , Wo          , Ww          , Wo          , Wo          , Wo          , Wo          , Wo          , Ww          , Ww          , Ai          , Ww          , Ww          , Wo          , Wo          , Wo          
Wo          , Wo          , Wo          , Wo          , Wo          , Wo          , Ww          , Ww^Bw|      , Ww          , Ww          , Wo          , Wo          , Wo          , Wo          , Wo          , Wo          , Wo          , Wo          , Wo          , Wo          , Wo          , Wo          , Wo          , Wo          , Wo          , Wo          , Ww          , Ww          , Ww          , Ww          , Wo          , Wo          , Ww          , Ww          , Gg          , Gg^Vh       , Aa          , Ai          , Ww          , Wo          , Wo          , Wo          
Wo          , Wo          , Wo          , Wo          , Wo          , Wo          , Ww          , Ww^Bw|      , Ww          , Wo          , Wo          , Wo          , Wo          , Wo          , Wo          , Wo          , Wo          , Wo          , Wo          , Wo          , Wo          , Wo          , Wo          , Wo          , Ww          , Wo          , Ai          , Gg          , Ww          , Wo          , Wo          , Wo          , Ww^Bw\      , Ai          , Aa          , Rr          , Aa          , Ai          , Ww          , Wo          , Wo          , Wo          
Wo          , Wo          , Ww          , Ww          , Ww          , Ww          , Ww          , Ww^Bw|      , Ww          , Wo          , Wo          , Wo          , Ww          , Ww          , Ww          , Ww          , Ww          , Ww          , Ww          , Wo          , Ww          , Ww          , Ww          , Ww          , Chr         , Ai          , Ai          , Ai          , Ww          , Wo          , Ww          , Ww          , Ai          , Ds          , Gg          , Rr          , Aa^Vha      , Ai          , Aa^Fpa      , Ww          , Ww          , Ww          
Ww          , Ww          , Aa^Vha      , Ai          , Gs          , Ww          , Ww          , Gs          , Ww          , Ww          , Ww^Bw\      , Ww          , Gg^Vh       , Ww          , Gs          , Ai          , Aa          , Ai          , Gs          , Ww          , Aa          , Aa          , Aa          , Aa          , Ch          , Ww          , Ww^Bw\      , Ai          , Ai          , Ww^Bw\      , Ds          , Ww^Bw\      , Ds          , Aa          , Aa^Vha      , Rr          , Rr          , Aa          , Aa^Fpa      , Aa^Fpa      , Ww          , Ww          
Aa          , Aa          , Aa          , Aa          , Aa          , Gs          , Aa^Vha      , Ww^Bw|      , Aa          , Ww          , Aa          , Gg          , Aa          , Rd          , Rd          , Aa          , Aa^Fpa      , Aa          , Aa^Fpa      , Rd          , Aa          , Aa          , Aa          , Aa          , Chr         , Ai          , Rd          , Ds          , Ds          , Ds          , Aa^Vha      , Ds          , Aa          , Aa          , Rr          , Aa^Vha      , Rr          , Ha          , Aa          , Ai          , Ww          , Ww          
Aa          , Aa          , Aa          , Aa          , Aa^Fpa      , Aa          , Rd          , Rd          , Rd          , Aa^Vha      , Aa          , Aa          , Aa          , Aa          , Aa          , Aa^Fpa      , Aa^Fpa      , Aa^Vha      , Rd          , Aa^Fpa      , Aa^Fpa      , Rd          , Rd          , Gs          , Rd          , Ch          , Chr         , Gg^Vh       , Rr          , Aa          , Aa^Vha      , Aa          , Ch          , Ch          , Ch          , Rr          , Rr          , Ha          , Ha          , Ai          , Ww          , Ww          
Aa          , Aa          , Aa          , Aa^Fpa      , Aa^Fpa      , Rd          , Ce          , Rd          , Ce          , Rd          , Rd          , Gs          , Gs          , Aa          , Rd          , Aa^Fpa      , Rd          , Rd          , Rd          , Aa^Fpa      , Rd          , Rd          , Chr         , Rd          , Rd          , Rd          , Rr          , Rr          , Chr         , Rr          , Rr          , Rr          , Ch          , 1 Kh        , Ch          , Rr          , Ha          , Ha          , Aa^Vha      , Ai          , Ww          , Ww          
Aa^Fpa      , Aa^Fpa      , Aa^Fpa      , Aa^Fpa      , Rd          , Rd          , Ce          , 4 Ke        , Ce          , Rd          , Rd          , Rd          , Rd          , Rd          , Rd          , Rd          , Rd          , Aa^Fpa      , Aa^Fpa      , Rd          , Rd          , Rd          , Rr          , Rd          , Rr          , Rr          , Rd          , Aa          , Aa          , Ch          , 2 Kh        , Rr          , Rr          , Ch          , Rr          , Rr          , Ha          , Ha          , Ai          , Ai          , Ww          , Ww          
Aa^Fpa      , Aa^Fpa      , Aa^Fpa      , Aa^Fpa      , Aa^Fpa      , Rd          , Aa          , Ce          , Rd          , Rd          , Rd          , Rd          , Gg          , Rd          , Gs          , Rd          , Ha          , Aa^Fpa      , Ha          , Aa^Fpa      , Gs          , Rd          , Chr         , Rr          , Aa^Vha      , Rd          , Rd          , Aa          , Rd          , Ch          , Aa          , Aa          , Aa          , Rr          , Ha          , Rr          , Aa^Vha      , Aa          , Ai          , Ww          , Ww          , Ww          
Aa^Fpa      , Aa^Fpa      , Aa^Fpa      , Aa^Fpa      , Gg^Vh       , Rd          , Aa^Fpa      , Aa          , Aa          , Rd          , Rd          , Gg^Vh       , Ha          , Ha          , Ha          , Ha          , Ha          , Ha          , Ha          , Ha          , Rd          , Rd          , Rd          , Rr          , Aa          , Aa          , Aa          , Aa          , Ai          , Ch          , Aa^Vha      , Ha          , Gs          , Aa^Vha      , Aa          , Ha          , Aa          , Ai          , Ww          , Ww          , Wo          , Wo          
Aa^Fpa      , Aa^Fpa      , Aa^Fpa      , Aa^Fpa      , Aa^Fpa      , Aa^Fpa      , Aa^Fpa      , Aa          , Ha          , Gs          , Rd          , Ha          , Mm          , Mm          , Ha          , Ha          , Ha          , Ha          , Aa^Fpa      , Ha          , Ha          , Ha          , Rr          , Rr          , Rd          , Aa          , Rd          , Ai          , Ai          , Ai          , Ai          , Aa          , Ww          , Ai          , Ww          , Gs          , Ww          , Ww          , Wo          , Wo          , Wo          , Wo          
Aa^Fpa      , Aa^Fpa      , Aa^Fpa      , Aa^Fpa      , Aa^Fpa      , Aa^Fpa      , Ha          , Ha          , Ha          , Ha          , Rd          , Ha          , Ha          , Ha          , Aa          , Aa^Fpa      , Aa^Fpa      , Aa^Fpa      , Aa^Fpa      , Aa^Fpa      , Rr          , Rr          , Aa          , Rd          , Aa^Fpa      , Aa          , Rd          , Ai          , Ww          , Ww          , Ww          , Ww          , Wo          , Ww          , Ww          , Ww          , Ww          , Ww          , Wo          , Wo          , Wo          , Wo          
Aa          , Aa          , Aa          , Ha          , Ha          , Ha          , Mm          , Ha          , Ha          , Aa          , Re          , Ha          , Aa^Fpa      , Aa^Fpa      , Aa          , Aa          , Re          , Re          , Re          , Re          , Aa          , Aa          , Aa          , Aa^Fpa      , Aa^Fpa      , Aa^Vha      , Ai          , Ai          , Ww          , Ww          , Wo          , Wo          , Wo          , Wo          , Wo          , Ww          , Ww          , Wo          , Wo          , Wo          , Wo          , Wo          
Aa          , Aa          , Ha          , Ha          , Mm          , Mm          , Mm          , Ha          , Aa          , Aa          , Gs          , Re          , Aa^Fpa      , Aa^Fpa      , Re          , Re          , Aa          , Aa          , Ai          , Aa          , Ai          , Ai          , Ai          , Ai          , Ai          , Ai          , Ww          , Ai          , Ww          , Ww          , Wo          , Wo          , Wo          , Wo          , Wo          , Ww          , Ww          , Wo          , Wo          , Wo          , Wo          , Wo          
Ha          , Ha          , Ha          , Ha          , Mm          , Mm          , Mm          , Ha          , Ha          , Gs          , Gs          , Re          , Re          , Re          , Aa          , Aa          , Ai          , Aa          , Ai          , Ai          , Ww          , Ai          , Ww          , Ww          , Ww          , Ww          , Ww          , Ww          , Wwr         , Wo          , Wo          , Wo          , Ww          , Wo          , Wwr         , Ww          , Wo          , Wo          , Wo          , Wo          , Wo          , Wo          
Mm          , Mm          , Mm^Xm       , Mm^Xm       , Mm^Xm       , Mm          , Ha          , Ha          , Gs          , Gs          , Aa^Fpa      , Gs          , Re          , Aa^Vha      , Aa          , Ai          , Ai          , Ai          , Ww          , Ww          , Ww          , Ww          , Ww          , Ww          , Ww          , Ww          , Wo          , Wwr         , Wwr         , Wo          , Wwr         , Ww          , Ww          , Wwr         , Wwr         , Ww          , Wo          , Wo          , Wo          , Wo          , Wo          , Wo          
Mm          , Mm          , Mm          , Mm          , Mm          , Mm          , Ha^Vhha     , Ha          , Aa^Fpa      , Aa^Fpa      , Aa^Fpa      , Gs          , Re          , Aa          , Aa          , Aa          , Ai          , Ai          , Ww          , Ww          , Wo          , Ww          , Wo          , Ww          , Wo          , Wo          , Wo          , Wo          , Wo          , Wwr         , Ai          , Ai          , Ww          , Ww          , Wwr         , Wo          , Wo          , Wo          , Wo          , Wo          , Wo          , Wo          
Mm          , Mm          , Ha          , Ha          , Ha          , Ha          , Ha          , Ha          , Aa^Fpa      , Aa^Fpa      , Gs          , Gs          , Aa^Fpa      , Re          , Re          , Gs          , Gs          , Ai          , Wwr         , Wwr         , Wo          , Wo          , Wo          , Wo          , Wo          , Wo          , Ww          , Ww          , Ww          , Ww          , Gg          , Gg^Vh       , Ai          , Ai          , Wwr         , Wo          , Wo          , Wo          , Wo          , Wo          , Wo          , Wo          
Ha          , Ha          , Aa^Fpa      , Ha          , Aa^Fpa      , Aa^Fpa      , Aa^Fpa      , Gs          , Gs          , Gs          , Gs          , Aa^Fpa      , Aa^Fpa      , Ce          , 3 Ke        , Ce          , Gs          , Ww          , Ww          , Ww          , Wwr         , Wo          , Wo          , Wo          , Wo          , Ww          , Ai          , Ai          , Aa^Fpa      , Ai          , Aa^Vha      , Ha          , Ai          , Wwr         , Wo          , Wo          , Wo          , Wo          , Wo          , Wo          , Wo          , Wo          
Aa^Fpa      , Aa^Fpa      , Aa^Fpa      , Aa^Fpa      , Aa^Fpa      , Aa^Fpa      , Aa          , Aa          , Aa          , Gs          , Gs          , Aa^Fpa      , Aa^Fpa      , Ce          , Ce          , Ce          , Ww          , Ww          , Ai          , Ww          , Ww          , Wwr         , Wwr         , Wwr         , Ww          , Ww          , Ww^Bw\      , Aa^Fpa      , Gs          , Aa          , Ha          , Aa^Fpa      , Ai          , Ww          , Wo          , Wo          , Wo          , Wo          , Wo          , Wo          , Wo          , Wo          
Ha          , Ha          , Ha          , Aa^Fpa      , Aa          , Aa          , Aa          , Aa          , Aa          , Gs          , Gg^Vh       , Ai          , Ai          , Ai          , Ww          , Ai          , Ww          , Ai          , Ww          , Ww          , Wo          , Wwr         , Wwr         , Ww          , Wwr         , Ww          , Ai          , Gg^Vh       , Aa^Fpa      , Ha          , Aa^Fpa      , Ai          , Ww          , Wo          , Wo          , Wo          , Wo          , Wo          , Wo          , Wo          , Wo          , Wo          
Ha          , Ha          , Aa^Vha      , Aa          , Aa          , Aa          , Aa^Vha      , Gs          , Ai          , Ai          , Ai          , Ai          , Ai          , Ww          , Wo          , Ww          , Wo          , Wo          , Wo          , Wo          , Wo          , Wo          , Wo          , Wo          , Wo          , Ww          , Ai          , Ai          , Ai          , Ai          , Ai          , Ai          , Wo          , Wo          , Wo          , Wo          , Wo          , Wo          , Wo          , Wo          , Wo          , Wo          
Ha          , Ha          , Aa^Fpa      , Aa^Fpa      , Aa^Fpa      , Aa          , Aa          , Aa          , Ai          , Ai          , Ai          , Ww          , Ww          , Ww          , Ww          , Wo          , Wo          , Wo          , Wo          , Wo          , Wo          , Wo          , Wo          , Wo          , Wo          , Ww          , Ww          , Ww          , Ww          , Ww          , Wo          , Wo          , Wo          , Wo          , Wo          , Wo          , Wo          , Wo          , Wo          , Wo          , Wo          , Wo          
Ha          , Ha          , Aa^Fpa      , Aa^Fpa      , Aa^Fpa      , Aa          , Aa          , Aa          , Ai          , Ai          , Ai          , Ww          , Ww          , Ww          , Ww          , Wo          , Wo          , Wo          , Wo          , Wo          , Wo          , Wo          , Wo          , Wo          , Wo          , Wo          , Wo          , Wo          , Wo          , Wo          , Wo          , Wo          , Wo          , Wo          , Wo          , Wo          , Wo          , Wo          , Wo          , Wo          , Wo          , Wo          
