
border_size=1
usage=map

Wo          ,Wo          , Wo          , Wo          , Wo          , Wo          , Wo          , Wo          , Wo          , Wo          , Wo          , Wo          , Wo          , Wo          , Wo          , Wo          , Wo          , Wo          , Wo          , Wo          , Wo          , Wo          , Wo          , Wo          , Wo          , Wo          , Wo          , Wo          , Wo          , Wo          , Wo          , Wo          , Wo          , Wo          , Wo          
Wo          ,Wo          , Wo          , Wo          , Wo          , Wo          , Wo          , Wo          , Wo          , Wo          , Wo          , Wo          , Wo          , Wo          , Wo          , Wo          , Wo          , Wo          , Wo          , Wo          , Wo          , Wo          , Wo          , Wo          , Wo          , Wo          , Wo          , Wo          , Wo          , Wo          , Wo          , Wo          , Wo          , Wo          , Wo          
Wo          ,Wo          , Wo          , Wo          , Ww          , Wo          , Wo          , Wo          , Wo          , Wo          , Wo          , Wo          , Wo          , Wo          , Wo          , Wo          , Wo          , Wo          , Wo          , Wo          , Wo          , Wo          , Wo          , Wo          , Wo          , Wo          , Wo          , Wo          , Ww          , Ww          , Ww          , Ww          , Ww          , Wo          , Wo          
Wo          ,Wo          , Ww          , Ww          , Ww          , Ww          , Ww          , Ww          , Ww          , Wo          , Ww          , Ww          , Ww          , Ww          , Ww          , Ww          , Ww          , Ww          , Ww          , Wo          , Wo          , Wo          , Wo          , Wo          , Wo          , Wo          , Ww          , Ww          , Ww          , Gs          , Gs^Ft       , Gs^Ft       , Ww          , Wo          , Wo          
Wo          ,Wo          , Ww          , Ww          , Ww          , Dd          , Ww          , Ww          , Ww          , Ww          , Ww          , Hd          , Hd          , Hd          , Ww          , Hd          , Ww          , Ww          , Ww          , Wo          , Wo          , Wo          , Wo          , Wo          , Wo          , Wo          , Wo          , Ww          , Dd^Vda      , Ss          , Ss          , Gs^Ft       , Ww          , Wo          , Wo          
Wo          ,Wo          , Ww          , Ww          , Dd          , Dd^Vda      , Dd          , Dd          , Dd          , Dd          , Dd          , Hd          , Hd          , Md          , Md          , Md          , Hd          , Ww          , Ww          , Wo          , Ww          , Wo          , Wo          , Wo          , Wo          , Wo          , Wo          , Ww          , Gs          , Gs          , Ss          , Gs^Ft       , Ww          , Wo          , Wo          
Wo          ,Wo          , Ww          , Gs^Ft       , Dd          , Gs^Ft       , Dd          , Chr         , Chr         , Chr         , Dd          , Ww          , Dd^Vda      , Hd          , Md          , Hd          , Hd          , Gs^Ft       , Ww          , Ww          , Ww          , Ww          , Ww          , Wo          , Wo          , Wo          , Wo          , Ww          , Ww          , Ww          , Gs^Ft       , Ww          , Wo          , Wo          , Wo          
Wo          ,Wo          , Wo          , Ww          , Gs^Ft       , Gs^Ft       , Gs^Ft       , Chr         , 3 Khr       , Chr         , Dd          , Dd          , Hd          , Md          , Md          , Md          , Hd          , Gs^Ft       , Gs^Ft       , Gs^Ft       , Dd^Vdt      , Ww          , Ww          , Ww          , Wo          , Wo          , Wo          , Wo          , Ww          , Ww          , Ww          , Ww          , Wo          , Wo          , Wo          
Wo          ,Wo          , Wo          , Ww          , Ww          , Ww          , Gs^Ft       , Dd          , Dd          , Dd          , Hd          , Gs^Ft       , Md          , Md          , Md          , Hd          , Gs^Ft       , Gs^Ft       , Gs^Ft       , Gs^Ft       , Gs^Ft       , Gs^Ft       , Ww          , Ww          , Ww          , Wo          , Wo          , Ww          , Ww^Bw\      , Ww          , Ww          , Wo          , Wo          , Wo          , Wo          
Wo          ,Wo          , Wo          , Wo          , Ww          , Ww          , Gs^Ft       , Gs^Ft       , Dd^Do       , Dd          , Md          , Hd          , Md          , Md          , Md          , Hd          , Gs^Ft       , Dd          , Dd          , Gs^Ft       , Gs^Ft       , Gs^Ft       , Gs^Ft       , Gs^Ft       , Ww          , Wo          , Ww          , Ww          , Gs          , Dd^Vda      , Ww          , Ww          , Wo          , Wo          , Wo          
Wo          ,Wo          , Wo          , Wo          , Ww          , Ww          , Ww          , Ww          , Gs^Ft       , Hd          , Gs^Ft       , Hd          , Md          , Hd          , Hd          , Hd          , Gs^Ft       , Dd          , Gs^Ft       , Gs^Ft       , Gs^Ft       , Gs^Ft       , Gs^Ft       , Gs^Ft       , Ww          , Ww          , Ww          , Ww          , Gs          , Gs^Ft       , Gs^Ft       , Ww          , Ww          , Wo          , Wo          
Wo          ,Wo          , Wo          , Wo          , Ww          , Ww          , Ww          , Ww          , Gs^Ft       , Gs^Ft       , Dd          , Hd          , Hd          , Gs^Vht      , Gs^Ft       , Hd          , Gs^Ft       , Gs^Ft       , Gs^Ft       , Gs^Ft       , Gs^Ft       , Ss          , Gs^Ft       , Gs^Ft       , Gs          , Dd          , Ww          , Ww          , Ce          , Ce          , Gs^Ft       , Dd          , Ww          , Wo          , Wo          
Wo          ,Wo          , Wo          , Wo          , Wo          , Wo          , Ww          , Ww          , Gs^Ft       , Gs^Ft       , Gs^Ft       , Gs^Ft       , Gs^Ft       , Gs^Ft       , Gs^Ft       , Dd          , Gs^Ft       , Dd          , Gs^Ft       , Gs^Ft       , Gs^Ft       , Gs^Ft       , Gs^Ft       , Gs^Ft       , Gs^Ft       , Ww          , Ww          , Ww          , Ww          , 1 Ke        , Ce          , Dd          , Ww          , Wo          , Wo          
Wo          ,Wo          , Wo          , Wo          , Wo          , Wo          , Ww          , Ww          , Gs^Ft       , Gs^Ft       , Gs^Ft       , Dd          , Gs^Ft       , Ss          , Ss          , Gs^Ft       , Gs^Ft       , Gs^Ft       , Rd          , Gs^Ft       , Gs^Ft       , Gs^Ft       , Gs^Ft       , Gs^Ft       , Rd          , Dd^Vdt      , Ww          , Ww          , Ww          , Ce          , Ww          , Dd          , Ww          , Wo          , Wo          
Wo          ,Wo          , Wo          , Wo          , Ww          , Ww          , Ww          , Gs^Ft       , Dd          , Gs^Ft       , Gs^Ft       , Dd          , Gs^Ft       , Gs^Ft       , Gs^Ft       , Gs^Ft       , Gs^Ft       , Gs^Ft       , Gs^Ft       , Gs^Ft       , Gs^Ft       , Gs^Ft       , Gs^Ft       , Gs^Vht      , Gs^Ft       , Gs^Ft       , Gs          , Ww          , Ww          , Ww          , Dd          , Ww          , Wo          , Wo          , Wo          
Wo          ,Wo          , Wo          , Ww          , Ww          , Gs          , Gs          , Gs^Ft       , Gs^Ft       , Dd          , Gs^Ft       , Gs^Ft       , Gs^Ft       , Gs^Ft       , Gs^Ft       , Gs^Ft       , Gs^Ft       , Gs^Ft       , Gs^Ft       , Gs^Ft       , Rd          , Rd          , Gs^Ft       , Gs^Ft       , Gs^Ft       , Gs^Ft       , Rd          , Gs          , Dd^Vdt      , Gs^Ft       , Ww          , Ww          , Wo          , Wo          , Wo          
Wo          ,Wo          , Ww          , Ww          , Ww          , Gs          , Gs^Ft       , Gs^Vht      , Gs^Ft       , Gs^Ft       , Gs^Ft       , Gs^Ft       , Gs^Ft       , Ss          , Gs^Ft       , Gs^Ft       , Gs^Ft       , Gs^Ft       , Gs^Ft       , Gs^Ft       , Gs^Ft       , Gs^Ft       , Ss          , Ss          , Gs^Ft       , Gs^Ft       , Gs^Ft       , Gs^Ft       , Gs^Ft       , Gs^Ft       , Gs^Ft       , Ww          , Wo          , Wo          , Wo          
Wo          ,Wo          , Ww          , Gs          , Ww          , Gs          , Gs^Ft       , Gs^Ft       , Gs^Ft       , Gs^Ft       , Dd          , Dd          , Gs^Ft       , Gs^Ft       , Gs^Ft       , Gs^Ft       , Gs^Ft       , Rd          , Gs^Vht      , Gs^Ft       , Gs^Ft       , Gs^Ft       , Gs^Ft       , Gs^Ft       , Gs          , Gs^Ft       , Gs^Ft       , Gs^Ft       , Gs^Ft       , Gs^Ft       , Gs^Ft       , Ww          , Wo          , Wo          , Wo          
Wo          ,Wo          , Ww          , Gs^Ft       , Ww          , Ww          , Gs          , Gs          , Gs^Ft       , Gs^Ft       , Gs^Ft       , Gs^Ft       , Rd          , Gs^Ft       , Gs^Ft       , Gs^Ft       , Ss          , Rd          , Gs^Ft       , Gs^Ft       , Gs^Ft       , Gs^Ft       , Gs^Ft       , Gs^Ft       , Gs          , Gs^Ft       , Gs^Ft       , Gs          , Dd^Vdt      , Gs^Ft       , Ww          , Ww          , Wo          , Wo          , Wo          
Wo          ,Wo          , Ww          , Gs^Ft       , Gs^Ft       , Ww          , Ww          , Ww          , Ww          , Ww          , Gs^Ft       , Dd          , Gs          , Gs          , Gs          , Gs^Ft       , Gs          , Gs          , Gs^Ft       , Gs^Ft       , Gs^Ft       , Gs^Ft       , Gs^Ft       , Gs^Ft       , Gs          , Gs          , Gs          , Gs^Ft       , Gs^Ft       , Ww          , Ww          , Wo          , Wo          , Wo          , Wo          
Wo          ,Wo          , Ww          , Gs^Ft       , Gs          , Ww          , Wo          , Wo          , Ww          , Ww          , Dd          , Dd          , Dd          , Dd          , Gs          , Dd          , Gs          , Gs^Ft       , Gs          , Gs^Ft       , Gs^Ft       , Gs^Ft       , Gs^Ft       , Gs          , Gs^Ft       , Gs^Ft       , Gs^Ft       , Ww          , Ww          , Ww          , Wo          , Wo          , Wo          , Wo          , Wo          
Wo          ,Wo          , Wo          , Ww          , Ww          , Ww          , Wo          , Wo          , Ww          , Ww          , Ww          , Ww          , Dd          , Dd          , Dd          , Dd          , Dd          , Dd          , Gs          , Dd          , Dd          , Ww          , Gs          , Ww          , Gs          , Ww          , Ww          , Ww          , Ww          , Wo          , Wo          , Wo          , Wo          , Wo          , Wo          
Wo          ,Wo          , Wo          , Wo          , Ww          , Wo          , Ww          , Wo          , Ww          , Ww          , Dd          , Dd          , Ss          , Dd          , Ss          , Ss          , Dd          , Dd          , Dd          , Dd          , Dd          , Ww          , Ww          , Ww          , Ww          , Ww          , Ww          , Ww          , Ww          , Ww          , Ww          , Wo          , Ww          , Wo          , Wo          
Wo          ,Wo          , Wo          , Ww          , Ww          , Ww          , Ww          , Ww          , Ww          , Ww          , Ww          , Dd          , Dd          , Dd          , Dd          , Ss          , Dd          , Dd          , Dd          , Ww          , Ww          , Ww          , Wo          , Wo          , Wo          , Ww          , Ww          , Ww          , Ww          , Ds          , Ww          , Ww          , Ww          , Wo          , Wo          
Wo          ,Wo          , Wo          , Ww          , Dd          , Dd          , Dd          , Dd          , Dd          , Ww          , Ww          , Ww          , Ss          , Ss          , Dd          , Ss          , Dd          , Ww          , Ww          , Ww          , Ww          , Wo          , Wo          , Wo          , Wo          , Ww          , Ww          , Ds          , Ds          , Ds          , Ds          , Ds          , Ww          , Wo          , Wo          
Wo          ,Wo          , Ww          , Ww          , Dd^Vda      , Gs^Ft       , Gs^Ft       , Gs^Ft       , Dd          , Dd          , Ss          , Ss          , Dd          , Dd          , Dd          , Dd          , Ww          , Ww          , Ww          , Ww          , Wo          , Wo          , Wo          , Wo          , Ww          , Ww          , Ds          , Gs^Ft       , Gs^Ft       , Gs^Vht      , Gs^Ft       , Ds          , Ww          , Wo          , Wo          
Wo          ,Wo          , Ww          , Ww          , Dd          , Gs^Ft       , Gs^Ft       , Gs^Ft       , Dd          , Ss          , Ww          , Ss          , Ww          , Ww          , Dd          , Dd          , Ww          , Ww          , Ww          , Wo          , Wo          , Wo          , Wo          , Wo          , Ww          , Ww          , Ds          , Gs          , Gs          , Gs^Ft       , Gs^Ft       , Ds          , Ww          , Wo          , Wo          
Wo          ,Wo          , Ww          , Gs^Ft       , Gs^Ft       , Gs^Ft       , Gs^Ft       , Dd^Vda      , Dd          , Dd          , Ss          , Ss          , Ww          , Ss          , Ww          , Ww          , Ww          , Ww          , Wo          , Wo          , Wo          , Wo          , Wo          , Wo          , Wo          , Ww          , Ww          , Ww          , Ds          , Ds          , Ds          , Ww          , Wo          , Wo          , Wo          
Wo          ,Wo          , Ww          , Gs^Ft       , Dd^Vda      , Gs^Ft       , Gs^Ft       , Gs^Ft       , Gs^Ft       , Dd          , Dd          , Dd          , Dd          , Ss          , Dd          , Ww          , Wo          , Wo          , Wo          , Wo          , Wo          , Wo          , Wo          , Wo          , Ww          , Ww          , Ww          , Ww          , Ww          , Ww          , Ww          , Ww          , Wo          , Wo          , Wo          
Wo          ,Wo          , Ww          , Ww          , Chr         , Gs^Ft       , Gg          , Ss          , Gg          , Gg          , Dd          , Ss          , Dd          , Dd          , Gs          , Ww          , Wo          , Wo          , Wo          , Wo          , Wo          , Wo          , Wo          , Wo          , Ww          , Ww          , Ww          , Ww          , Ww          , Ww          , Ww          , Ww          , Wo          , Wo          , Wo          
Wo          ,Wo          , Wo          , Chr         , Chr         , Gg          , Gs^Ft       , Gg          , Ss          , Gs^Ft       , Gs^Ft       , Dd          , Dd^Vda      , Gg          , Gs          , Ww          , Ww          , Ww          , Wo          , Wo          , Wo          , Wo          , Wo          , Ww          , Ww          , Dd^Vda      , Ww          , Ww          , Ww          , Ww          , Wo          , Wo          , Wo          , Wo          , Wo          
Wo          ,Wo          , Ww          , 2 Khr       , Chr         , Chr         , Gs^Ft       , Gs^Ft       , Ss          , Ss          , Gs^Ft       , Gs^Ft       , Gg          , Gg          , Gs          , Gs          , Ww          , Ww          , Wo          , Wo          , Wo          , Wo          , Ww          , Ww          , Dd          , Dd          , Dd          , Dd          , Ww          , Wo          , Wo          , Wo          , Wo          , Wo          , Wo          
Wo          ,Wo          , Ww          , Gs^Ft       , Gg          , Gs^Ft       , Gs^Ft       , Gs^Ft       , Gs^Ft       , Gs^Ft       , Gs^Ft       , Gs^Ft       , Gg          , Gs          , Gs          , Ww          , Ww          , Wo          , Wo          , Wo          , Wo          , Ww          , Ww          , Ww^Bw\      , Dd          , Hd          , Hd          , Md          , Ww          , Ww          , Ww          , Ww          , Ww          , Wo          , Wo          
Wo          ,Wo          , Ww          , Dd^Do       , Dd          , Gg          , Gs^Ft       , Gs^Ft       , Gs^Ft       , Gs^Ft       , Gs^Ft       , Gs^Ft       , Gs          , Gs          , Ww          , Ww          , Wo          , Wo          , Wo          , Ww          , Ww          , Ww          , Ww          , Dd          , Gs^Fp       , Md          , Md          , Md          , Dd          , Dd          , Ww          , Ww          , Ww          , Wo          , Wo          
Wo          ,Wo          , Ww          , Dd          , Dd          , Gs          , Gs          , Gg          , Ss          , Gg          , Gg          , Gs^Vht      , Gs          , Ww          , Ww          , Wo          , Wo          , Wo          , Wo          , Ww          , Ww          , Gg          , Gg          , Gs^Fp       , Hd          , Md          , Hd          , Hd          , Gs^Ft       , Dd          , Dd^Vda      , Ww          , Ww          , Wo          , Wo          
Wo          ,Wo          , Ww          , Dd          , Gs          , Gs          , Gs          , Ss          , Gs          , Gs          , Gs          , Gs          , Gs          , Ww          , Ww          , Wo          , Wo          , Wo          , Wo          , Wo          , Ww          , Ww          , Gg          , Hd          , Md          , Md          , Hd          , Gs^Fp       , Dd          , Ww          , Ww          , Ww          , Wo          , Wo          , Wo          
Wo          ,Wo          , Ww          , Ww          , Ww          , Ww          , Gs          , Gs          , Gs          , Gs^Ft       , Gs^Ft       , Gs          , Ww          , Ww          , Wo          , Wo          , Wo          , Wo          , Wo          , Wo          , Wo          , Ww          , Ww          , Gg          , Gg          , Gs^Vht      , Gs          , Dd          , Ww          , Ww          , Wo          , Wo          , Wo          , Wo          , Wo          
Wo          ,Wo          , Wo          , Ww          , Ww          , Ww          , Gs          , Gs^Vht      , Gs          , Gs^Ft       , Gs          , Gs          , Ww          , Ww          , Wo          , Wo          , Wo          , Wo          , Wo          , Wo          , Wo          , Ww          , Ww          , Ww          , Gg          , Ss          , Gg          , Ww          , Ww          , Wo          , Wo          , Wo          , Wo          , Wo          , Wo          
Wo          ,Wo          , Wo          , Wo          , Ww          , Ww          , Ww          , Gs          , Ww          , Gs          , Ww          , Ww          , Ww          , Ww          , Wo          , Wo          , Wo          , Wo          , Wo          , Wo          , Wo          , Wo          , Ww          , Ww          , Gg          , Ww          , Ww          , Ww          , Wo          , Wo          , Wo          , Wo          , Wo          , Wo          , Wo          
Wo          ,Wo          , Wo          , Wo          , Wo          , Ww          , Ww          , Ww          , Ww          , Ww          , Ww          , Ww          , Ww          , Wo          , Wo          , Wo          , Wo          , Wo          , Wo          , Wo          , Wo          , Wo          , Ww          , Ww          , Ww          , Ww          , Ww          , Wo          , Wo          , Wo          , Wo          , Wo          , Wo          , Wo          , Wo          
Wo          ,Wo          , Wo          , Wo          , Wo          , Wo          , Wo          , Ww          , Wo          , Ww          , Wo          , Wo          , Wo          , Wo          , Wo          , Wo          , Wo          , Wo          , Wo          , Wo          , Wo          , Wo          , Wo          , Ww          , Wo          , Ww          , Wo          , Wo          , Wo          , Wo          , Wo          , Wo          , Wo          , Wo          , Wo          
Wo          ,Wo          , Wo          , Wo          , Wo          , Wo          , Wo          , Ww          , Wo          , Ww          , Wo          , Wo          , Wo          , Wo          , Wo          , Wo          , Wo          , Wo          , Wo          , Wo          , Wo          , Wo          , Wo          , Ww          , Wo          , Ww          , Wo          , Wo          , Wo          , Wo          , Wo          , Wo          , Wo          , Wo          , Wo          
