border_size=1
usage=map

Mm          , Mm          , Mm          , Mm          , Mm          , Mm          , Mm          , Mm          , Ai          , Mm          , Mm          , Mm          , Mm          , Mm          , Ha          , Mm          , Mm          , Mm          , Mm          , Mm          , Mm          , Ha          , Ha          , Ha          , Aa          , Aa          , Rr          , Rr          , Aa          , Aa          , Aa          , Ha          , Ha          , Ha          , Ha          , Ha          , Ha          
Mm          , Mm          , Mm          , Mm          , Mm          , Mm          , Mm          , Mm          , Ai          , Mm          , Mm          , Mm          , Mm          , Mm          , Ha          , Mm          , Mm          , Mm          , Mm          , Mm          , Mm          , Ha          , Ha          , Ha          , Aa          , Aa          , Rr          , Rr          , Aa          , Aa          , Aa          , Ha          , Ha          , Ha          , Ha          , Ha          , Ha          
Ha          , Ha          , Ha          , Mm          , Mm          , Mm          , Mm          , Ai          , Mm          , Mm          , Mm          , Mm          , Mm          , Mm          , Ha^Vhha     , Mm          , Mm          , Mm          , Mm          , Mm          , Mm          , Ha          , Ha          , Aa          , Ha          , Aa          , Rr          , Aa          , Ai          , Aa^Vha      , Ha          , Ha          , Ha          , Ha          , Mm          , Mm          , Mm          
Ha          , Ha          , Ha          , Ha          , Ha          , Mm          , Mm          , Mm          , Mm          , Mm          , Mm          , Mm          , Ai          , Ai          , Mm          , Mm          , Mm          , Mm          , Mm          , Mm          , Ha          , Ha          , Ha          , Ha          , Aa^Vha      , Aa          , Rr          , Ai          , Ai          , Ai          , Ha          , Ha          , Ha          , Mm          , Mm          , Mm          , Mm          
Ha          , Ha          , Ha          , Ha          , Ha          , Ha          , Ha          , Ha          , Ha          , Ha          , Ai          , Ai          , Ha          , Mm          , Mm          , Mm          , Mm          , Mm          , Ha          , Ha          , Ha          , Ha          , Ha          , Ha          , Rr          , Rr          , Ha          , Ha          , Ha          , Ha          , Ha          , Ha          , Mm          , Mm          , Mm          , Mm          , Mm          
Aa          , Aa          , Ha          , Ha          , Ha^Vhha     , Ha          , Ha          , Ha          , Ha          , Ai          , Aa          , Aa          , Ha          , Mm          , Mm          , Mm          , Mm          , Mm          , Ha          , Ha          , Aa          , Ha          , Chr         , Aa          , Rr          , Ch          , Ch          , Ha          , Ha          , Ha          , Ha          , Mm          , Mm          , Mm          , Mm          , Mm          , Mm          
Aa^Fpa      , Aa^Fpa      , Aa^Fpa      , Ha          , Ha          , Ha          , Ha          , Ha          , Ai          , Ai          , Ha          , Ha          , Ha          , Mm          , Mm          , Mm          , Mm          , Mm          , Ha          , Aa          , Aa          , Ha          , Aa          , Rr          , Ch          , 3 Kh        , Ha          , Ha          , Ha          , Ha          , Ha          , Mm          , Mm          , Mm          , Mm          , Mm          , Mm          
Aa^Fpa      , Aa^Fpa      , Aa^Fpa      , Aa^Fpa      , Aa^Fpa      , Aa^Fpa      , Aa^Fpa      , Aa          , Ai          , Aa          , Aa          , Ha          , Ha          , Ha          , Ha          , Mm          , Mm          , Ha          , Aa^Fpa      , Ha          , Aa          , Aa          , Rr          , Rr          , Aa^Fpa      , Ch          , Ha          , Ha          , Ha          , Ha          , Ha          , Mm          , Mm          , Mm          , Ha^Vhha     , Mm          , Mm          
Aa^Fpa      , Aa^Fpa      , Aa^Fpa      , Aa^Fpa      , Aa^Fpa      , Aa^Fpa      , Aa^Fpa      , Aa          , Ai          , Ai          , Aa          , Ha          , Aa          , Ha          , Ha          , Mm          , Mm          , Aa^Fpa      , Aa^Fpa      , Aa^Fpa      , Rr          , Rr          , Aa^Vha      , Aa^Fpa      , Aa^Fpa      , Aa^Fpa      , Aa          , Ha          , Ha          , Ha          , Ha          , Ha          , Mm          , Ai          , Ai          , Ai          , Ai          
Aa^Fpa      , Aa^Fpa      , Aa^Fpa      , Aa^Fpa      , Aa^Fpa      , Aa^Fpa      , Aa^Fpa      , Aa          , Aa          , Ai          , Aa          , Aa          , Aa^Vha      , Aa          , Ai          , Mm          , Aa^Fpa      , Aa^Fpa      , Aa^Fpa      , Aa^Fpa      , Rr          , Aa          , Aa          , Aa^Fpa      , Aa^Fpa      , Aa^Fpa      , Aa^Fpa      , Aa          , Aa^Fpa      , Ha          , Ha          , Ha          , Ai          , Ai          , Mm          , Mm          , Mm          
Aa^Fpa      , Aa^Fpa      , Aa^Fpa      , Ai          , Chr         , Aa^Fpa      , Aa          , Aa          , Ai          , Ai          , Ai          , Aa          , Ai          , Ai          , Aa          , Aa^Fpa      , Aa^Fpa      , Aa^Fpa      , Aa^Fpa      , Rr          , Aa          , Aa          , Ha          , Ha          , Ha          , Ha          , Ha          , Aa^Fpa      , Aa^Fpa      , Aa^Fpa      , Ai          , Ai          , Ha          , Ha          , Ha          , Mm          , Mm          
Aa^Fpa      , Aa^Fpa      , Aa^Fpa      , Ch          , 2 Kh        , Ch          , Aa          , Ai          , Ai          , Wo          , Wo          , Ai          , Aa          , Aa          , Aa          , Aa          , Aa^Vha      , Aa^Fpa      , Rr          , Rr          , Aa          , Ha          , Ha          , Ha          , Ha          , Ha          , Ha          , Aa^Fpa      , Aa^Fpa      , Aa^Fpa      , Ai          , Ha          , Ha          , Ha          , Ha          , Ha          , Ha          
Aa^Fpa      , Aa^Fpa      , Aa          , Ch          , Chr         , Re          , Re          , Aa^Vha      , Ai          , Ai          , Ai          , Ai          , Aa          , Aa          , Aa          , Aa          , Rr          , Rr          , Aa          , Aa          , Aa          , Aa          , Ha          , Ha          , Ha          , Ha          , Aa          , Aa          , Aa          , Ai          , Ha          , Ha          , Ha          , Ha          , Ha          , Ha          , Ha          
Aa          , Aa          , Aa          , Aa          , Ai          , Ai          , Ai          , Ai          , Aa          , Aa          , Aa          , Ai          , Aa          , Aa          , Aa          , Aa          , Rr          , Rr          , Rr          , Aa          , Aa          , Ha          , Ha          , Aa^Vha      , Ai          , Aa          , Aa          , Aa          , Ai          , Ai          , Ha          , Ha          , Ha          , Ha          , Ha          , Ha          , Ha          
Aa          , Aa          , Aa          , Ai          , Aa          , Aa          , Aa          , Re          , Re          , Aa          , Aa          , Aa          , Re          , Aa          , Re          , Rr          , Aa          , Aa          , Rr          , Aa          , Aa          , Aa          , Aa          , Ai          , Ai          , Aa          , Aa^Vha      , Aa^Fpa      , Ai          , Aa^Fpa      , Aa^Fpa      , Ha          , Ha          , Ha          , Ai          , Aa          , Aa          
Aa          , Aa          , Ai          , Ai          , Aa          , Aa          , Aa          , Aa          , Aa          , Re          , Re          , Re          , Aa^Vha      , Re          , Aa          , Aa          , Aa^Fpa      , Aa          , Re          , Aa^Vha      , Aa          , Aa          , Ai          , Ai          , Wo          , Ai          , Ai          , Ai          , Aa^Fpa      , Aa^Fpa      , Aa^Fpa      , Aa          , Aa          , Aa          , Aa^Fpa      , Aa          , Aa          
Ai          , Ai          , Aa          , Aa          , Aa          , Aa          , Aa          , Aa          , Aa          , Aa          , Aa          , Aa          , Ha          , Ha          , Ha          , Aa^Fpa      , Aa^Fpa      , Aa^Fpa      , Re          , Aa          , Aa          , Aa          , Ai          , Wo          , Wo          , Wo          , Ai          , Aa          , Aa          , Aa^Fpa      , Aa^Fpa      , Aa^Fpa      , Aa^Fpa      , Aa^Fpa      , Aa^Fpa      , Aa^Fpa      , Aa^Fpa      
Aa          , Aa          , Aa^Fpa      , Aa^Fpa      , Aa^Fpa      , Aa          , Aa          , Aa          , Aa          , Aa          , Aa          , Aa          , Ha          , Ha          , Ha          , Aa^Fpa      , Aa^Fpa      , Aa^Fpa      , Re          , Aa          , Aa          , Ai          , Aa^Vha      , Ai          , Ai          , Ai          , Aa          , Aa          , Aa          , Aa^Fpa      , Aa^Fpa      , Aa^Fpa      , Aa^Fpa      , Aa^Fpa      , Aa^Fpa      , Aa^Fpa      , Aa^Fpa      
Aa          , Aa          , Aa^Fpa      , Aa^Fpa      , Aa^Fpa      , Aa^Fpa      , Aa^Fpa      , Aa          , Aa          , Aa          , Ha          , Ha          , Ha          , Ha          , Aa^Fpa      , Aa^Fpa      , Aa^Fpa      , Aa^Fpa      , Re          , Aa          , Aa          , Aa          , Aa          , Aa          , Aa          , Ai          , Aa^Vha      , Aa          , Aa          , Aa^Fpa      , Aa^Fpa      , Aa^Fpa      , Aa^Fpa      , Aa^Vha      , Aa^Fpa      , Aa^Fpa      , Aa^Fpa      
Aa          , Aa          , Aa^Fpa      , Aa^Fpa      , Aa^Fpa      , Aa^Fpa      , Aa^Fpa      , Aa^Vha      , Aa          , Ha          , Ha          , Ha          , Ai          , Ha          , Aa^Fpa      , Aa^Fpa      , Aa^Fpa      , Aa^Fpa      , Re          , Aa          , Aa          , Aa          , Aa          , Aa          , Aa          , Ai          , Aa          , Aa          , Aa          , Aa          , Aa          , Aa^Fpa      , Aa^Fpa      , Aa^Fpa      , Ai          , Aa^Fpa      , Aa^Fpa      
Aa          , Aa          , Aa^Fpa      , Aa^Fpa      , Aa^Fpa      , Aa^Fpa      , Aa^Fpa      , Aa^Fpa      , Aa^Fpa      , Ha          , Ha          , Ha          , Ha          , Ha          , Ha          , Aa^Fpa      , Aa^Fpa      , Aa^Fpa      , Re          , Aa          , Aa^Fpa      , Aa^Fpa      , Aa^Fpa      , Aa          , Aa          , Ai          , Aa          , Aa^Fpa      , Aa^Fpa      , Aa          , Aa          , Aa^Fpa      , Aa^Fpa      , Ai          , Ai          , Aa          , Aa          
Aa^Fpa      , Aa^Fpa      , Aa^Fpa      , Aa^Fpa      , Aa^Fpa      , Aa^Vha      , Aa^Fpa      , Aa^Fpa      , Aa^Fpa      , Aa          , Aa          , Aa          , Aa          , Ha          , Ha          , Aa          , Aa          , Aa          , Re          , Aa          , Aa^Fpa      , Aa^Fpa      , Aa^Fpa      , Aa          , Aa          , Ai          , Ai          , Aa^Fpa      , Aa^Fpa      , Aa^Vha      , Aa          , Aa          , Aa          , Aa          , Ai          , Aa          , Aa          
Aa^Fpa      , Aa^Fpa      , Aa^Fpa      , Aa^Fpa      , Aa^Fpa      , Aa^Fpa      , Aa          , Aa^Fpa      , Aa          , Aa          , Aa          , Aa          , Ha          , Ha          , Ha          , Aa          , Aa          , Aa          , Re          , Aa          , Aa^Fpa      , Aa^Fpa      , Re          , Aa^Fpa      , Aa^Vha      , Ai          , Ai          , Ai          , Ai          , Aa          , Aa          , Aa          , Aa          , Aa          , Aa          , Aa          , Aa          
Aa^Fpa      , Aa^Fpa      , Ai          , Aa^Fpa      , Aa^Fpa      , Aa^Fpa      , Aa          , Aa          , Aa          , Ai          , Ai          , Aa          , Aa          , Ha          , Aa^Fpa      , Aa^Fpa      , Aa^Fpa      , Aa          , Aa          , Re          , Re          , Re          , Aa^Fpa      , Re          , Re          , Aa          , Aa          , Aa          , Ai          , Aa          , Re          , Aa          , Ce          , Ce          , Ce          , Aa          , Aa          
Aa^Fpa      , Aa^Fpa      , Ai          , Aa^Fpa      , Aa          , Aa          , Aa^Vha      , Aa          , Aa          , Ai          , Ai          , Aa          , Aa^Fpa      , Aa^Fpa      , Aa^Fpa      , Aa^Fpa      , Aa^Fpa      , Aa^Fpa      , Aa          , Re          , Aa          , Aa^Fpa      , Aa^Fpa      , Aa^Fpa      , Aa          , Re          , Re          , Aa          , Ai          , Ai          , Aa^Vha      , Re          , Ce          , 1 Ke        , Ce          , Aa          , Aa          
Aa^Fpa      , Aa^Fpa      , Aa^Fpa      , Aa^Fpa      , Aa          , Aa          , Aa          , Aa          , Aa          , Aa          , Aa          , Aa          , Aa^Fpa      , Aa^Fpa      , Aa^Fpa      , Aa^Fpa      , Aa^Fpa      , Aa^Fpa      , Aa          , Re          , Aa^Vha      , Aa^Fpa      , Aa^Fpa      , Aa^Fpa      , Aa^Fpa      , Aa^Fpa      , Re          , Aa          , Aa          , Ww          , Ww^Bw/      , Re          , Aa          , Ce          , Aa          , Aa          , Aa          
Aa^Fpa      , Aa^Fpa      , Aa^Fpa      , Aa^Fpa      , Aa          , Aa          , Ha          , Ha          , Ha          , Aa          , Aa          , Aa          , Aa          , Aa^Fpa      , Aa^Fpa      , Aa^Fpa      , Aa^Fpa      , Aa^Fpa      , Aa          , Re          , Aa          , Aa^Fpa      , Aa^Fpa      , Aa^Fpa      , Aa^Fpa      , Aa^Fpa      , Aa^Fpa      , Re          , Re          , Re          , Ww          , Ww          , Ww          , Aa          , Ww          , Aa          , Aa          
Aa^Fpa      , Aa^Fpa      , Aa^Fpa      , Aa          , Aa          , Ha          , Ha          , Ha          , Ha          , Aa          , Ha          , Aa          , Aa          , Aa          , Aa          , Aa^Fpa      , Aa^Fpa      , Aa^Fpa      , Aa          , Re          , Aa          , Aa          , Aa^Fpa      , Aa^Fpa      , Aa^Fpa      , Aa^Fpa      , Aa          , Aa          , Aa          , Aa^Vha      , Ww          , Ww          , Ww          , Ww          , Ww          , Ww          , Ww          
Aa^Fpa      , Aa^Fpa      , Aa^Fpa      , Aa^Fpa      , Aa          , Ha          , Ha          , Ha          , Ha          , Ha          , Ha          , Ha          , Ha          , Aa^Vha      , Ha          , Ha          , Ha          , Aa          , Re          , Re          , Aa^Fpa      , Aa^Fpa      , Aa^Fpa      , Aa^Fpa      , Aa^Fpa      , Aa          , Ai          , Aa          , Aa          , Aa          , Ww          , Ww          , Ww          , Ww          , Ww          , Ww          , Ww          
Aa^Fpa      , Aa^Fpa      , Aa^Fpa      , Aa^Fpa      , Ai          , Aa          , Ai          , Ai          , Ai          , Ha          , Ha          , Ha          , Ha          , Ha          , Ha          , Ha          , Ha          , Aa          , Re          , Aa          , Aa^Fpa      , Aa^Fpa      , Aa^Fpa      , Aa^Fpa      , Aa          , Ai          , Ai          , Ai          , Ww          , Ww          , Ww          , Ww          , Wo          , Wo          , Wo          , Wo          , Wo          
Aa^Fpa      , Aa^Fpa      , Aa^Fpa      , Ai          , Wo          , Ai          , Ai          , Ai          , Aa^Vha      , Ha          , Ha          , Ai          , Ha          , Ha          , Aa          , Ha          , Aa          , Aa          , Re          , Aa          , Aa          , Aa^Fpa      , Aa^Fpa      , Aa^Fpa      , Aa          , Ai          , Ww          , Ww          , Ww          , Ww          , Wo          , Ww          , Wo          , Wo          , Wo          , Wo          , Wo          
Aa^Fpa      , Aa^Fpa      , Aa^Fpa      , Ai          , Ai          , Wo          , Ai          , Aa          , Ha          , Ha          , Mm          , Ha          , Ha          , Ha          , Re          , Aa          , Re          , Re          , Ha          , Aa^Vha      , Aa          , Aa          , Ai          , Aa          , Ww          , Ww          , Ww          , Ww          , Wo          , Ww          , Wo          , Wo          , Wo          , Wo          , Wo          , Wo          , Wo          
Aa^Fpa      , Aa^Fpa      , Aa^Fpa      , Aa^Fpa      , Ai          , Ai          , Ha          , Ha          , Mm          , Mm          , Mm          , Mm          , Mm          , Mm          , Re          , Re          , Ha          , Ha          , Ha          , Ha          , Aa          , Ai          , Aa          , Ai          , Aa          , Ww          , Ww          , Wo          , Wo          , Wo          , Wo          , Wo          , Wo          , Wo          , Wo          , Wo          , Wo          
Aa^Fpa      , Aa^Fpa      , Aa          , Aa^Fpa      , Ai          , Ha          , Ha          , Ha          , Ha          , Ha          , Mm          , Mm          , Ha          , Re          , Mm          , Ha          , Ha          , Ha          , Aa          , Aa          , Aa^Fpa      , Aa^Fpa      , Aa^Fpa      , Aa          , Aa          , Ww          , Ww          , Wo          , Wo          , Wo          , Wo          , Wo          , Wo          , Wo          , Wo          , Wo          , Wo          
Aa          , Aa          , Aa          , Aa          , Ai          , Ha          , Ha          , Ha          , Ha          , Mm          , Mm          , Mm          , Mm          , Re          , Mm          , Ha          , Ha          , Ha          , Ha          , Aa          , Aa^Fpa      , Aa          , Aa^Fpa      , Aa^Vha      , Ai          , Ai          , Ww          , Ww          , Wo          , Wo          , Wo          , Wo          , Wo          , Wo          , Wo          , Wo          , Wo          
Aa          , Aa          , Aa^Vha      , Aa          , Ww          , Ha          , Ha          , Ha          , Mm          , Mm          , Mm          , Mm          , Cud         , Re          , Mm          , Ha          , Ha          , Ha          , Ha          , Aa^Fpa      , Aa^Fpa      , Aa^Fpa      , Aa^Fpa      , Aa          , Ai          , Ww          , Ww          , Ww          , Wo          , Wo          , Wo          , Wo          , Wo          , Wo          , Wo          , Wo          , Wo          
Ww          , Ww          , Ww          , Ww          , Aa          , Aa          , Ha          , Ha          , Mm          , Mm          , Mm          , Cud         , 4 Kud       , Cud         , Mm          , Mm          , Ha          , Ha          , Aa^Vha      , Ha          , Aa          , Aa^Fpa      , Ai          , Ai          , Ww          , Ww          , Ww          , Wo          , Wo          , Wo          , Wo          , Wo          , Wo          , Wo          , Wo          , Wo          , Wo          
Ww          , Ww          , Ww          , Ww          , Aa          , Aa          , Aa          , Ha          , Ha          , Mm          , Mm          , Cud         , Cud         , Cud         , Mm          , Mm          , Ha          , Ha          , Ha          , Ha          , Aa          , Aa          , Ai          , Ww          , Wo          , Ww          , Wo          , Wo          , Wo          , Wo          , Wo          , Wo          , Wo          , Wo          , Wo          , Wo          , Wo          
Ww          , Ww          , Ww          , Ww          , Ai          , Aa          , Aa          , Ha          , Ha          , Ha          , Ha          , Mm          , Mm          , Mm          , Mm          , Mm          , Ha          , Ha          , Ha          , Aa          , Aa          , Aa          , Ai          , Ww          , Ww          , Wo          , Wo          , Wo          , Wo          , Wo          , Wo          , Wo          , Wo          , Wo          , Wo          , Wo          , Wo          
Wo          , Wo          , Ww          , Ww          , Ai          , Aa          , Aa          , Aa          , Ha          , Ha          , Ha          , Ha          , Ha          , Ha          , Aa^Vha      , Ha          , Aa          , Ha          , Aa          , Aa          , Ai          , Ai          , Ww          , Ww          , Ww          , Wo          , Wo          , Wo          , Wo          , Wo          , Wo          , Wo          , Wo          , Wo          , Wo          , Wo          , Wo          
Wo          , Wo          , Ww          , Ww          , Ww          , Ai          , Aa          , Aa          , Aa          , Ha          , Ha          , Ha          , Aa          , Aa^Fpa      , Aa^Fpa      , Aa^Fpa      , Aa^Fpa      , Aa          , Aa          , Aa          , Ai          , Ww          , Ww          , Ww          , Wo          , Wo          , Wo          , Wo          , Wo          , Wo          , Wo          , Wo          , Wo          , Wo          , Wo          , Wo          , Wo          
Wo          , Wo          , Wo          , Wo          , Ww          , Ai          , Ai          , Aa          , Ai          , Aa          , Aa^Vha      , Aa          , Aa          , Aa^Fpa      , Aa^Fpa      , Aa^Fpa      , Aa^Fpa      , Aa^Fpa      , Aa          , Ai          , Ai          , Ww          , Ww          , Wo          , Wo          , Wo          , Wo          , Wo          , Wo          , Wo          , Wo          , Wo          , Wo          , Wo          , Wo          , Wo          , Wo          
Wo          , Wo          , Wo          , Wo          , Wo          , Ww          , Ww          , Ai          , Ai          , Aa          , Aa          , Aa          , Ai          , Aa          , Ai          , Aa          , Ai          , Aa          , Ai          , Ai          , Ww          , Ww          , Wo          , Wo          , Wo          , Wo          , Wo          , Wo          , Wo          , Wo          , Wo          , Wo          , Wo          , Wo          , Wo          , Wo          , Wo          
Wo          , Wo          , Wo          , Wo          , Wo          , Wo          , Ww          , Ai          , Ww          , Ai          , Ai          , Ai          , Ai          , Ai          , Ww          , Ai          , Ai          , Ai          , Ai          , Ai          , Ww          , Ww          , Wo          , Wo          , Wo          , Wo          , Wo          , Wo          , Wo          , Wo          , Wo          , Wo          , Wo          , Wo          , Wo          , Wo          , Wo          
Wo          , Wo          , Wo          , Wo          , Wo          , Ww          , Ww          , Ww          , Ww          , Ww          , Ww          , Ww          , Ww          , Ww          , Wo          , Ww          , Ww          , Ww          , Ww          , Ww          , Ww          , Ww          , Wo          , Wo          , Wo          , Wo          , Wo          , Wo          , Wo          , Wo          , Wo          , Wo          , Wo          , Wo          , Wo          , Wo          , Wo          
Wo          , Wo          , Wo          , Wo          , Wo          , Wo          , Wo          , Wo          , Wo          , Ww          , Wo          , Ww          , Wo          , Wo          , Wo          , Ww          , Wo          , Ww          , Wo          , Wo          , Wo          , Wo          , Wo          , Wo          , Wo          , Wo          , Wo          , Wo          , Wo          , Wo          , Wo          , Wo          , Wo          , Wo          , Wo          , Wo          , Wo          
Wo          , Wo          , Wo          , Wo          , Wo          , Wo          , Wo          , Wo          , Wo          , Wo          , Wo          , Wo          , Wo          , Wo          , Wo          , Wo          , Wo          , Wo          , Wo          , Wo          , Wo          , Wo          , Wo          , Wo          , Wo          , Wo          , Wo          , Wo          , Wo          , Wo          , Wo          , Wo          , Wo          , Wo          , Wo          , Wo          , Wo          
