WWWWWWWWWuWWWWWuWWWWWWWWW
WWWWWWWuuDuuuuuDuuWWWWWWW
WWWWWuuWuuuooouuuWuuWWWWW
WWWWWuuuWuuo2ouuWuuuWWWWW
WWWWWuuWWuuuouu[WWuuWWWWW
WWWWWuuuuuuuuuu[[uuuWWWWW
WWWWWWuuuuWWWWWuuuuWWWWWW
WWWWWWWWuuuuuuuuuWWWWWWWW
WWWWWWWWWW[[uuuWWWWWWWWWW
WWWWWWWWWWW[uuWWWWWWWWWWW
WWWWWWWWWW[[uuuWWWWWWWWWW
WWWWWWWWWWuuWu[WWWWWWWWWW
WWWWWWWWWuuWWWuuWWWWWWWWW
WWWWW[Wuuuuuu]uuuuWWWWWWW
WWWW]u]]uccc]cccuuuuuuWWW
Wsssu\cccssscsssccc/usWsW
WWW[c]u]ccscscscc]uucusWW
WWWuuDuu]]c]c]c]]uuDuuWWW
WWWWuu]]uW]W]W]Wuuu]]WWWW
WWWWWWW]uuWWWWW[uuWWWWWWW
WWWWWWuWuuuuuu[uuW[WWWWWW
WWWWWWuuuuuo'ouuuu[WWWWWW
WWWWWWWW[[uo1ouu[WWWWWWWW
WWWWWWWWW[[[ou[[WWWWWWWWW
WWWWWWWWWWWW[WWWWWWWWWWWW
