border_size=1
usage=map

Gs^Fp       , Gs^Fp       , Gs^Fp       , Gs^Fp       , Gs^Fp       , Gs^Fp       , Gs^Fp       , Gs^Fp       , Gs^Fp       , Gs^Fp       , Gs^Fp       , Gs^Fp       , Gs^Fp       , Gs^Fp       , Gs^Fp       , Gs^Fp       , Gs^Fp       , Gs^Fp       , Gs^Fp       , Gs^Fp       , Gs^Fp       , Gs^Fp       , Gs^Fp       , Gs^Fp       , Gs^Fp       , Gs^Fp       , Gs^Fp       , Gs^Fp       , Gs^Fp       , Gg          , Gg          , Gg          , Gg          , Gg          , Gs^Fp       , Gs^Fp       , Gs^Fp       
Gs^Fp       , Gs^Fp       , Gs^Fp       , Gs^Fp       , Gs^Fp       , Gs^Fp       , Gs^Fp       , Gs^Fp       , Gs^Fp       , Gs^Fp       , Gs^Fp       , Gs^Fp       , Gs^Fp       , Gs^Fp       , Gs^Fp       , Gs^Fp       , Gs^Fp       , Gs^Fp       , Gs^Fp       , Gs^Fp       , Gs^Fp       , Gs^Fp       , Gs^Fp       , Gs^Fp       , Gs^Fp       , Gs^Fp       , Gs^Fp       , Gs^Fp       , Gs^Fp       , Gg          , Gg          , Gg          , Gg^Vh       , Gg          , Gs^Fp       , Gs^Fp       , Gs^Fp       
Gs^Fp       , Gs^Fp       , Gs^Fp       , Gs^Fp       , Gs^Fp       , Gs^Fp       , Gs^Fp       , Gs^Fp       , Gs^Fp       , Gs^Fp       , Gs^Fp       , Gs^Fp       , Gs^Fp       , Gs^Fp       , Gs^Fp       , Gs^Fp       , Gs^Fp       , Gs^Fp       , Gs^Fp       , Gg^Vh       , Gs^Fp       , Gg          , Gs^Fp       , Gs^Fp       , Gs^Fp       , Gs^Fp       , Gs^Fp       , Gs^Fp       , Gs^Fp       , Gg          , Gs^Fp       , Gg          , Gs          , Gs          , Gs          , Gs^Fp       , Gs^Fp       
Gs^Fp       , Gs^Fp       , Gs^Fp       , Gs^Fp       , Gg          , Gs^Fp       , Gs^Fp       , Gs^Fp       , Gs^Fp       , Gs^Fp       , Gs^Fp       , Gs^Fp       , Gs^Fp       , Gs^Fp       , Gs^Fp       , Gs^Fp       , Gs^Fp       , Gs^Fp       , Gs^Fp       , Gs^Fp       , Gg          , Gs^Fp       , Gs^Fp       , Gg          , Gg          , Gg          , Gg          , Gs^Fp       , Gs^Fp       , Gs^Fp       , Gg          , Gs          , Ss          , Ss          , Ss          , Gs          , Gs          
Gs^Fp       , Gs^Fp       , Gs^Fp       , Gs^Fp       , Gs^Fp       , Gg^Vh       , Gs^Fp       , Gs^Fp       , Gs^Fp       , Gs^Fp       , Gs^Fp       , Gg          , Gg          , Gg          , Gg          , Gs^Fp       , Gs^Fp       , Gs^Fp       , Gs^Fp       , Gs^Fp       , Gs^Fp       , Gg          , Gs^Fp       , Gg          , Gs^Fp       , Gg          , Gg          , Gg          , Gg          , Gs          , Gs          , Ss          , Ss          , Ss^Vhs      , Ss          , Ss          , Ss          
Gs^Fp       , Gs^Fp       , Gs^Fp       , Gs^Fp       , Gs^Fp       , Gs^Fp       , Gs^Fp       , Gs^Fp       , Gs^Fp       , Gs^Fp       , Gg          , Gs          , Ce          , Gg          , Gg          , Gs^Fp       , Gs^Fp       , Gs^Fp       , Gg          , Gs^Fp       , Gg          , Gg          , Gg          , Gs^Fp       , Gg          , Gg          , Gg          , Gs          , Gs          , Gs          , Gs          , Gs          , Ss          , Gs          , Gs          , Ss          , Ss          
Gs^Fp       , Gs^Fp       , Gs^Fp       , Gs^Fp       , Gs^Fp       , Gs^Fp       , Gs^Fp       , Gs^Fp       , Gs^Fp       , Gg          , Gs          , Ce          , 1 Ke        , Ce          , Gs          , Gs^Fp       , Gs^Fp       , Gg          , Gs^Fp       , Gg          , Gs^Fp       , Gs^Fp       , Gg          , Gg          , Gg          , Gs          , Ss          , Ss          , Ss          , Ss          , Ss          , Gs          , Ww^Bw\      , Ss          , Ss          , Ss          , Ss          
Gs^Fp       , Gs^Fp       , Gs^Fp       , Gs^Fp       , Gs^Fp       , Gs^Fp       , Gs^Fp       , Gs^Fp       , Gs^Fp       , Gg          , Gs          , Ce          , Ce          , Ce          , Gs          , Gg          , Gs^Fp       , Gs^Fp       , Gs^Fp       , Gs^Fp       , Gs^Fp       , Gg          , Gg          , Gg^Vh       , Gg          , Gg          , Ss          , Ss          , Ss          , Ww          , Ww          , Ss          , Gs^Fp       , Gs          , Ss          , Ww          , Ww          
Gs^Fp       , Gs^Fp       , Gs^Fp       , Gs^Fp       , Gs^Fp       , Gs^Fp       , Gs^Fp       , Gs^Fp       , Gg          , Gg          , Gg^Vh       , Gs          , Gs          , Gs          , Gs^Fp       , Gs          , Gg          , Gg          , Gg          , Gg          , Gg          , Gg          , Gs^Fp       , Gg          , Gg          , Gs          , Ss          , Gs          , Ss          , Ww          , Ss          , Ss          , Ss          , Gs          , Ss          , Ww          , Ww          
Gs^Fp       , Gs^Fp       , Gs^Fp       , Gs^Fp       , Gs^Fp       , Gs^Fp       , Gg          , Gs^Fp       , Gg          , Gg          , Gg          , Gs          , Gg          , Gs^Fp       , Gg          , Gs          , Gs          , Gg^Vh       , Gg          , Gg          , Gg          , Gs^Fp       , Gs^Fp       , Gg          , Gg          , Gs          , Ss          , Ss          , Ww          , Ss          , Gs          , Ss          , Ww          , Ww^Bw|      , Ss          , Ss^Vhs      , Ss          
Gs^Fp       , Gs^Fp       , Gs^Fp       , Gg          , Gg          , Gg          , Gg          , Gs^Fp       , Rd          , Rd          , Gs^Fp       , Gg          , Gg          , Gg          , Gs^Fp       , Gg          , Gs          , Gs          , Gs          , Gg          , Gg          , Gs^Fp       , Gs          , Ss          , Gs          , Gg          , Gs          , Ss          , Ss          , Ss          , Ss          , Ss          , Ss          , Ww^Bw|      , Ss          , Ss          , Ss          
Gs^Fp       , Gs^Fp       , Gg          , Gg          , Gg          , Gg^Vh       , Rd          , Rd          , Gg          , Gs^Fp       , Gs^Fp       , Gg          , Gg          , Gg          , Gs^Fp       , Gg          , Gs^Fp       , Gs^Fp       , Gs          , Gs          , Gs          , Gg          , Gg          , Ss          , Ss          , Gs          , Ss          , Gs          , Ss          , Ww          , Ss          , Gs          , Gs          , Gs          , Ss          , Gs          , Gs          
Gg          , Gg          , Gs^Fp       , Gg          , Rd          , Rd          , Gg          , Gg          , Gg          , Gg          , Gg          , Gg          , Gg          , Gs^Fp       , Gg          , Gs^Fp       , Gs^Fp       , Gg          , Gs^Fp       , Gs          , Gs          , Gg^Vh       , Gg          , Ss          , Ss          , Ss^Vhs      , Ww          , Ss          , Ss          , Ss          , Gs^Fp       , Ss          , Ww          , Ww^Bw|      , Ww          , Ss          , Ss          
Gg          , Gg          , Gg          , Gg          , Rd          , Rd          , Ss          , Gg          , Ss          , Gg          , Gg          , Gg          , Gg          , Gg          , Gg          , Gg          , Gg          , Gg          , Gs          , Gs          , Ss          , Gs          , Gg          , Gs^Fp       , Gs^Fp       , Ss          , Ww          , Ww          , Ss^Vhs      , Gs^Fp       , Chr         , Gs^Fp       , Gs^Fp       , Ww^Bw|      , Ss          , Ww          , Ww          
Ss          , Ss          , Ss          , Ss          , Ss          , Ww^Bw\      , Ww^Bw\      , Ss          , Ss          , Gs^Fp       , Gs^Fp       , Gg          , Ss          , Ss          , Ss          , Ss          , Ss          , Gg          , Gs          , Gg          , Ss          , Gs          , Gs          , Gg          , Gg          , Ss          , Ss          , Ww          , Ss          , Ss          , Gs^Fp       , 3 Khr       , Chr         , Gs          , Ss          , Ww          , Ww          
Ww          , Ww          , Ss          , Rd          , Ss          , Ss          , Ss          , Rd          , Ss          , Ss          , Ss          , Ss          , Ss          , Gg          , Ss          , Ss          , Ww^Bw/      , Ww^Bw/      , Gg          , Ss          , Ss          , Ss          , Gg          , Gs          , Ww^Bw\      , Ss          , Gs^Fp       , Ss          , Ss          , Ss          , Ss          , Chr         , Ss          , Ww^Bw|      , Gg          , Ss          , Ss          
Ss          , Ss          , Ww          , Ss          , Ww          , Ss^Vhs      , Ss          , Ww^Bw|      , Ss          , Ww          , Ww          , Ww          , Ww          , Ss          , Ss          , Gg          , Ss          , Ss          , Ss          , Ss          , Gg          , Gs^Fp       , Gg          , Ss          , Ss          , Gs          , Gs          , Gs^Fp       , Gs^Fp       , Ss          , Ww          , Ww          , Ss          , Gs          , Gg          , Gs^Fp       , Gs^Fp       
Ww          , Ww          , Ww          , Ww          , Ww          , Ss          , Ww^Bw/      , Rd          , Ss          , Ww          , Ss          , Ww          , Ss          , Ww          , Ss          , Ww^Bw|      , Ss          , Ww          , Ss          , Gg          , Gs^Fp       , Gs^Fp       , Gg          , Ss          , Gg          , Gs^Fp       , Gg          , Gs          , Ww^Bw\      , Ss          , Ss          , Ss          , Ww^Bw/      , Ww^Bw/      , Ss          , Gs^Fp       , Gs^Fp       
Ss          , Ss          , Ss          , Ss          , Ww^Bw/      , Ww^Bw/      , Ww          , Ss          , Rd          , Ss^Vhs      , Gg          , Ss          , Gg          , Ss          , Gg          , Ww^Bw|      , Ss          , Ww          , Ww          , Ss          , Ss          , Gs^Fp       , Gg          , Ss          , Gg          , Ss          , Gg          , Gg          , Ss          , Gs          , Ww^Bw/      , Gs          , Ss          , Ww          , Ww          , Ss          , Ss          
Gs^Fp       , Gs^Fp       , Chr         , Rd          , Ss          , Ww          , Ss          , Ss          , Ss          , Ss          , Ss          , Gg          , Gg          , Ss          , Gg^Vh       , Gg          , Ss          , Ww          , Ss          , Ss^Vhs      , Ss          , Ss          , Ss          , Ss          , Ss          , Ss          , Ss          , Ss          , Ss          , Gs          , Ss          , Gs^Fp       , Gs^Fp       , Ss          , Ww          , Ww          , Ww          
Gs^Fp       , Gs^Fp       , 2 Khr       , Chr         , Ww          , Ss          , Ss^Vhs      , Gs^Fp       , Gs^Fp       , Gs^Fp       , Gs^Fp       , Ss          , Gg          , Ss          , Ww^Bw/      , Gg          , Gg          , Ss          , Gg          , Ss          , Ww          , Ww          , Ww          , Ww          , Ss          , Ss          , Ss          , Ww          , Ss          , Ww^Bw|      , Ss          , Gg          , Ss          , Ss          , Ww          , Ww          , Ww          
Gs^Fp       , Gs^Fp       , Chr         , Rd          , Ww^Bw\      , Ss          , Ss          , Gg          , Gs^Fp       , Gs^Fp       , Gs^Fp       , Gs^Fp       , Gg          , Gg          , Hh          , Ss          , Ss          , Ss          , Ss          , Ss          , Ss          , Ss          , Ss          , Ss          , Ss          , Gg          , Gs^Fp       , Ss          , Ww^Bw/      , Gs          , Gs          , Ss          , Ss          , Ss          , Ww          , Ww          , Ww          
Ss          , Ss          , Ww          , Ww          , Ss          , Ww^Bw\      , Ww^Bw\      , Gg          , Gg          , Gs^Fp       , Gs^Fp       , Gs^Fp       , Gs^Fp       , Gg          , Gg          , Hh          , Gs^Fp       , Gs^Fp       , Gs^Fp       , Gs^Fp       , Gs^Fp       , Gs^Fp       , Gs^Fp       , Gs          , Gs^Fp       , Gs^Fp       , Gs          , Gs          , Gs^Fp       , Ss          , Ss          , Ww^Bw\      , Ww^Bw\      , Ww          , Ss          , Ww          , Ww          
Ww          , Ww          , Ww          , Ww          , Ss          , Ss          , Ss          , Rd          , Ss          , Gg          , Ss          , Gs^Fp       , Gg          , Gs^Fp       , Gs^Fp       , Gg          , Gg          , Gs^Fp       , Gs^Fp       , Gs^Fp       , Rd          , Rd          , Gs^Fp       , Gs^Fp       , Rd          , Gs          , Gs          , Gs^Fp       , Ss          , Ss          , Ww          , Ww          , Ss          , Ww^Bw\      , Ww^Bw\      , Ss          , Ss          
Ww          , Ww          , Ww          , Ss^Vhs      , Ss          , Gg          , Ss          , Rd          , Rd          , Ss          , Gg          , Gg          , Gg          , Gs^Fp       , Rd          , Rd          , Rd          , Rd          , Rd          , Rd          , Rd          , Rd          , Rd          , Rd          , Rd          , Gs          , Rd          , Ss          , Ss          , Ww          , Ww          , Ww          , Ss          , Chs         , Chs         , Gs          , Gs          
Ss          , Ss          , Ss          , Ss          , Ss          , Gg          , Ss          , Ss          , Ss          , Rd          , Rd          , Rd          , Rd          , Rd          , Rd          , Rd          , Gs^Fp       , Rd          , Hh          , Hh          , Hh          , Hh          , Hh          , Rd          , Gs^Fp       , Rd          , Ss          , Gs          , Ss          , Ww          , Ss          , Ss          , Chs         , 4 Khs       , Gs^Fp       , Gs          , Gs          
Ss          , Ss          , Ss          , Gg          , Ss          , Ss          , Ss          , Ww          , Ss          , Ss          , Rd          , Gg          , Gs^Fp       , Gs^Fp       , Hh          , Hh          , Hh          , Hh          , Hh          , Hh          , Mm          , Hh          , Hh          , Gs^Fp       , Rd          , Rd          , Rd          , Ss^Vhs      , Ss          , Ww          , Ww          , Ss          , Ss          , Chs         , Ss          , Gs          , Gs          
Gs^Fp       , Gs^Fp       , Gs^Fp       , Ss          , Ss          , Ss          , Ss^Vhs      , Ss          , Gg          , Gg^Vh       , Rd          , Gs^Fp       , Gs^Fp       , Gs^Fp       , Hh          , Hh          , Mm          , Mm          , Mm          , Mm          , Mm          , Mm          , Hh          , Rd          , Gs^Fp       , Rd          , Ww^Bw\      , Ss          , Gs          , Ss          , Ww          , Ss^Vhs      , Ww          , Ww          , Ss          , Gs          , Gs          
Ss          , Ss          , Ss          , Gg          , Ss          , Ss          , Rd          , Ss          , Gg          , Gg          , Rd          , Rd          , Rd          , Hh          , Hh          , Mm          , Mm          , Mm          , Mm          , Mm          , Rr          , Hh          , Rd          , Rd          , Rd          , Ss          , Ss          , Rd          , Rd          , Ss          , Ss          , Ww          , Ss          , Ss          , Ww^Bw/      , Gs          , Gs          
Ww          , Ww          , Ww          , Ss          , Ss          , Ss          , Ss          , Ss          , Ss          , Rd          , Chr         , Gg          , Gg          , Hh          , Hh          , Hh          , Mm          , Mm          , Hh          , Hh          , Hh          , Rr          , Rd          , Gs^Fp       , Rd          , Ss          , Ww          , Ss          , Ss          , Gs          , Rd          , Gs          , Gs          , Gs          , Ss          , Gs          , Gs^Fp       
Ss          , Ss          , Ss          , Ss          , Ss          , Ss          , Ss^Vhs      , Rd          , Rd          , Chr         , 5 Khr       , Ss          , Ss          , Gs^Fp       , Gs^Fp       , Hh          , Hh          , Hh          , Hh          , Rd          , Rd          , Rd          , Ss          , Ss          , Rd          , Ss          , Ww          , Ww          , Ss          , Ss          , Gg          , Gg^Vh       , Ss          , Gs          , Gs^Fp       , Gs^Fp       , Gs^Fp       
Gs^Fp       , Gs^Fp       , Gg          , Gg          , Gs^Fp       , Ss          , Ss          , Ss          , Ss          , Ss          , Chr         , Chr         , Rd          , Ss          , Rd          , Gs^Fp       , Gs^Fp       , Rd          , Gs^Fp       , Rd          , Gg          , Gg^Vh       , Gg          , Ss          , Ss          , Ss          , Ww          , Ww          , Ss          , Gg          , Ss          , Ss          , Ww          , Ss          , Gs^Fp       , Gs^Fp       , Gs^Fp       
Gg          , Gg          , Ss^Vhs      , Ss          , Gs^Fp       , Gs^Fp       , Ss          , Ww          , Ww          , Ss          , Ss          , Gg          , Ss          , Ss^Vhs      , Ss          , Rd          , Gs^Fp       , Gs^Fp       , Gs^Fp       , Rd          , Gg          , Gg          , Ss          , Ss          , Ww          , Ww          , Ss          , Ww          , Ww          , Ss          , Ww          , Ww          , Ww          , Ss          , Gs^Fp       , Ss          , Ss          
Ss          , Ss          , Ss          , Ss          , Gs^Fp       , Gs^Fp       , Ss          , Ss          , Ss          , Ss          , Ss          , Ss          , Gg          , Ss          , Gs^Fp       , Gs^Fp       , Gg          , Gs^Fp       , Gg          , Gg          , Ss          , Ss          , Ss          , Ww          , Ss          , Ss          , Gs^Fp       , Ss          , Ss          , Ww          , Ss          , Ss          , Ss          , Ss          , Ss^Vhs      , Ss          , Ss          
Gs^Fp       , Gs^Fp       , Gs^Fp       , Ss          , Gs^Fp       , Ss          , Gs^Fp       , Gs^Fp       , Ss          , Gg          , Ss^Vhs      , Ss          , Ss          , Ss          , Ss          , Ss          , Ss          , Hh          , Ss          , Ss          , Ss          , Ss          , Gg          , Ss          , Gg          , Ss          , Gg          , Gs^Fp       , Ss          , Ss^Vhs      , Ss          , Gs^Fp       , Gs^Fp       , Ss          , Ss          , Ww          , Ww          
Gs^Fp       , Gs^Fp       , Gs^Fp       , Gs^Fp       , Gs^Fp       , Ss          , Gs^Fp       , Ss          , Ss          , Gg          , Gg          , Ss          , Ww          , Ww          , Ww          , Ss          , Ss          , Ss          , Gg^Vh       , Ss          , Ww          , Ss          , Ss          , Ss          , Ss          , Ss          , Ss          , Ss          , Ss          , Ss          , Gs          , Gs^Fp       , Ss          , Ss          , Ss          , Ww          , Ww          
Gs^Fp       , Gs^Fp       , Gs^Fp       , Gs^Fp       , Gs^Fp       , Gs^Fp       , Gs^Fp       , Gg          , Ss          , Ss          , Ss          , Ss          , Ww          , Ww          , Ww          , Ss          , Ss          , Gg          , Gg          , Ss          , Ww          , Ww          , Ss          , Ss          , Gg          , Gg          , Ss          , Ss          , Ss          , Gs          , Gs          , Gs^Fp       , Gs^Fp       , Gs^Fp       , Ss          , Ss          , Ss          
Gs^Fp       , Gs^Fp       , Gs^Fp       , Gs^Fp       , Gs^Fp       , Gs^Fp       , Gs^Fp       , Gg          , Ss          , Ss          , Ss          , Ss          , Ss          , Ww          , Ss          , Ss          , Ss          , Gg          , Gg          , Ss          , Ss          , Ss          , Ss          , Ss          , Ss          , Gg          , Gg          , Ss          , Ss          , Gs          , Gs          , Gs^Fp       , Gs^Fp       , Gs^Fp       , Gs^Fp       , Ss          , Ss          
