border_size=1
usage=map

Ai          , Ai          , Ai          , Ai          , Aa          , Aa          , Aa          , Aa          , Re          , Re          , Aa          , Aa^Fpa      , Aa          , Aa^Fpa      , Aa^Fpa      , Aa          , Aa          , Aa^Fpa      , Aa^Fpa      , Aa^Fpa      , Mm          , Mm          , Mm          , Mm          , Mm          , Hh          , Mm          , Mm          , Mm          , Mm          , Mm          , Mm          , Mm          , Ce          , Ce          , Ce          , Ce          
Ai          , Ai          , Ai          , Ai          , Aa^Vha      , Aa          , Aa          , Aa          , Re          , Re          , Aa          , Aa^Fpa      , Aa          , Aa^Fpa      , Aa^Fpa      , Aa          , Aa^Vha      , Aa^Fpa      , Aa^Fpa      , Aa^Fpa      , Mm          , Mm          , Mm          , Mm          , Mm          , Hh^Vhh      , Mm          , Mm          , Mm          , Mm          , Mm          , Mm          , Mm          , Ce          , 4 Ke        , Ce          , Ce          
Ai          , Ai          , Aa^Vha      , Aa          , Aa          , Mm          , Ce          , Re          , Ce          , Re          , Re          , Aa          , Aa^Fpa      , Aa^Fpa      , Mm          , Mm          , Mm          , Mm          , Mm          , Aa^Fpa      , Mm          , Mm          , Ai          , Mm          , Mm          , Mm          , Mm          , Mm          , Mm          , Aa          , Mm          , Mm          , Mm          , Mm          , Mm          , Ce          , Ce          
Aa          , Aa          , Aa^Fpa      , Aa^Fpa      , Aa          , Mm          , Ce          , 3 Ke        , Ce          , Aa          , Re          , Aa          , Aa^Vha      , Aa^Fpa      , Mm          , Mm          , Mm          , Mm          , Mm          , Mm          , Mm          , Mm          , Ai          , Mm          , Mm          , Mm          , Mm          , Mm          , Mm          , Mm          , Mm          , Mm          , Mm          , Mm          , Mm          , Mm          , Mm          
Aa^Fpa      , Aa^Fpa      , Aa          , Aa^Fpa      , Aa          , Mm          , Mm          , Ha          , Ha          , Aa          , Ha          , Re          , Ha          , Aa          , Mm          , Mm          , Mm          , Mm          , Mm          , Mm          , Mm          , Ai          , Ai          , Aa          , Aa          , Mm          , Ha          , Ha          , Ha          , Ha          , Ha          , Ha          , Ai          , Ai          , Mm          , Mm          , Mm          
Aa^Fpa      , Aa^Fpa      , Mm          , Aa          , Aa^Vha      , Aa          , Mm          , Mm          , Mm          , Ha          , Ha          , Re          , Ha          , Mm          , Mm          , Mm          , Mm          , Mm          , Ha          , Ha          , Ha          , Ai          , Ha          , Aa^Vha      , Aa          , Ha          , Aa^Fpa      , Ha          , Ha          , Aa          , Aa^Vha      , Aa^Fpa      , Ai          , Mm          , Mm          , Mm          , Mm          
Mm          , Mm          , Mm          , Mm          , Mm          , Mm          , Mm          , Mm          , Mm          , Mm          , Chr         , Re          , Chr         , Mm          , Mm          , Mm          , Mm          , Ha          , Ha          , Ha          , Aa^Fpa      , Ai          , Aa^Fpa      , Aa^Fpa      , Aa^Fpa      , Aa^Fpa      , Aa^Fpa      , Aa^Fpa      , Aa^Fpa      , Aa          , Ai          , Ai          , Aa^Fpa      , Mm          , Mm          , Mm          , Mm          
Mm          , Mm          , Mm          , Mm          , Mm          , Mm          , Mm          , Mm          , Mm          , Ha          , Ha          , Re          , Ha          , Ha          , Ha          , Mm          , Ha          , Ha          , Ha          , Ha          , Aa^Fpa      , Ai          , Ai          , Gs          , Ai          , Aa^Fpa      , Aa^Fpa      , Gs          , Aa^Fpa      , Ai          , Aa^Fpa      , Aa^Fpa      , Aa^Fpa      , Mm          , Mm          , Mm          , Mm          
Mm^Xm       , Mm^Xm       , Mm^Xm       , Mm          , Mm          , Mm          , Mm          , Mm          , Mm          , Mm          , Ha          , Re          , Re          , Ha          , Mm          , Mm          , Ha          , Aa^Fpa      , Aa^Fpa      , Aa^Fpa      , Aa^Fpa      , Aa^Fpa      , Ai          , Ai          , Ai          , Gs          , Gs          , Aa^Fpa      , Ai          , Ai          , Aa^Fpa      , Aa^Fpa      , Aa^Fpa      , Aa^Fpa      , Aa^Fpa      , Mm          , Mm          
Mm^Xm       , Mm^Xm       , Mm^Xm       , Mm^Xm       , Mm          , Mm          , Mm          , Mm          , Mm          , Aa^Fpa      , Ha          , Ha          , Re          , Ha          , Ha          , Ha          , Ha          , Ha          , Aa^Fpa      , Aa^Fpa      , Aa^Fpa      , Aa^Fpa      , Aa^Vha      , Ai          , Ai          , Ww          , Ww          , Ai          , Ai          , Gs          , Gs          , Aa^Fpa      , Gs          , Aa^Fpa      , Mm          , Mm          , Mm          
Mm^Xm       , Mm^Xm       , Mm^Xm       , Mm          , Mm          , Mm          , Mm          , Mm          , Mm          , Ha          , Aa^Fpa      , Ha          , Re          , Ha          , Gs          , Aa          , Gs          , Gs          , Aa^Fpa      , Aa^Fpa      , Aa^Fpa      , Aa^Fpa      , Ww          , Ai          , Ww          , Ww          , Wo          , Ww          , Ww          , Ww          , Aa^Fpa      , Aa^Fpa      , Aa^Fpa      , Mm          , Mm          , Mm          , Mm          
Mm^Xm       , Mm^Xm       , Mm^Xm       , Mm          , Mm^Xm       , Mm          , Mm          , Mm          , Mm          , Mm          , Aa^Fpa      , Aa^Fpa      , Aa          , Re          , Re          , Gs          , Gs          , Gs          , Gs          , Gs          , Ww          , Ww          , Wo          , Ww          , Wo          , Wo          , Wo          , Ww          , Ww^Bw\      , Gs          , Aa^Fpa      , Aa^Fpa      , Aa^Fpa      , Aa^Fpa      , Aa          , Mm          , Mm          
Mm^Xm       , Mm^Xm       , Mm          , Mm          , Mm          , Mm          , Mm          , Mm          , Mm          , Aa^Fpa      , Hh          , Aa^Fpa      , Gs          , Gs          , Re          , Gg^Vh       , Gs          , Gs          , Gs          , Gs          , Ww          , Ww          , Wo          , Wo          , Wo          , Wo          , Wo          , Ww          , Ww          , Gg^Vh       , Gs          , Gs          , Gs          , Aa^Fpa      , Gg^Vh       , Mm          , Mm          
Mm^Xm       , Mm^Xm       , Mm          , Mm          , Mm          , Mm          , Mm          , Mm          , Mm          , Mm          , Mm          , Hh          , Aa^Fpa      , Gs          , Gs          , Re          , Re          , Gs          , Gs^Fp       , Gs          , Ww          , Wo          , Wo          , Wo          , Ww          , Wo          , Wo          , Wo          , Wo          , Wo          , Wo          , Gs          , Gs          , Gs          , Mm          , Mm          , Mm          
Mm          , Mm          , Mm          , Mm          , Mm          , Mm          , Gs^Fp       , Mm          , Gs^Fp       , Mm          , Mm          , Hh          , Hh          , Gs          , Gs          , Gs          , Re          , Gs          , Gs^Fp       , Ww          , Wo          , Wo          , Ww          , Ww          , Gs          , Ww          , Wo          , Ch          , 1 Kh        , Ch          , Gs          , Gs          , Gs^Fp       , Gs          , Mm          , Mm          , Mm          
Mm          , Mm          , Mm          , Mm          , Mm          , Gs^Fp       , Gs^Fp       , Gs^Fp       , Gs^Fp       , Mm          , Hh          , Hh          , Hh          , Gs          , Gs          , Gs          , Re          , Ch          , Ww          , Ww          , Ww          , Wo          , Ww          , Ww          , Gs          , Ww          , Gs          , Ch          , Ch          , Ch          , Gs          , Gs          , Gs          , Gs^Fp       , Gs          , Mm          , Mm          
Mm          , Mm          , Mm          , Mm          , Gs^Fp       , Gs^Fp       , Gs^Fp       , Gg^Vh       , Ww          , Gs^Fp       , Ww          , Hh          , Hh          , Hh          , Gs          , Ch          , Gs          , Re          , Ww          , Ww          , Gs          , Ww          , Gg^Vh       , Gs^Fp       , Gs          , Gs          , Gs          , Gs          , Rr          , Gs          , Gs^Fp       , Gs^Fp       , Mm          , Gs^Fp       , Gg^Vh       , Mm          , Mm          
Mm          , Mm          , Mm          , Mm          , Gs^Fp       , Gs^Fp       , Gs^Fp       , Ww          , Ww          , Ss          , Ww          , Gs          , Gs          , Gs          , Gs          , Gs          , Gs          , Re          , Gg^Vh       , Ww          , Gs          , Gs^Fp       , Gs^Fp       , Gs^Fp       , Gs          , Gs          , Rr          , Rr          , Gs          , Gs          , Gs          , Mm          , Mm          , Mm          , Mm          , Mm          , Mm          
Mm          , Mm          , Mm          , Mm          , Hh          , Gs^Fp       , Gs^Fp       , Ss          , Gs^Fp       , Ss          , Ss          , Gs^Fp       , Gs          , Hh          , Gs          , Gs          , Gs          , Re          , Gs          , Ww          , Gs          , Gs^Fp       , Gs^Fp       , Gs          , Rr          , Rr          , Gg^Vh       , Re          , Gs          , Gs          , Gg^Vh       , Mm          , Mm          , Mm          , Mm          , Mm          , Mm          
Mm          , Mm          , Mm          , Hh          , Hh          , Gg^Vh       , Hh          , Gs^Fp       , Gs^Fp       , Ss          , Ww          , Ss          , Re          , Gg^Vh       , Re          , Gs          , Re          , Re          , Ww          , Ww          , Gs          , Gs          , Gs          , Gs          , Rr          , Gs          , Re          , Re          , Gs          , Gs^Fp       , Gs^Fp       , Mm          , Mm          , Mm          , Mm          , Gs          , Mm          
Mm          , Mm          , Mm          , Hh          , Hh          , Hh          , Hh          , Gs          , Gs          , Gs^Fp       , Re          , Ww^Bw/      , Ww          , Re          , Ss          , Re          , Ss          , Re          , Ww^Bw\      , Gs          , Rr          , Gs          , Rr          , Rr          , Gs          , Re          , Gs          , Gs^Fp       , Gs^Fp       , Gs^Fp       , Gs^Fp       , Mm          , Mm          , Mm          , Mm          , Mm          , Mm          
Mm          , Mm          , Mm          , Mm          , Mm          , Hh          , Hh          , Hh          , Re          , Re          , Hh          , Gg^Vh       , Ss          , Ss          , Ss          , Ss          , Ss          , Ww          , Gs          , Rr          , Gg^Vh       , Rr          , Gs          , Gs          , Gs          , Gs          , Gs^Fp       , Gs^Fp       , Mm          , Gs^Fp       , Mm          , Gs^Fp       , Mm          , Mm          , Mm          , Mm          , Mm          
Mm          , Mm          , Mm          , Mm          , Ce          , Hh          , Hh          , Re          , Gs          , Hh          , Hh          , Ww          , Ww          , Ww          , Ss          , Ss          , Ss          , Ss          , Gs^Fp       , Hh          , Hh          , Gs          , Mm          , Mm          , Mm          , Gs          , Mm          , Mm          , Mm          , Mm          , Mm          , Mm          , Mm          , Mm          , Mm          , Mm          , Mm          
Mm          , Mm          , Mm          , Mm          , 2 Ke        , Ce          , Re          , Re          , Re          , Gg^Vh       , Hh          , Hh          , Hh          , Ww          , Gs          , Gs          , Mm          , Gs^Fp       , Gs^Fp       , Hh          , Hh          , Mm          , Mm          , Mm          , Mm          , Mm          , Mm          , Mm          , Mm          , Mm          , Mm          , Mm          , Mm          , Mm          , Mm          , Mm          , Mm          
Mm          , Mm          , Mm          , Ce          , Ce          , Re          , Hh          , Hh          , Hh          , Re          , Ch          , Mm          , Mm          , Hh          , Mm          , Gs          , Mm          , Gs^Fp       , Mm          , Mm          , Mm          , Mm          , Mm          , Mm          , Mm          , Mm          , Mm          , Mm          , Mm          , Mm          , Gs          , Mm          , Mm          , Mm          , Mm          , Mm          , Mm          
Mm          , Mm          , Mm          , Mm          , Mm          , Hh          , Mm          , Mm          , Ch          , Re          , Re          , Hh          , Mm          , Mm          , Mm          , Mm          , Mm          , Mm          , Mm          , Mm          , Mm          , Mm          , Mm          , Mm          , Mm          , Mm          , Mm          , Mm          , Mm          , Mm          , Mm          , Gg^Vh       , Mm          , Mm          , Mm          , Mm          , Mm          
Mm          , Mm          , Mm          , Mm          , Mm          , Mm          , Mm          , Mm          , Ch          , Re          , Re          , Hh          , Mm          , Mm          , Mm          , Mm          , Mm          , Mm          , Mm          , Mm          , Mm          , Mm          , Mm          , Mm          , Mm          , Mm          , Mm          , Mm          , Mm          , Mm          , Mm          , Mm          , Mm          , Mm          , Mm          , Mm          , Mm          
