Xu, Xu, Xu, Xu, Xu, Xu, Xu, Xu, Xu, Xu, Xu, Xu, Xu, Xu, Xu, Rb, Sm, Sm, Ss^Em, Ss^Em, Xu, Xu, Xu, Xu, Xu, Xu, Xu, Xu, Xu, Xu, Xu, Xu
Xu, Xu, Xu, Xu, Xu, Xu, Uh^Em, Xu, Xu, Xu, Xu, Xu, Xu, Xu, Ss^Vhs, Rb, Ss, Sm, Rb, Re^Em, Uu^Emf, Xu, Xu, Xu, Xu, Xu, Xu, Xu, Ur^Vu, Xu, Xu, Xu
Xu, Xu, Xu, Xu, Xu, Uh^Uf, Uu^Emf, Uu^Em, Rb, Xu, Uu, Xu, Xu, Xu, Ss, Ss, Sm, Sm, Sm, Rb, Uu, Uu^Uf, Xu, Xu, Xu, Xu, Xu, Xu, Ur^Es, Ur^Es, Xu, Xu
Xu, Xu, Xu, Xu, Uh^Dr, Uh^Uf, Ur, Ur^Es, Uh^Emf, Rb^Es, Uu, Xu, Xu, Rb, Sm, Ss, Ss, Ss, Rb, Re, Re, Xu, Xu, Xu, Xu, Xu, Xu, Xu, Uu, Re^Es, Xu, Xu
Xu, Xu, Xu, Xu, Xu, Uu^Em, Ur^Es, Uu^Em, Uh^Uf, Uh^Uf, Uu^Vud, Xu, Xu, Rb, Xu, Sm, Xu, Xu, Xu, Xu, Xu, Xu, Xu, Uh^Uf, Uh^Dr, Uh^Uf, Uu^Emf, Uu^Em, Uu^Em, Re, Xu, Xu
Xu, Xu, Xu, Xu, Xu, Cud, Uu^Br\, Ur^Es, Uu^Em, Xu, Xu, Xu, Xu, Xu, Xu, Xu, Xu, Xu, Xu, Xu, Xu, Xu, Xu, Xu, Ur^Es, Uh^Emf, Re^Em, Uu, Ur, Ur^Es, Xu, Xu
Xu, Xu, Xu, Xu, Xu, Xuc, Uu^Br|, Ur^Es, Re, Uu^Emf, Xu, Xu, Xu, Xu, Xu, Xu, Xu, Uh, Uu^Vu, Uh^Uf, Rb^Es, Xu, Xu, Ur^Es, Xu, Ur, Xu, Re, Ur^Es, Xu, Xu, Xu
Xu, Xu, Xu, Xuc, Xu, Xuc, Re^Es, Uu, Re^Em, Uu^Em, Xuc, Xu, Xu, Xu, Xu, Xu, Xu, Uu^Emf, Ur^Es, Uu, Rb^Es, Xu, Xu, Uu^Vud, Xu, Xu, Xu, Xu, Re, Xu, Xu, Xu
Xu, Xu, Xuc, Xuc, Xuc, Re^Es, Uu^Br|, Ur, Uh^Em, Uh^Uf, Xuc, Xu, Xu, Xu, Xu, Xu, Xu, Uu, Uu, Ur, Xu, Xu, Xu, Xu, Xu, Uh^Uf, Uh^Emf, Uu^Uf, Re^Es, Xu, Xu, Xu
Xu, Xuc, Uu^Vud, Xuc, Xuc, Re, Uu^Br|, Ur, Uh^Vu, Xuc, Xu, Xu, Xu, Xu, Xu, Xu, Xu, Xu, Xu, Xu, Xu, Xu, Xu, Xu, Xu, Xu, Uh^Em, Re, Uu^Em, Uh^Uf, Xu, Xu
Xu, Xuc, Cud, Uue^Edb, Uue^Br/, Uu^Br/, Uu^Es, Uu^Es, Xuc, Xu, Xu, Xu, Xu, Xu, Xu, Xu, Xu, Xu, Xu, Xu, Rb^Es, Xu, Uu^Em, Xu, Xu, Xu, Uu^Es, Rb^Es, Uu^Em, Uh^Dr, Xu, Xu
Xu, Xuc, Xuc, Uue^Br/, Uue^Dr, Uue^Br\, Uu^Br\, Cud, Xuc, Xu, Xu, Xu, Xu, Xu, Uh^Em, Xu, Ur^Es, Xu, Xu, Xu, Xu, Re, Re^Es, Rb^Es, Xu, Xu, Xu, Uu, Uu^Uf, Uu^Emf, Xu, Xu
Xu, Xu, Xuc, Xuc, Ur^Edb, Uue^Br|, Ur, Xuc, Xuc, Xu, Xu, Xu, Xu, Uh^Uf, Uu^Em, Rb^Es, Re^Vct, Ur^Es, Uu, Xu, Uu, Ur, Uu, Xu, Xu, Xu, Xu, Uu^Em, Xu, Xu, Xu, Xu
Xu, Xu, Uue^Br\, Ur, Uue^Edb, Uue^Br|, Uue^Edb, Ur, Uh^Ii, Xu, Xu, Xu, Uu^Uf, Uh^Emf, Rb^Es, Re, Re^Es, 1 Ur, Ur^Es, Ur^Es, Ur, Ur^Es, Uu^Es, Xu, Xu, Xu, Xu, Xu, Xu, Xu, Xu, Xu
Xu, Xu, Ur^Ii, Uue^Br\, Xuc, Xuc, Xuc, Ur^Edb, Uue^Br/, Xu, Xu, Xu, Uu^Em, Rb^Es, Re, Uu^Uf, Xu, Uu, Xu, Xu, Xu, Re^Em, Re, Uu^Dr, Xu, Xu, Xu, Xu, Xu, Xu, Xu, Xu
Xu, Xu, Uue^Vud, Ur^Edb, Uue^Dr, Xuc, Uue^Br\, Uue^Br/, Uue^Dr, Ur, Xuc, Xu, Xu, Uu, Re^Es, Uu^Dr, Xu, Xu, Xu, Xu, Xu, Uu^Emf, Re^Em, Uu^Es, Xu, Xu, Xu, Uu^Vu, Uh^Em, Xu, Xu, Xu
Xu, Xu, Xu, Uue^Br/, Cud, Uue^Ii, Ur^Br|, Uue^Edb, Ur^Edb, Ur^Br\, Xuc, Xu, Xu, Xu, Uu, Re^Es, Xu, Xu, Xu, Xu, Xu, Uu^Uf, Uu^Em, Ur, Rb^Es, Uu^Em, Uu^Emf, Uu^Uf, Xu, Xu, Xu, Xu
Xu, Xu, Xu, Cud^Dr, Kud, Ur, Uu^Em, Ur, Uu^Em, Xuc, Xuc, Xu, Xu, Xu, Uu^Edb, Re^Es, Xu, Xu, Xu, Xu, Xu, Xu, Rb^Dr, Ur, Uu, Rb^Es, Uu^Em, Xu, Xu, Xu, Xu, Xu
Xu, Xu, Xu, Xu, Xu, Cud, Uh^Ufi, Uu^Emf, Uu^Uf, Uh^Ii, Xu, Xu, Xu, Uu, Re^Edb, Xu, Xu, Xu, Xu, Xu, Xu, Xu, Xu, Ur, Uu^Vu, Uu^Em, Uu^Emf, Uh^Uf, Xu, Xu, Xu, Xu
Xu, Xu, Xu, Xu, Xu, Xu, Uh^Vud, Uh^Uf, Xu, Xu, Xu, Xu, Xu, Uu^Edb, Re^Edb, Re^Edb, Xu, Xu, Xu, Xu, Xu, Xu, Xu, Xu, Xu, Xu, Xu, Xu, Xu, Xu, Xu, Xu
Xu, Xu, Xu, Xu, Xu, Xu, Xu, Xu, Xu, Xu, Xu, Xu, Xu, Xu, Xu, Aa^Edb, Aa, Xu, Xu, Xu, Xu, Xu, Xu, Xu, Xu, Xu, Xu, Xu, Xu, Xu, Xu, Xu
Xu, Xu, Xu, Xu, Xu, Xu, Xu, Xu, Xu, Xu, Xu, Xu, Xu, Xu, Xu, Aa, Aa, Xu, Xu, Xu, Xu, Xu, Xu, Xu, Xu, Xu, Xu, Xu, Xu, Xu, Xu, Xu
