Xu, Xuc, Xuc, Xuc, Xuc, Xuc, Xuc, Xuc, Xu, Xu, Xu, Xu, Xu, Xu, Xu, Xu, Xu, Xu, Xu, Xu, Xu, Xu, Xu, Xu, Xu, Xu, Xu, Xu, Xu, Xu, Xu, Xu
Xu, Xuc, Xu, Xu, Xue, Xue, Xue, Xuc, Xu, Xu, Mm, Xu, Uu^Emf, Xos, Xos, Xu, Uh^Emf, Xu, Xu, Xu, Xu, Xu, Xu, Xu, Xu, Xu, Xu, Xu, Xu, Xu, Xu, Xu
Xue, Xue, Uh, Uh^Tf, Uue^Edb, Ur^Edb, Ur^Edb, Xue, Rb^Em, Uh^Tf, Uu, Uu, Uu, Rb^Es, Re, Uu^Em, Uu^Em, Uh^Tf, Xu, Xu, Xu, Xu, Xu, Xu, Xu, Xu, Xu, Xu, Xu, Xu, Xu, Xu
Xue, Uue^Eb, Uue^Dr, Uue^Emf, Xu, Uue^Edb, Ur^Edb, Uh, Ur^Edb, Ur^Edb, Ur^Edb, Ur^Edb, Ur^Es, Re, Ur^Es, Uu^Em, Uh^Em, Xu, Xu, Xu, Xu, Xu, Xu, Xu, Xu, Xu, Xu, Xu, Xu, Ss^Emf, Ss^Em, Sm
Xue, Xue, Ur^Edb, Xu, Xu, Xu, Uue^Edb, Uue^Edb, Uu, Ur^Edb, Uu^Vo, Re, Xue, Ur^Es, Xu, Ur^Es, Xu, Xu, Xu, Xu, Xu, Xu, Xu, Uh^Tf, Ss^Em, Ss^Tf, Sm, Ss^Edb, Sm, Ss^Em, Sm^Tf, Sm
Xue, Uh^Vo, Uue^Edb, Uue^Dr, Uue^Edb, Uue^Edb, Uue^Edb, Uue^Dr, Uh^Eb, Xue, Xu, Xu, Xuc, Xu, Xu, Xu, Xu, Xu, Xu, Xu, Xu, Xu, Rb^Emf, Rb^Tf, Sm^Emf, Rb^Emf, Sm, Sm^Edb, Sm^Edb, Ss^Edb, Ss^Emf, Sm
Xu, Xue, Cer^Edb, Cer^Edb, Ur, Uue^Edb, Uue^Edb, Ur^Edb, Xue, Xue, Xu, Xu, Xu, Xu, Xu, Xu, Ur^Es, Ur^Es, Uu^Vu, Uh^Tf, Rb^Es, Xu, Xu, Rb^Fp, Sm^Em, Ss^Edb, Sm^Edb, Sm^Edb, Ss^Tf, Sm, Xu, Xu
Xu, Xu, Xu, Ko, Cer^Dr, Uu^Edb, Uu^Emf, Uu^Emf, Uh^Tf, Xue, Xuc, Xu, Xu, Xu, Xu, Xu, Xu, Uu^Emf, Ur^Es, Uu, Rb^Es, Xu, Xu, Uu^Vud, Xu, Ss^Edb, Ss^Em, Ss^Em, Sm, Ss^Em, Ss^Emf, Ss^Edb
Xu, Xu, Xuc, Xu, Rb^Edb, Uh^Tf, Uh^Vo, Xu, Xu, Xu, Xuc, Xu, Xu, Xu, Xu, Xu, Xu, Uh, Uu, Ur, Xu, Xu, Xu, Xu, Xu, Uh^Tf, Uh^Emf, Uu^Tf, Sm, Xu, Ss^Em, Ss^Em
Xu, Xuc, Xu, Uu^Eb, Rb^Es, Rb^Es, Uu^Es, Xu, Uh^Vu, Xuc, Xu, Xu, Xu, Xu, Xu, Xu, Xu, Xu, Xu, Xu, Xu, Xu, Xu, Xu, Xu, Xu, Uh^Em, Sm^Em, Uu^Em, Uh^Tf, Xu, Xu
Xu, Xuc, Xu, Uh^Em, Xu, Rb^Es, Uu^Edb, Uu^Edb, Xu, Xu, Xu, Xu, Xu, Xu, Xu, Xu, Xu, Xu, Xu, Xu, Rb^Es, Xu, Uu^Em, Xu, Xu, Xu, Uu^Es, Rb^Es, Sm, Ss^Em, Xu, Xu
Xu, Xuc, Xu, Xu, Xu, Wwg^Ii, Xu, Uu^Edb, Xu, Xu, Xu, Xu, Xu, Xu, Uh^Em, Xu, Ur^Es, Xu, Uu, Xu, Uu, Re, Re^Es, Rb^Es, Xu, Xu, Xu, Uu, Uu^Tf, Ss^Vhs, Xu, Xu
Xu, Xu, Xuc, Xu, Xu, Wwg^Ii, Wwg^Ii, Xu, Xuc, Xu, Xu, Xu, Xu, Uh^Tf, Uu^Em, Rb^Es, Re^Vct, Ur^Es, Uu, Uu, Uu, Ur, Uu, Uu, Xu, Xu, Xu, Uu^Em, Xu, Xu, Xu, Xu
Xu, Xu, Xoi, Xoi, Wog, Wog^Xo, Wog^Xo, Xoi, Xoi, Xu, Xu, Xu, Uu^Tf, Uh^Emf, Rb^Es, Re, Re^Es, 1 Uu, Ur^Es, Ur^Es, Ke, Ur^Es, Uu^Es, Xu, Xu, Xu, Xu, Xu, Xu, Xu, Xu, Xu
Xoi, Xoi, Wog, Wog, Wog, Wog, Wog, Wog, Wog, Xoi, Xu, Xu, Uu^Em, Rb^Es, Re, Uu^Tf, Xu, Uu, Uu, Ce, Ce, Re^Em, Re, Uu^Dr, Xu, Xu, Xu, Xu, Xu, Xu, Xu, Xu
Xu, Xoi, Wog, Wog, Urb, Wog, Wog, Wog, Wog, Xoi, Xuc, Xu, Xu, Uu, Re^Es, Uu^Dr, Xu, Xu, Xu, Uu, Uu, Uu^Emf, Re^Em, Uu^Es, Xu, Xu, Xu, Uu^Vu, Uh^Em, Xu, Xu, Xu
Xu, Xoi, Wog, Wog, Wog, Urb^Ii, Wog, Wog, Wog, Xoi, Xuc, Xu, Xu, Xu, Uu, Re^Es, Xu, Xu, Xu, Uu, Xu, Uu^Tf, Uu^Em, Ur, Rb^Es, Uu^Em, Uu^Emf, Uu^Tf, Xu, Xu, Xu, Xu
Xu, Xoi, Wog, Wog, Wog, Wog, Wog, Wog, Wog, Xoi, Xuc, Xu, Xu, Xu, Uu^Edb, Re^Es, Xu, Xu, Xu, Xu, Xu, Xu, Rb^Dr, Ur, Uu, Rb^Es, Uu^Em, Xu, Xu, Xu, Xu, Xu
Xu, Xoi, Xoi, Wog, Wog, Wog, Wog, Wog, Xoi, Xoi, Xu, Xu, Xu, Uu, Re^Edb, Xu, Xu, Xu, Xu, Xu, Xu, Xu, Xu, Ur, Uu^Vu, Uu^Em, Uu^Emf, Uh^Tf, Xu, Xu, Xu, Xu
Xu, Xu, Xu, Xoi, Xoi, Wog, Xoi, Xoi, Xu, Xu, Xu, Xu, Xu, Uu^Edb, Re^Edb, Re^Edb, Xu, Xu, Xu, Xu, Xu, Xu, Xu, Xu, Xu, Xu, Xu, Xu, Xu, Xu, Xu, Xu
Xu, Xu, Xu, Xu, Xu, Xoi, Xu, Xu, Xu, Xu, Xu, Xu, Xu, Xu, Xu, Aa^Edb, Aa, Xu, Xu, Xu, Xu, Xu, Xu, Xu, Xu, Xu, Xu, Xu, Xu, Xu, Xu, Xu
Xu, Xu, Xu, Xu, Xu, Xu, Xu, Xu, Xu, Xu, Xu, Xu, Xu, Xu, Xu, Aa, Aa, Xu, Xu, Xu, Xu, Xu, Xu, Xu, Xu, Xu, Xu, Xu, Xu, Xu, Xu, Xu
