Mm^Xm, Gg, Mm^Xm, Gg, Mm^Xm, Mm, Mm^Xm, Mm, Mm, Mm, Hh^Fdw, Hh, Mm, Hh, Hh^Fdw, Hh, Re^Es, Mm, Mm, Mm, Mm, Hh, Hh^Fdw, Gg^Fdw, Gll^Fmw, Gg, Gll^Fdw, Gd, Gd^Edpp, Re, Hh, Hh, Gd^Edpp, Hh
Mm, Mm, Mm, Mm^Xm, Mm^Xm, Mm^Xm, Mm, Mm, Hh^Es, Mm, Hh^Fmw, Mm, Hh^Em, Mm, Re^Gvs, Hh, Re, Mm, Hh^Fdw, Mm, Hh^Em, Hh, Gll^Em, Hh^Em, Gll^Fmw, Gll^Fp, Hh^Fdw, Gd^Em, Hh, Re^Es, Gd^Es, Gd, Hh, Hh
Mm, Mm^Xm, Mm^Xm, Mm^Xm, Mm^Xm, Mm^Xm, Mm, Hh^Fdw, Hh^Fmw, Hh^Em, Hh^Fp, Hh^Fmw, Mm, Re^Gvs, Hh^Vhh, Hh^Fdw, Mm, Re, Re^Em, Hh^Fdw, Mm, Mm, Hh^Fdw, Gll^Fp, Gll^Emf, Hh^Fmw, Hh^Em, Gd^Edpp, Re, Re^Es, Gd^Edp, Gd^Edp, Hh^Fdw, Mm
Wo, Mm, Mm, Mm^Xm, Mm^Xm, Mm^Xm, Mm, Hh^Fdw, Mm, Hh^Fp, Mm, Mm, Mm, Mm, Re^Gvs, Mm, Hh^Fdw, Mm, Re^Es, Re, Re^Es, Mm, Re, Hh^Em, Hh^Vhh, Gll^Fdw, Hh^Em, Gs^Es, Re, Hh, Hh, Hh, Hh, Mm
Wo, Wo, Mm, Mm, Mm, Mm^Xm, Mm, Mm, Hh^Es, Hh^Fp, Mm, Hh^Em, Hh^Fdw, Mm, Mm, Mm, Mm, Hh^Fp, Mm, Mm, Mm, Re^Es, Mm, Re, Re^Es, Re^Es, Re, Hh^Fdw, Re, Re^Es, 2 Hh^Fdw, Hh^Fdw, Mm, Mm
Mm, Wo, Wwrg, Mm, Mm, Mm, Mm, Mm, Hh^Fmw, Hh^Fmw, Hh^Em, Hh, Gd, Mm, Mm, Hh, Mm, Mm, Mm, Mm, Hh^Fdw, Mm, Mm, Hh, Mm, Gs^Efm, Re, Re, Re, Re, Re^Es, Hh^Fmw, Hh, Hh
Wo, Wo, Wwrg, Mm, Mm, Mm, Mm, Mm, Hh, Gll^Fdw, Hh^Fmw, Hh^Fp, Gll^Fmw, Hh^Es, Hh^Es, Mm, Hh^Fdw, Hh, Mm, Mm, Hh^Fmw, Mm, Mm, Mm, Mm, Hh, Hh^Es, Re^Es, Re, Re, Hh, Mm, Mm, Mm
Wwrg, Wo, Wo, Mm, Wwg^Ewl, Mm, Mm, Mm, Ss^Emf, Gll^Fdw, Gll^Fdw, Hh^Fp, Mm, Hh^Edb, Re^Edb, Gd^Edpp, Mm, Mm, Mm, Mm, Mm, Mm, Mm, Mm, Gll^Fdw, Hh, Re^Es, Re^Es, Hh, Gs^Efm, Hh^Fmw, Mm, Hh^Em, Mm
Wwrg, Wo, Wo, Wo, Wwrg, Mm, Mm, Hh, Ss^Em, Ss^Em, Gll^Fmw, Hh, Mm, Hh^Edb, Hh^Es, Hh^Edpp, Hh^Vhhr, Gs^Em, Hh^Fmw, Mm, 1 Ke, Ce, Hh^Fmw, Re^Vct, Gll^Em, Re, Gd^Edpp, Gd, Hh^Fmw, Hh^Fmw, Gs^Fms, Hh^Vhh, Hh^Fds, Hh^Es
Wwrg, Wwrg, Wo, Wwg^Ewl, Wwg^Ewl, Mm, Hh, Mm, Sm^Em, Sm^Edb, Sm^Em, Mm, Hh^Edb, Hh^Edb, Re, Re^Es, Re^Es, Gll^Fdw, Hh^Fmw, Hh^Em, Ce, Ce, Re, Re, Re, Re^Es, Re, Gd^Es, Gs^Em, Gs^Fp, Hh^Fms, Gs^Fds, Gs^Fds, Mm
Mm, Wo, Wo, Wo, Wog, Mm, Mm, Ss^Emf, Ss^Em, Rb, Sm^Edb, Gll^Fmw, Gll^Em, Hh^Es, Gd^Vc, Gd^Edb, Gll^Fmw, Re, Re^Vct, Hh^Fp, Gll^Fp, Re^Es, Re^Es, Wwf, Wwg^Ewl, Wwg^Ewl, Re, Gd^Edpp, Hh^Fmw, Gs^Fp, Hh^Fp, Hh^Fms, Gs^Efm, Gs^Fms
Mm, Wo, Wwrg, Wog, Wog, Wwg^Ewl, Sm, Sm^Em, Ss, Ss, Wwg^Edb, Sm, Wwg, Wwg^Edb, Wwg, Gll^Fp, Gll^Fdw, Re, Re^Es, Hh^Fmw, Re, Re, Wwf^Es, Wwf, Re^Es, Wwf, Re^Es, Re, Gs, Gs^Em, Gg^Em, Gs^Fp, Hh, Gg^Em
Mm, Mm, Wwg, Wwrg, Wog, Wog, Wog, Sm, Sm, Wwg, Wwg^Ewl, Wwg, Wo, Wwg, Wwg, Wwg, Wwg^Edb, Gll^Fdw, Cer^Edb, Re^Es, Gd^Edpp, Gd, Wwg, Wwf, Wwf, Wwf, Wwf, Wwf^Es, Wwf, Gg^Efm, Wwg^Ewl, Hh^Fp, Wwg^Ewl, Wwg
Mm, Mm, Mm, Wwg^Es, Wwg^Es, Wog, Wog, Wog, Wog, Wog, Wwrg, Wwrg, Wo, Wo, Wo, Wo, Wo^Edb, Cer^Edb, Wo^Edb, Wwg, Wo, Wwg^Ewl, Wo, Wwg, Wwrg, Wwf^Es, Wwf, Wwf, Wwg, Wwg^Ewl, Wwg^Ewl, Wwg, Wo, Wo
Mm, Mm, Hh, Wwg^Ewl, Wwg^Ewl, Wwg, Wwg^Bw/, Wog, Wog, Wo, Wo, Wo, Wo, Wo, Wo, Wo, Wo, Wo^Edb, Wo, Wo, Wo, Wo, Wwg, Wwrg, Wwrg, Wwf, Wwg, Wwf, Wwf^Ewl, Wwrg, Wo, Wo, Wo, Wo
Mm, Mm, Hh^Fmw, Hh, Re^Es, Re, Gs^Fms, Wwg, Wwrg, Wo, Wo, Wo, Wwg, Wwrg, Wwg, Wo, Wwrg, Wo, Wwrg, Wo, Wo, Wo, Wwrg, Wwg, Wwf, Wwg, Wwf^Es, Wwf, Wwrg, Wwg, Wwg, Wo, Wwrg, Wo
Mm, Hh^Fp, Hh^Em, Gs^Fdw, Re^Gvs, Re^Wm, Gs, Wwg, Wwg, Wwrg, Wwg, Wwg, Gs, Wwg, Re, Wwg, Wwg, Wwrg, Wwrg, Wo, Wo, Wo, Wwg, Wwg, Wwf^Es, Wwg, Wwf, Wwf, Wwg, Wwg, Wwg^Ewf, Wwrg, Re^Es, Wwg
Hh^Fmw, Hh^Fmw, Gs^Fdw, Gs^Es, Re^Gvs, Re^Gvs, Re^Es, Gg, Wwg^Ewl, Wwg^Ewf, Wwg, Re^Es, Re^Gvs, Gs^Efm, Re^Vc, Re^Es, Gg, Wwg, Wo, Wo, Wo, Wo, Wwg, Wwf^Ewf, Wwf, Wwf, Wwf^Efm, Wwf, Ce, Wwf, Wwg^Ewl, Wwg, Wwg, Re^Es
Hh^Em, Gs^Fmw, Gs, Re^Gvs, Re^Gvs, Re^Gvs, Re^Es, Gg^Efm, Gs, Wwg^Ewf, Gs, Wwg^Ewl, Re^Gvs, Re^Gvs, Re^Eff, Gs^Es, Wwg^Ewl, Wwg^Ewl, Wwg, Wwg, Wwg, Wwg, Ce, 3 Ket, Re, Gs^Fdw, Gs^Efm, Gs^Es, Re^Es, Re, Gs^Fdw, Gs^Efm, Wwg^Ewl, Wwg
Hh^Fp, Hh, Gg^Efm, Re^Es, Gs, Gs, Rr, Ch, Ch, Gg^Efm, Gs, Gs, Gs, Re^Eff, Gs, Gs, Gs^Fms, Gs, Gs, Wwg^Ewl, Gs^Efm, Gd, Gd, Ce, Re, Gs^Fdw, Re^Es, Re^Es, Re, Gg^Fmw, Gg^Fmw, Gs^Fmw, Gs^Fp, Gg^Efm
Gs^Fmw, Gs^Fp, Gs^Fp, Re, Re, Rr, Rr^Vhc, Rr, Re, Ch, Ch, Gs^Es, Gs, Re, Re, Gs^Eff, Gs^Eff, Gs^Fp, Gs^Efm, Gs^Es, Gs, Gs, Gs, Gs, Re^Es, Re, Re, Re, Gs^Fdw, Gg^Efm, Gs^Fmw, Gs^Fdw, Gs^Em, Gs^Fp
Gs^Fdw, Gs^Fp, Ww^Ewf, Gg^Fet, Ww^Ewf, Re, Rr^Es, Rr, Gs, Re^Es, Gs, Re^Es, Re, Gs^Efm, Re, Re^Es, Re, Gg, Re^Es, Re, Re, Gs^Es, Re^Es, Gs^Efm, Re, Re, Gs^Vh, Re, Re, Gg^Fmw, Gs^Fdw, Gs^Fms, Gs^Fms, Gs^Fds
Gs^Em, Gs^Fdw, Ww, Ww, Rr, Rr, Rr, Gs^Efm, Gs, Gs^Vh, Re^Es, Re, Ch, Re, Gg^Efm, Gs, Gs, Re, Gd, Re, Re^Eff, Re^Eff, Re^Eff, Re^Eff, Gd^Eff, Gd, Gs, Gg^Es, Re^Es, Gs^Fp, Gs^Fms, Gs^Fms, Gs^Fds, Gs^Fds
Gs, Re^Wm, Re^Es, Re, Re^Es, Ch, Ch, Re, Re, Re, Rr^Es, Re, Ch, Gs, Gs^Fp, Ce, Gs^Fms, Gd^Fmw, Rb^Eff, Re^Eff, Rb^Es, Re, Re^Gvs, Gd^Gvs, Gd^Gvs, Gd^Eff, Re^Eff, Gs, Gs^Fmw, Re, Re, Gll^Fp, Re^Es, Gll^Fp
Gs, Re^Gvs, Re^Gvs, Re, Rr, 4 Kh, Ch, Rr, Re^Es, Rr, Rr^Vhc, Rr^Es, Ch, Gs^Es, Gs^Fmw, Gs^Fp, Gs^Fmw, Re^Eff, Rb^Eff, Rb^Es, Rb, Rb^Es, Re^Gvs, Re^Gvs, Re^Gvs, Re^Gvs, Gd^Gvs, Re^Eff, Re, Re^Es, Gs^Fdw, Re, Gll^Fp, Re^Es
Re^Gvs, Re^Gvs, Re^Gvs, Re, Re^Eff, Rr^Es, Gg, Re, Gs^Em, Re, Rr, Rr, Ch, Gs^Em, Gs^Em, Gs^Fms, Re^Eff, Re^Eff, Re^Gvs, Rb, Rb^Es, Re^Gvs, Re^Wm, Re^Gvs, Re^Gvs, Re^Gvs, Gd^Es, Gs^Vc, Re^Es, Re, Gg^Fmw, Gs^Fp, Gs^Em, Gs
Re^Gvs, Re^Gvs, Re^Gvs, Re^Gvs, Re^Eff, Re^Eff, Gs^Fp, Gg^Efm, Gs^Fmw, Re, Rr^Es, Re^Es, Re^Em, Gs^Fmw, Gs^Fmw, Gs, Gd^Vh, Gd^Gvs, Re^Gvs, Rb^Gvs, Re^Gvs, Re^Gvs, Re^Gvs, Re^Gvs, Re^Gvs, Gd, Gd^Es, Gd, Gs^Es, Gs^Eff, Gs^Eff, Gll^Fp, Gll^Emf, Gll^Fp
Gg, Gs, Gs, Re^Eff, Gs^Fmw, Gs^Fmw, Gs^Fp, Gs^Em, Gs^Fms, Gs^Fp, Re, Gs, Gs^Fp, Gs^Fp, Gs^Fp, Gs, Gs, Gd^Gvs, Re^Gvs, Re^Gvs, Re^Gvs, Re^Gvs, Re^Gvs, Re^Gvs, Re^Gvs, Gd, Re^Gvs, Gd, Gs, Gs^Eff, Gll^Fp, Gll^Fp, Gll^Fp, Gll^Fp
