Isr, Xos, Xos^Efs, Xos, Xos, Xos, Xos, Xos, Xos, Xos, Xos^Efs, Xos, Xos, Xos, Xos, Xos, Xos^Efs, Xos, Xos, Xos, Xos, Xos, Xos, Xos, Xos, Xos, Xos, Xos, Xos
Xos, Isr, Iwr, Xos^Efs, Xos, Xos, Xos^Efs, Xos^Efs, Iwc^Ebn, Xos, Xos, Xos^Efs, Xos, Xos, Xos^Efs, Xos^Efs, Iwc, Iwc, Iwc, Xos, Xos, Xos, Xos^Efs, Xos^Efs, Iwc, Xos, Xos, Xos, Xos
Xos, Xos, Iwr, Iwr, Xos, Xos, Iwc^Eb, Iwc, Iwr, Iwc, Iwc^Eb, Xos, Xos, Xos^Efs, Iwc, Iwr, Iwr, Iwc, Xos, Xos, Xos^Efs, Xos, Xos^Efs, Iwr, Iwr, Iwc, Xos, Xos, Xos
Xos, Iwr, Iwr, Xos^Efs, Xos^Efs, Xos, Xos, Iwr, Iwr, Iwr, Xos, Xos, Xos^Efs, Iwc, Iwr, Iwr, Iwr, Iwr, Xos, Xos^Efs, Isr, Isc, Isc, Iwr^Pr\, Xos, Xos, Xos, Xos, Xos
Xos, Xos, Xos, Iwr, Iwr, Xos, Xos, Xos, Xos, Iwr^Pr/, Isc, Xos^Efs, Xos^Efs, Xos^Efs, Xos^Efs, Xos^Efs, Xos, Iwr^Pr/, Isc, Isr, Isr, Isr, Xos, Xos, Xos^Efs, Xos^Efs, Iwr, Xos, Xos
Xos, Xos, Xos, Xos, Xos, Iwr, Xos, Xos, Xos, Xos, Xos, Isc, Isc, Xos, Xos^Efs, Xos, Isr, Isc, Isr, Isr^Ebn, Xos, Isr^Pr/, Iwr, Xos, Iwr, Iwo, Iwr, Iwr, Xos
Xos, Xos, Xos, Xos, Xos, Xos, Xos, Xos, Xos^Efs, Xos, Xos^Efs, Xos, Xos, Isr, Isr, Isr, Isr^Ebn, Isr, Isr, Xos, Xos, Xos, Xos, Iwr, Iwo, Iwo, Iwo, Iwo, Xos
Xos, Xos, Xos, Xos, Xos, Xos, Xos, Xos^Efs, Urc, Urc, Iwr, Xos^Efs, Xos, Xos, Xos, Xos, Xos, Isr, Isr, Xos, Xos, Xos, Xos, Xos, Iwo^Pr\, Iwo, Xos, Xos, Xos
Xos, Xos, Xos^Efs, Xos, Xos^Efs, Xos, Iwr, Iwr, Iwr, Iwr, Iwr, Iwr, Iwr^Pr/, Xos, Xos, Xos, Xos, Isr, Isr^Ebn, Xos, Xos, Xos, Xos^Efs, Iwo, Iwr, Xos, Xos, Xos, Xos
Xos^Efs, Xos^Efs, Iwc, Iwc^Eb, Iwr, Xos, Iwr^Pr\, Iwr, Urc, Urc, Xos, Xos, Xos, Isr, Isr, Xos^Efs, Isr, Isr, Xos, Xos, Xos, Xos^Efs, Iwr, Iwo, Iwo, Iwr, Iwo^Eb, Xos, Xos
Xos, Iwc^Ebn, Iwr, Iwr, Iwr, Iwr, Xos, Xos, Xos, Xos, Xos, Xos, Xos, Xos, Isr, Isr, Xos, Xos, Xos, Xos, Iwr, Iwr, Iwr, Iwo, Iwo, Iwo, Xos, Xos, Xos
Xos, Iwc, Iwc^Eb, Iwr, Xos, Xos, Xos, Xos, Xos, Xos, Xos^Efs, Xos^Efs, Isr, Isr^Pr\, Xos, Xos, Xos, Xos, Xos, Iwr^Eb, Iwr, Iwr, Urc, Iwo, Xos, Xos, Xos, Xos, Xos
Xos, Xos, Xos, Xos, Xos, Xos, Xos, Xos, Xos, Xos^Efs, Isr, Isr, Isr, Isr, Isr, Xos, Xos^Efs, Xos, Isr, Iwr^Pr\, Xos, Urc, Xos, Xos, Xos, Xos, Xos, Xos, Xos
Xos, Xos, Xos, Xos, Xos, Xos, Xos, Xos, Xos, Isr, Isr, Isr, Isr, Isr, Isr, Isr, Isr, Isr, Xos, Xos, Xos, Xos, Xos, Xos, Xos, Xos, Xos, Xos, Xos
Xos, Xos, Xos, Xos, Iwr^Eb, Xos, Xos^Efs, Xos, Iwr, Isr^Pr\, Xos, Isr, Isr^Ebn, Isr, Isr, Isr, Isr, Isr, Xos^Efs, Xos, Xos, Xos, Xos, Xos, Xos, Xos, Xos, Xos, Xos
Xos, Xos, Xos, Iwr, Iwr, Urc, Urc, Urc, Iwr, Xos, Xos, Xos, Xos, Isr, Isr, Isr, Isr, Isc, Isc, Xos^Efs, Xos, Xos, Xos, Xos, Xos, Xos, Xos, Xos, Xos
Xos, Xos, Xos, Xos, Xos, Iwr, Iwr, Iwr, Xos, Xos, Xos, Xos, Xos, Xos, Xos, Isc, Isc, 1 Isr, Isr, Isc, Isc, Xos^Efs, Xos^Efs, Xos, Xos, Xos, Xos, Xos, Xos
Xos, Xos, Xos, Xos, Xos, Xos, Xos, Xos, Xos, Xos, Xos, Xos, Xos, Xos, Xos, Xos, Xos, Isc, Isc, Isr, Isr, Isc, Isc, Xos, Xos, Xos, Xos, Xos, Xos
Xos, Xos, Xos, Xos, Xos, Xos, Xos, Xos, Xos, Xos, Xos, Xos, Xos, Xos, Xos, Xos, Xos, Xos, Xos, Isc, Isc, Isr, Rrc, Rrc, Rrc, Xos, Xos, Xos, Xos
Xos, Xos, Xos, Xos, Xos, Xos, Xos, Xos, Xos, Xos, Xos, Xos, Xos, Xos, Xos, Xos, Xos, Xos, Xos, Xos, Xos, Rrc, Rrc, Rrc, Rrc, Rrc, Rrc, Xos, Xos
Xos, Xos, Xos, Xos, Xos, Xos, Xos, Xos, Xos, Xos, Xos, Xos, Xos, Xos, Xos, Xos, Xos, Xos, Xos, Xos, Xos, Rrc, Rrc, Rrc, Rrc, Rrc, Rrc, Rrc, Xos
Xos, Xos, Xos, Xos, Xos, Xos, Xos, Xos, Xos, Xos, Xos, Xos, Xos, Xos, Xos, Xos, Xos, Xos, Xos, Xos, Xos, Rrc, Rrc, Rrc, Rrc, Rrc, Rrc, Rrc, Xos
