Xu, Xu, Xu, Xu, Xu, Xu, Xu, Xu, Xu, Xu, Xu, Xu, Xu, Xu, Xu, Xu, Xos, Xos, Xos, Xos, Xos, Xos, Xos, Xos, Xos, Xos, Xu, Xu, Xu, Xu, Ur^Es, Ur, Xu, Xu, Xu, Xu, Xos
Xu, Xu, Xu, Xu, Xu, Xu, Xu, Xu, Xu, Xu, Xu, Xu, Uh^Tf, Xu, Uh^Tf, Xu, Xos, Xos, Xos, Xos, Xos, Xos, Uh^Tf, Xos, Xos, Xos, Xu, Xu, Xu, Xu, Uu^Em, Ur^Es, Xu, Xu, Xu, Xu, Xu
Xu, Xu, Xu, Xu, Xu, Xu, Xu, Xu, Xu, Xu, Xu, Xu, Uh^Tf, Uh^Emf, Uh^Em, Xu, Xos, Xos, Urb^Eb, Xos, Xos, Uh^Emf, Uh^Em, Uu^Emf, Uh^Tf, Xom, Xos, Xu, Xu, Uh^Tf, Uh^Emf, Ur, Ur^Es, Xu, Xuc, Xu, Xu
Xu, Xu, Xu, Xu, Xu, Xu, Xu, Xu, Xu, Xu, Xu, Uh^Tf, Uu^Emf, Uu^Ii, Uu^Em, Xos^Efs, Ur, Ur^Es, Urb, Urb, Ur^Es, Xos^Efs, Ur^Es, Uu^Em, Xom, Xom, Xos, Xos, Xom, Xuc, Xuc, Xuc, Xuc, Ur, Uu^Tf, Xuc, Xos
Xu, Xu, Xu, Xu, Xu, Xu, Xu, Xu, Xos, Xos, Uu^Em, Uh^Em, Uu^Em, Uu, Uu^Es, Uu, Ur, Urb, Urb, Urb, Ur^Es, Ur, Uu, Uu^Em, Xom, Xos, Xom, Xom, Ur^Es, Xom, Ur^Es, Xuc, Xuc, Ur^Es, Uu^Em, Xuc, Xos
Xu, Xu, Xu, Xu, Xu, Xu, Xos, Xos, Xos, Xos, Uh^Emf, Uu^Em, Uu, Uu^Es, Uu, Ur^Es, Urb, Urb, Urb, Urb, Urb, Ur, Ur^Es, Uu^Em, Uu^Ebn, Xom^Efs, Ur, Ur, Uu^Em, Ur, Xuc, Ur^Es, Ur, Uu^Em, Xu, Xos, Xos
Xu, Xu, Xu, Xu, Xu, Xu, Xos, Xos, Uu, Uh, Uu^Em, Uu^Ii, Ur, Ur^Es, Ur^Ii, Xoc, Urb, Urb, Urb, Urb, Urb, Ur^Es, Ur, Uu, Ur, Ur^Es, Ur^Es, Uu^Emf, Xom, Xuc, Xos, Xu, Xu, Xu, Xos, Xos, Xos
Xu, Xu, Xu, Xu, Xu, Xos, Xos^Efs, Xos, Ur, Ur, Ur^Es, Ur, Xoc, Irs, Irs, Irs, Urb, Urb, Xos, Urb, Urb, Urb, Urb, Ur^Es, Urb, Uu, Uu, Uu^Em, Xos^Efs, Xos, Uu^Emf, Xu, Xu, Xu, Xu, Xu, Xos
Xu, Xu, Xu, Xu, Xu, Xos^Efs, Uu^Em, Ur^Ebn, Ur^Es, Irs, Irs, Irs, book_start Icr^Ii, Irs, Irs, Irs, Irs, Urb, Urb, Urb, Urb, Urb, Ur^Es, Ur, Urb, Urb, Xos, Urb^Pr/, Urb, Ur, Ur^Eb, Uu^Tf, Uu^Tf, Xu, Xu, Xu, Xos
Xu, Xu, Xu, Xu, Uh^Em, Uu^Em, Uu^Ii, Ur^Es, Ur, Xoc, Irs^Ii, Irs, Irs, Irs, Irs^Ii, Xoc, Irs, Urb, Ur, Urb, Urb, Xos, Ur^Es, Ur, Xos, Urb^Pr/, Urb, Urb, Urb, Urb, Uu^Em, Uu^Emf, Urb^Pr/, Xos, Xos, Xu, Xu
Xu, Xu, Uh^Tf, Uh^Emf, Uu^Em, Uu, Uu, Uu^Em, Ur, Ur^Es, Ur, Ur^Es, Xos, Irs, Irs, Irs, Urb, Ur^Es, Xos, Ur^Es, Ur, Ur^Es, Xos, Xos, Xos, Xos, Xos, Urb, Urb, Ur^Es, Xos, Xos, Xu, Uu^Em, Uh^Tf, Xu, Xu
Xu, Xu, Uh^Tf, Uu^Tf, Uh^Emf, Uh^Em, Uu^Ii, Ur, Uu, Ur^Es, Uu, Ur, Uu, Ur^Es, Urb, Urb, Urb, Urb, Urb, Urb, Ur^Pr/, Xos, Urc, Urc, Urc, Xos^Efs, Xos^Efs, Xos, Xos, Ur^Pr/, Ur^Es, Xu, Xu, Uu^Em, Uh^Emf, Xu, Xos
Xu, Xu, Xu, Xu, Xu, Uh^Em, Uh^Em, Uu^Em, Uu^Em, Uu, Uu^Em, Uu^Ii, Uu, Ur, Urb, Xos, Urb, Urb^Ebn, Xos, Xos, Urc, Ur, Ur, Ur, Urc, Urc, Xos, Xos, Xos, Xos, Ur, Uu, Uu^Em, Uu, Xu, Xu, Xos
Xu, Xu, Xu, Xu, Xu, Xu, Uh^Tf, Uh^Emf, Xu, Xu, Xu, Uh^Emf, Uu^Em, Ur^Es, Ur, Urb, Xos, Xos, Xos, Urc, Urc, Ur, Urc, Ur, Ur^Pr/, Xos, Xos^Efs, Xos, Urb, Urb, Urb, Ur, Ur^Es, Uu^Ebn, Xu, Xu, Xos
Xu, Xu, Xu, Xu, Xu, Xu, Xu, Xu, Xu, Xu, Xu, Uh^Tf, Xos, Xos, Xos, Urb^Pr/, Urb, Xos^Efs, Xos^Efs, Xos, Xos, Urc, Xos, Xos, Xos, Ur, Ur^Es, Ur^Eb, Urb, Urb, 1 Urb, Urb, Ur, Xos, Xos, Xos, Xos
Xu, Xu, Xu, Xu, Xu, Xos, Xos, Xu, Xu, Xu, Xos, Xos, Xos^Efs, Xos^Efs, Ur^Es, Ur^Es, Urb, Urb, Urb, Xos, Xos, Xos, Xos^Efs, Xos^Efs, Ur^Es, Ur, Urb, Ur, Ur^Es, Ur, Ur^Es, Ur, Ur^Es, Xos, Xos, Xos, Xos
Xu, Xu, Xu, Xu, Xos, Xos, Xu, Xu, Xu, Xu, Uu^Em, Xos, Uu^Ebn, Uu, Ur, Urb, Urb, Urb, Xos, Urb^Pr/, Urb, Xos, Urb, Ur, Urb, Urb, Urb, Urb, Urb, Urb, Ur^Es, Ur, Ur^Es, Xos, Xos, Xos, Xos
Xu, Xu, Xos, Xos, Xos, Xu, Xu, Xos, Xu, Xu, Uh^Em, Uu, Uh^Em, Uu, Uu^Es, Urb, Xos, Xos, Xos, Xos, Xu, Urb, Ur^Es, Ur, Ur^Es, Urb, Urb, Urb, Urb, Urb, Xos, Ur, Ur, Ur, Irs, Xos, Xos
Xos, Xos, Xos, Xos, Xos, Xos, Xu, Xos, Xu, Uh^Tf, Uh^Emf, Uh^Emf, Uh^Tf, Uu^Em, Xos, Xos, Xu, Xu, Xu, Xu, Uh^Emf, Xu, Uu^Em, Uu, Ur, Urb, Urb, Urb, Xos, Xos, Xos, Xos, Xos, Ur, Irs, Irs, Irs
Xos, Xos, Xos, Xos, Xos, Xos, Xos, Xu, Xu, Xu, Xu, Xu, Xu, Xu, Xos, Xos, Xu, Xu, Xu, Xu, Uh^Tf, Uh^Em, Uu^Em, Uu^Ebn, Xos, Ur^Es, Xos, Xos, Xos, Xos, Xos, Xos, Xos, Xos, Xos, Irs, Irs
Xos, Xos, Xos, Xos, Xos, Xos, Xos, Xos, Xu, Xos, Xu, Xu, Xos, Xos, Xos, Xos, Xos, Xu, Xu, Xu, Xu, Xu, Xu, Xu, Xos, Xos, Xos, Xos, Xos, Xos, Xos, Xos, Xos, Xos, Xos, Xos, Xos
Xos, Xos, Xos, Xos, Xos, Xos, Xu, Xu, Xos, Xu, Xos, Xos, Xos, Xos, Xos, Xos, Xos, Xos, Xos, Xos, Xos, Xos, Xos, Xos, Xos, Xos, Xos, Xos, Xos, Xos, Xos, Xos, Xos, Xos, Xos, Xos, Xos
