Xu, Xu, Xu, Xu, Xu, Xu, Xu, Xu, Xu, Xu, Xu, Xu, Xu, Xu, Xu, Xu, Xos, Xos, Xos, Xos, Xos, Xos, Xos, Xos, Xos, Xos, Xu, Xu, Xu, Xu, Uu, Ur, Xu, Xu, Xu, Xu, Xos
Xu, Xu, Xu, Xu, Xu, Xu, Xu, Xu, Xu, Xu, Xu, Xu, Xu, Xu, Xos, Xos, Xos, Xos, Xos, Xos, Xos, Xos, Uu^Uf, Xos, Xos, Xos, Xu, Xu, Xu, Xu, Uu, Ur, Xu, Xu, Xu, Xu, Xu
Xu, Xu, Xu, Xu, Xu, Xu, Xu, Xu, Xu, Xu, Xu, Xu, Uu, Uh, Xos, Xos, Xol, Xos, Urb, Xos, Xos, Uu, Uu, Uu, Uu, Xos, Xos, Xu, Xu, Uh, Uh, Ur, Ur, Xu, Xos, Xu, Xu
Xu, Xu, Xu, Xu, Xu, Xu, Xu, Xu, Xu, Xu, Xos, Uu, Uu, Uu, Uu, Xol, Urb, Urb, Urb, Urb, Urb, Xos, Urb, Uu, Xos, Xos, Xos, Xos, Xos, Xos, Xos, Xos, Xos, Ur, Uu^Uf, Xos, Xos
Xu, Xu, Xu, Xu, Xu, Xu, Xu, Xu, Xos, Xos, Xos, Xos, Xol, Uu, Urb, Urb, Urb, Urb, Urb, Urb, Urb, Urb, Uu, Uu, Xos, Xos, Uu, Xos, Ur, Xos, Ur, Xol, Xol, Ur, Uu, Xos, Xos
Xu, Xu, Xu, Xu, Xu, Xu, Xos, Xos, Xos, Xos, Uu, Xol, Urb, Urb, Urb, Urb, Urb, Urb, Urb, Urb, Urb, Urb, Urb, Uu, Uu, Xos, Ur, Ur, Uu, Ur, Xos, Ur, Ur, Ur, Xos, Xos, Xos
Xu, Xu, Xu, Xu, Xu, Xu, Xos, Xos, Uu, Uu, Urb, Urb, Urb, Urb, Urb, Xos, Urb, Urb, Urb, Urb, Urb, Urb, Urb, Uu, Urb, Uu, Uu, Uu, Xos, Uu, Xos, Uu, Xos, Xos, Xos, Xos, Xos
Xu, Xu, Xu, Xu, Xu, Xos, Xol, Xos, Urb, Urb, Urb, Rr, Urb, Urb, Urb, Urb, Urb, Urb, Xos, Urb, Urb, Urb, Urb, Urb, Urb, Uu, Uu, Uu, Xol, Xos, Uu, Xos, Uu, Xos, Xos, Xos, Xos
Xu, Xu, Xu, Xu, Xu, Xol, Uu, Urb, Urb, Urb, Urb, Urb, Urb, Urb, Urb, Urb, Urb, Urb, Urb, Urb, Urb, Urb, Urb, Urb, Urb, Urb, Xos, Xol, Urb, Urb, Urb, Uu, Uu, Xos, Xos, Xos, Xos
Xu, Xu, Xu, Xu, Uh, Uu, Uu, Urb, Urb, Xos, Urb, Urb, Urb, Urb, Urb, Urb, Urb, Urb, Urb, Urb, Urb, Xos, Urb, Urb, Xos, Urb^Pr/, Urb, Urb, Urb, Urb, Uu, Uu, Uu, Uu, Xos, Xos, Xos
Xu, Xu, Uh, Uh, Uu, Uu, Uu, Uu, Uu, Urb, Urb, Urb, Xos, Urb, Urb, Urb, Urb, Urb, Urb, Urb, Urb, Urb, Xos, Xos, Xos, Urb, Urb, Urb, Urb, Urb, Urb, Urb, Xos, Rr, Xos, Xos, Xos
Xu, Xu, Uh, Uu^Uf, Uh, Uh, Uu, Uu, Uu, Urb, Urb, Urb, Urb, Urb, Urb, Urb, Urb, Urb, Urb, Urb, Urb^Pr/, Xos, Urb, Urb, Urb, Xol, Xol, Urb, Urb, Urb, Urb^Pr/, Xos, Xos, Xos, Uu, Xos, Xos
Xu, Xu, Xu, Xu, Xu, Uh, Uh, Uu, Urb, Urb, Urb, Urb, Urb, Urb, Urb, Xos, Urb, Urb, Xos, Xos, Urb, Urb, Urb, Urb, Urb, Urb, Urb, Xos, Xol, Xos, Urb, Urb, Urb, Uu, Uu, Xos, Xos
Xu, Xu, Xu, Xu, Xu, Xu, Uh, Urb, Urb, Urb, Urb, Urb, Urb, Urb, Urb, Urb, Xos, Xos, Xol, Urb, Urb, Urb, Urb, Urb, Urb, Urb, Xos, Xol, Urb, Urb, Urb, Urb, Urb, Urb, Uu, Uu, Xos
Xu, Xu, Xu, Xu, Xu, Xu, Xos, Xos, Xos, Urb, Urb, Urb, Urb, Urb, Xos, Urb^Pr/, Urb, Urb, Urb, Xol, Xos, Urb, Urb, Urb, Xos, Urb^Pr/, Urb, Urb, Urb, Urb, 1 Urb, Urb, Urb, Urb, Uu, Uu, Xos
Xu, Xu, Xu, Xu, Xu, Xos, Xos, Xos, Xos, Xos, Xos, Urb, Xol, Xol, Urb, Urb, Urb, Urb, Urb, Urb, Urb, Xos, Xol, Xol, Urb, Urb, Urb, Urb, Urb, Urb, Urb, Urb, Urb, Urb, Xos, Xos, Xos
Xu, Xu, Xu, Xu, Xos, Xos, Xos, Xos, Xos, Xos, Xos, Xos, Uu, Urb, Urb, Urb, Urb, Urb, Urb, Urb, Urb^Pr/, Xos, Urb, Urb, Urb, Urb, Urb, Urb, Urb, Urb, Urb, Urb, Xos, Xos, Xos, Xos, Xos
Xu, Xu, Xos, Xos, Xos, Xos, Xos, Xos, Xos, Xos, Xos, Xos, Uh, Uu, Uu, Urb, Uu, Urb, Xos, Xos, Xos, Urb, Urb, Urb, Urb, Urb, Urb, Urb, Urb, Urb, Xos, Ur, Ur, Xos, Xos, Xos, Xos
Xos, Xos, Xos, Xos, Xos, Xos, Xos, Xos, Xos, Xos, Xos, Uu^Uf, Uu^Uf, Uu, Uu, Uu, Xos, Xos, Xos, Xos, Uu, Xos, Uu, Uu, Uu, Urb, Urb, Urb, Xos, Xos, Xos, Xos, Xos, Ur, Ur, Xos, Xos
Xos, Xos, Xos, Xos, Xos, Xos, Xos, Xos, Xos, Xos, Xos, Xos, Xos, Xos, Xos, Xos, Xos, Xos, Xos, Xos, Xos, Uu, Xos, Uu, Uu, Uu, Xos, Xos, Xos, Xos, Xos, Xos, Xos, Xos, Xos, Ur, Ur
Xos, Xos, Xos, Xos, Xos, Xos, Xos, Xos, Xos, Xos, Xos, Xos, Xos, Xos, Xos, Xos, Xos, Xos, Xos, Xos, Xos, Xos, Xos, Xos, Xos, Xos, Xos, Xos, Xos, Xos, Xos, Xos, Xos, Xos, Xos, Xos, Xos
Xos, Xos, Xos, Xos, Xos, Xos, Xos, Xos, Xos, Xos, Xos, Xos, Xos, Xos, Xos, Xos, Xos, Xos, Xos, Xos, Xos, Xos, Xos, Xos, Xos, Xos, Xos, Xos, Xos, Xos, Xos, Xos, Xos, Xos, Xos, Xos, Xos
