border_size=1
usage=map

Mm          , Mm          , Mm          , Mm          , Mm          , Mm          , Gs^Fp       , Gs^Fp       , Mm          , Mm          , Mm          , Mm          , Gg          , Hh          , Hh          , Gg          , Hh          , Hh          , Hh          , Gg          , Gg          , Gg          , Gg          , Gg          , Gg          , Gs^Fp       , Gg          , Gg          , Gg          , Gs^Fp       , Gs^Fp       , Gg          , Gg          , Gg          , Ww          , Ww          , Ww          
Mm          , Mm          , Mm          , Mm          , Mm          , Mm          , Gs^Fp       , Gs^Fp       , Mm          , Mm          , Mm          , Mm          , Gg          , Hh          , Hh          , Gg          , Hh          , Hh          , Hh          , Gg          , Gg          , Gg          , Ggf         , Gg          , Ggf         , Gs^Fp       , Gg          , Gg          , Gg^Ve       , Gs^Fp       , Gs^Fp       , Gg          , Gg          , Gg          , Ww          , Ww          , Ww          
Mm          , Mm          , Mm          , Mm          , Mm          , Mm          , Hh          , Mm          , Mm          , Mm          , Mm          , Mm          , Hh          , Hh          , Hh          , Hh^Vhh      , Re^Gvs      , Gg          , Gg          , Gg          , Gg          , Ggf         , Ggf         , Gg          , Gg          , Gg          , Gg          , Gg          , Gg          , Gs^Fp       , Gs^Fp       , Gg          , Ww          , Ww          , Ww          , Ww          , Ww          
Mm          , Mm          , Mm          , Hh          , Mm          , Mm          , Mm          , Mm          , Mm          , Mm          , Gs^Fp       , Hh          , Hh          , Hh          , Gg          , Re^Gvs      , Re^Gvs      , Re^Gvs      , Re^Gvs      , Gg          , Gg          , Gg          , Gg          , Gg          , Gs^Fp       , Gg          , Gg          , Gg          , Gg          , Gs^Fp       , Ww          , Ww          , Ww          , Ww          , Gg          , Gg          , Gg          
Mm          , Mm          , Mm          , Mm          , Mm          , Mm          , Mm          , Mm          , Mm          , Gs^Fp       , Gs^Fp       , Hh^Vhh      , Gs^Fp       , Hh          , Gg          , Re^Gvs      , Re^Gvs      , Re^Gvs      , Gg          , Gg          , Gg          , Ggf         , Gg          , Gg          , Gg          , Gg          , Ww          , Ww          , Ww          , Ww          , Ww          , Ww          , Gg          , Gg          , Gg          , Ggf         , Ggf         
Mm          , Mm          , Mm          , Mm          , Hh          , Mm          , Gg          , Mm          , Gg^Fet      , Hh          , Gg          , Hh          , Gs^Fp       , Gs^Fp       , Gs^Fp       , Gg          , Gg          , Gg          , Gg          , Gg          , Gg          , Gg          , Gg          , Gg          , Ww          , Ww^Bw\      , Ww^Bw\      , Ww          , Ww          , Ww          , Gg          , Ggf         , Gg          , Ggf         , Gg          , Gg          , Gg          
Mm          , Mm          , Mm          , Mm          , Gg          , Gg          , Gg          , Gs^Fp       , Gs^Fp       , Gg          , Gg          , Gs^Fp       , Gs^Fp       , Gg          , Gs^Fp       , Gs^Fp       , Gg          , Gg          , Gg          , Gg          , Ww          , Gg          , Ww          , Ww          , Ww          , Ww          , Gg          , Gg          , Gg          , Gg          , Gg          , Gg          , Gg          , Gg          , Gg^Fet      , Gs^Fp       , Gs^Fp       
Mm          , Mm          , Mm          , Mm          , Gg^Fet      , Gg          , Gg          , Gs^Fp       , Gs^Fp       , Gs^Fp       , Gs^Fp       , Gs^Fp       , Gs^Fp       , Gs^Fp       , Gs^Fp       , Gg^Fet      , Gg          , Gg          , Ww          , Ww          , Ww          , Ww          , Ww          , Ww          , Gg          , Gg          , Gg          , Gg          , Gg          , Gg          , Gg          , Gg          , Gs^Fp       , Gg          , Gs^Fp       , Gs^Fp       , Gs^Fp       
Mm          , Mm          , Mm          , Gs^Fp       , Mm          , Gg          , Hh          , Gg          , Gg          , Gg          , Gs^Fp       , Gg^Fet      , Gs^Fp       , Gs^Fp       , Gg          , Gg          , Ww          , Ww          , Ww          , Ww          , Gg          , Ww          , Gg          , Gg          , Gg          , Gs^Fp       , Gg          , Gg          , Gg          , Gg^Vh       , Gs^Fp       , Gg          , Gg          , Gg          , Gs^Fp       , Gg          , Gg          
Mm          , Mm          , Mm          , Mm          , Mm          , Mm          , Hh          , Hh          , Gs^Fp       , Gg          , Gs^Fp       , Gs^Fp       , Gs^Fp       , Gg          , Gg^Vh       , Ww          , Ww          , Ww          , Gg          , Gg          , Gs^Fp       , Gs^Fp       , Gg          , Gg          , Gg          , Gg          , Re^Gvs      , Gg          , Re^Gvs      , Re^Gvs      , Gg          , Gg          , Gg          , Gg          , Gs^Fp       , Gs^Fp       , Gs^Fp       
Mm          , Mm          , Mm          , Mm          , Mm          , Mm          , Gg          , Gg          , Gg          , Gs^Fp       , Gs^Fp       , Gg          , Gs^Fp       , Gg          , Gg          , Ww          , Ww          , Gg          , Gs^Fp       , Gg^Fet      , Gs^Fp       , Gg^Ve       , Gg          , Gg          , Re^Gvs      , Re^Gvs      , Re^Gvs      , Re^Gvs      , Re^Gvs      , Re^Gvs      , Gg          , Gg^Fet      , Gg          , Gs^Fp       , Gg          , Gs^Fp       , Gs^Fp       
Mm          , Mm          , Mm          , Mm          , Mm          , Mm          , Mm          , Gg          , Gs^Fp       , Gs^Fp       , Gg          , Gs^Fp       , Gg          , Gg          , Gg          , Ww          , Ww^Bw/      , Gg          , Gg          , Gs^Fp       , Re          , Gg          , Gg          , Gg          , Gg          , Re^Gvs      , Re^Gvs      , Re^Gvs      , Re^Gvs      , Re^Gvs      , Gg          , Gg          , Gg          , Gg          , Gs^Fp       , Gs^Fp       , Gs^Fp       
Gg          , Gg          , Gg          , Mm          , Mm          , Mm          , Mm          , Hh^Vhh      , Hh          , Gg          , Gg          , Gg          , Ggf         , Gg          , Gg          , Ww^Bw/      , Ww          , Gg          , Gg          , Gg          , Gg          , Gg          , Gs^Fp       , Gg          , Gg          , Ggf         , Gg          , Re^Gvs      , Gg^Wm       , Gg          , Gg          , Gg          , Gg          , Gs^Fp       , Gg          , Gs^Fp       , Gs^Fp       
Mm          , Mm          , Mm          , Gg          , Mm          , Mm          , Mm          , Gg          , Gg          , Gg          , Ggf         , Gg          , Re          , Gg          , Ww          , Ww          , Gg          , Ww          , Ww          , Gg          , Gg          , Gg          , Gg          , Gg          , Ggf         , Gg          , Gg          , Gg          , Gg          , Gg          , Re^Gvs      , Gg          , Gg          , Gg          , Gg          , Gs^Fp       , Gs^Fp       
Mm          , Mm          , Mm          , Hh          , Gg          , Mm          , Mm          , Mm          , Gg          , Gg          , Ggf         , Re          , Re^Gvs      , Re^Gvs      , Ww          , Gg          , Gg          , Gg          , Gg          , Ww          , Gg          , Gg          , Ggf         , Gg          , Gg          , Ggf         , Gg          , Gg          , Re^Gvs      , Re^Gvs      , Re^Gvs      , Re^Gvs      , Re^Gvs      , Gg^Ve       , Gs^Fp       , Gs^Fp       , Gs^Fp       
Mm          , Mm          , Mm          , Mm          , Mm          , Gg          , Gs^Fp       , Gg          , Gg          , Gg          , Gg          , Gg          , Re^Gvs      , Re^Gvs      , Gg          , Ww          , Gg          , Gg^Vh       , Gg          , Ww          , Gg          , Gg          , Gg          , Ggf         , Gg          , Ggf         , Gg          , Gg          , Re^Gvs      , Re^Gvs      , Gg          , Re^Gvs      , Gg          , Gs^Fp       , Gg          , Gs^Fp       , Gs^Fp       
Mm          , Mm          , Mm          , Hh          , Chr         , Gg          , Chr         , Gg          , Gg^Fet      , Ggf         , Gg          , Gg          , Gg          , Re^Gvs      , Ww          , Ww          , Gg          , Gs^Fp       , Ww          , Ww          , Gg          , Gg          , Gg          , Gg          , Gg^Ve       , Gg          , Gg          , Gg          , Gg          , Gg          , Gg          , Gs^Fp       , Gg          , Gg          , Hh          , Gg          , Gg          
Mm          , Mm          , Mm          , Gg          , Chr         , Khr         , Gg^Fet      , Gg          , Gg          , Gg          , Ggf         , Gg          , Gg          , Gg          , Ww          , Gg          , Gs^Fp       , Gg          , Ww          , Gg          , Gg          , Gg          , Gs^Fp       , Hh          , Hh          , Hh          , Hh          , Gg          , Gg          , Gg          , Gg          , Gg          , Gg          , Gg          , Hh          , Gs^Fp       , Gs^Fp       
Mm          , Mm          , Mm          , Gg          , Gs^Fp       , Chr         , Gs^Fp       , Chr         , Gg          , Re          , Gg          , Gg          , Gg^Vh       , Gg          , Ww          , Gg          , Ww          , Ww          , Gg          , Gg^Vh       , Gg          , Gs^Fp       , Hh          , Hh          , Hh          , Gs^Fp       , Hh          , Gg          , Gg          , Gg          , Gg          , Gg          , Gg          , Gg          , Gs^Fp       , Gs^Fp       , Gs^Fp       
Mm          , Mm          , Mm          , Mm          , Hh          , Gs^Fp       , Gg          , Gg          , Gg          , Gg          , Gg          , Gg          , Ww^Bw\      , Ww          , Ww          , Ww          , Gg          , Gg          , Ggf         , Gg          , Gg          , Hh          , Gs^Fp       , Hh          , Gg^Ve       , Hh          , Gg          , Gg          , Gg          , Gg          , Gg          , Gg          , Gg          , Hh          , Hh          , Hh          , Hh          
Mm          , Mm          , Mm          , Mm          , Hh          , Gg          , Gg          , Gg          , Gg          , Gg          , Ww          , Ww          , Ww          , Ww^Bw\      , Gg          , Gg          , Gs^Fp       , Gg          , Ggf         , Gg          , Gg          , Gg          , Gs^Fp       , Gs^Fp       , Gs^Fp       , Gs^Fp       , Gg          , Gg          , Re^Gvs      , Hh          , Gg          , Gg          , Gg          , Gg^Fet      , Gg          , Gs^Fp       , Gs^Fp       
Mm          , Mm          , Mm          , Hh          , Hh          , Hh^Vhh      , Gg          , Gg          , Gg          , Ww          , Ww          , Ww          , Gg          , Gg          , Gg          , Gg          , Gg          , Gg          , Gg          , Gs^Fp       , Gs^Fp       , Gg          , Gg          , Gs^Fp       , Gg          , Gs^Fp       , Gg          , Re^Gvs      , Re^Gvs      , Re^Gvs      , Gg          , Gg          , Gg          , Gg          , Gs^Fp       , Gg          , Gg          
Mm          , Mm          , Mm          , Mm          , Hh          , Hh          , Hh          , Gg          , Ww          , Ww          , Ww          , Gg          , Gs^Fp       , Gg          , Gs^Fp       , Gs^Fp       , Gs^Fp       , Gg          , Gs^Fp       , Re          , Re          , Gg          , Gg          , Gg          , Gg          , Gg          , Gg          , Re^Gvs      , Re^Gvs      , Re^Gvs      , Gg          , Gg          , Gg          , Gg          , Gg          , Gg          , Gg          
Mm          , Mm          , Mm          , Mm          , Gs^Fp       , Hh          , Hh          , Hh          , Ww          , Ww          , Gg          , Gg          , Gs^Fp       , Gg^Fet      , Gs^Fp       , Gs^Fp       , Gs^Fp       , Gg          , Gs^Fp       , Gs^Fp       , Gs^Fp       , Gg          , Gg          , Gg          , Gs^Fp       , Gs^Fp       , Gs^Fp       , Re^Gvs      , Gg          , Gg          , Gg          , Gg          , Gg          , Hh          , Gg          , Hh          , Hh          
Mm^Xm       , Mm          , Mm          , Mm          , Gs^Fp       , Gs^Fp       , Ww          , Ww          , Hh          , Gg          , Gs^Fp       , Gs^Fp       , Hh          , Gs^Fp       , Hh          , Gg^Ve       , Gs^Fp       , Gs^Fp       , Gs^Fp       , Gs^Fp       , Gs^Fp       , Gs^Fp       , Gg          , Gg          , Gs^Fp       , Gs^Fp       , Gs^Fp       , Gg^Ve       , Gg          , Gg          , Gg          , Gg          , Gg          , Gg          , Gg          , Gg          , Gg          
Xu          , Mm^Xm       , Xu          , Mm          , Ww          , Ww          , Hh          , Hh          , Hh          , Gs^Fp       , Gg^Fet      , Gs^Fp       , Gs^Fp       , Hh          , Hh          , Gs^Fp       , Gs^Fp       , Gs^Fp       , Gs^Fp       , Gs^Fp       , Gs^Fp       , Gg          , Gs^Fp       , Re          , Gs^Fp       , Gs^Fp       , Gs^Fp       , Gs^Fp       , Gs^Fp       , Gg          , Gg          , Gg          , Gg          , Gg          , Gg          , Gg          , Gg          
Xu          , Xu          , Uu          , 1 Uu        , Ww          , Hh          , Mm          , Hh          , Hh          , Gs^Fp       , Gs^Fp       , Gs^Fp       , Gg          , Hh          , Gs^Fp       , Gg^Fet      , Gs^Fp       , Gs^Fp       , Gg          , Gs^Fp       , Gs^Fp       , Gs^Fp       , Gg          , Gg          , Gs^Fp       , Gs^Fp       , Gs^Fp       , Gs^Fp       , Gs^Fp       , Gs^Fp       , Gg          , Gg          , Gg          , Gg          , Gg          , Gg          , Gg          
Xu          , Uu          , Ww          , Ww          , Xu          , Mm          , Mm          , Mm          , Hh          , Hh          , Hh          , Gs^Fp       , Gs^Fp       , Gg^Ve       , Gs^Fp       , Gs^Fp       , Gs^Fp       , Gs^Fp       , Gs^Fp       , Gs^Fp       , Gs^Fp       , Gs^Fp       , Gg          , Gs^Fp       , Gs^Fp       , Gs^Fp       , Gs^Fp       , Gg          , Gg          , Gg          , Gg          , Gg          , Gg          , Gg          , Gg          , Gs^Fp       , Gs^Fp       
Uu          , Uu          , Ww          , Xu          , Xu          , Mm^Xm       , Mm^Xm       , Mm          , Mm          , Hh          , Hh          , Gs^Fp       , Gs^Fp       , Gg          , Gs^Fp       , Gs^Fp       , Gs^Fp       , Gs^Fp       , Gs^Fp       , Gs^Fp       , Gs^Fp       , Gs^Fp       , Gg          , Gs^Fp       , Gs^Fp       , Gs^Fp       , Gs^Fp       , Gg          , Gg          , Gg          , Gg          , Gg          , Gg          , Gg          , Gg          , Gs^Fp       , Gs^Fp       
