
border_size=1
usage=map

       Mm,       Mm,       Mm,       Mm,   Gs,       Mm,       Mm,       Mm,       Hh,       Hh,       Hh,       Mm,       Mm,       Ww,       Ww,       Mm,       Hh,       Hh,       Hh,       Mm,       Mm,       Mm
       Mm,       Mm,       Mm,       Mm,   Gs^Vht,       Mm,       Mm,       Mm,       Hh,       Hh,       Hh,       Mm,       Mm,       Ww,       Ww,       Mm,       Hh,       Hh,       Hh,       Mm,       Mm,       Mm
       Mm,       Mm,       Mm,       Mm,       Hh,       Mm,       Hh,       Hh,       Hh,       Hh,       Gg,       Hh,       Hh,       Mm,    Gs^Fp,       Ww,       Hh,    Gs^Fp,   Gs^Vht,       Hh,       Hh,       Hh
       Mm,       Mm,       Hh,       Hh,       Hh,       Hh,       Hh,       Hh,     2 Ke,       Ce,       Re,       Gg,   Gs^Vht,    Gs^Fp,    Gs^Fp,       Ww,    Gs^Fp,    Gs^Fp,    Gs^Fp,    Gs^Fp,       Hh,       Hh
       Hh,       Hh,       Hh,       Hh,   Gs^Vht,       Hh,    Gs^Fp,       Ce,       Ce,       Ce,       Gg,       Re,       Gg,       Gg,       Ww,       Ww,    Gs^Fp,    Gs^Fp,    Gs^Fp,    Gs^Fp,       Hh,       Hh
       Hh,       Hh,       Gg,       Hh,       Hh,       Hh,       Gg,    Gs^Fp,    Gs^Fp,    Gs^Fp,       Re,   Gs^Vht,       Gg,       Gg,       Ww,       Gg,       Gg,    Gs^Fp,    Gs^Fp,    Gs^Fp,       Gg,       Gg
       Hh,       Hh,    Gs^Fp,       Gg,       Gg,       Re,       Gg,    Gs^Fp,       Gg,       Gg,       Re,       Gg,       Gg,       Gg,       Ww,       Gg,       Ss,       Ss,       Ss,       Ss,       Ss,       Ss
       Hh,       Hh,    Gs^Fp,       Gg,   Gs^Vht,       Re,       Re,       Gg,   Gs^Vht,       Re,       Gg,       Re,   Gs^Vht,       Ww,       Gg,       Gg,       Ss,       Ss,    Gs^Fp,       Ss,       Ss,       Ss
       Hh,       Hh,    Gs^Fp,    Gs^Fp,       Gg,       Gg,       Re,       Re,       Re,       Re,       Gg,       Gg,       Gg,       Ww,       Ww,       Ww,       Ss,       Ss,       Ss,    Gs^Fp,       Ss,       Ss
       Gg,       Gg,       Gg,       Gg,       Re,       Re,       Gg,       Gg,       Gg,       Re,       Gg,    Gs^Fp,       Gg,       Ww,       Ss,       Ss,       Ss,       Ss,       Ss,       Ss,       Ss,       Ss
       Gg,       Gg,    Gs^Fp,   Gs^Vht,    Gs^Fp,    Gs^Fp,       Gg,   Gs^Vht,       Gg,       Re,       Gg,       Gg,       Gg,       Ww,       Ss,       Ss,       Ss,       Ss,       Ss,       Ss,       Ss,       Ss
       Re,       Re,       Re,       Gg,       Re,       Gg,    Gs^Fp,       Gg,       Re,       Re,   Gs^Vht,    Gs^Fp,    Gs^Fp,    Gs^Fp,       Hh,   Gs^Vht,       Hh,    Gs^Fp,    Gs^Fp,       Ss,       Ss,       Ss
       Gg,       Gg,       Gg,       Re,       Gg,       Re,       Re,    Gs^Fp,       Re,       Gg,    Gs^Fp,    Gs^Fp,    Gs^Fp,    Gs^Fp,       Gg,       Gg,       Hh,       Hh,       Hh,    Gs^Fp,       Hh,       Hh
    Gs^Fp,    Gs^Fp,    Gs^Fp,       Gg,       Gg,       Gg,   Gs^Vht,       Re,       Gg,       Gg,    Gs^Fp,    Gs^Fp,       Gg,       Gg,    Gs^Fp,       Gg,    Gs^Fp,       Hh,    Gs^Fp,       Hh,       Hh,       Hh
    Gs^Fp,    Gs^Fp,    Gs^Fp,    Gs^Fp,    Gs^Fp,       Gg,    Gs^Fp,    Gs^Fp,    Gs^Fp,    Gs^Fp,    Gs^Fp,    Gs^Fp,       Gg,       Gg,    Gs^Fp,       Gg,    Gs^Fp,       Gg,    Gs^Fp,    Gs^Fp,    Gs^Fp,    Gs^Fp
       Gg,       Gg,    Gs^Fp,       Gg,       Gg,    Gs^Fp,    Gs^Fp,       Gg,    Gs^Fp,    Gs^Fp,    Gs^Fp,       Gg,       Gg,    Gs^Fp,       Ce,    Gs^Fp,       Gg,    Gs^Fp,    Gs^Fp,       Gg,    Gs^Fp,    Gs^Fp
       Gg,       Gg,       Gg,       Gg,    Gs^Fp,       Gg,       Gg,    Gs^Fp,    Gs^Fp,       Gg,    Gs^Fp,    Gs^Fp,    Gs^Fp,       Ce,     1 Ke,       Ce,    Gs^Fp,    Gs^Fp,    Gs^Fp,    Gs^Fp,    Gs^Fp,    Gs^Fp
       Hh,       Hh,       Hh,    Gs^Fp,    Gs^Fp,    Gs^Fp,    Gs^Fp,       Gg,       Gg,    Gs^Fp,    Gs^Fp,       Gg,    Gs^Fp,       Ce,       Ce,       Ce,    Gs^Fp,    Gs^Fp,       Gg,    Gs^Fp,    Gs^Fp,    Gs^Fp
       Hh,       Hh,       Hh,       Hh,       Hh,    Gs^Fp,    Gs^Fp,       Gg,    Gs^Fp,    Gs^Fp,       Gg,    Gs^Fp,    Gs^Fp,    Gs^Fp,    Gs^Fp,    Gs^Fp,    Gs^Fp,       Gg,    Gs^Fp,    Gs^Fp,       Mm,       Mm
       Mm,       Mm,       Mm,       Hh,       Hh,       Hh,       Hh,    Gs^Fp,    Gs^Fp,    Gs^Fp,    Gs^Fp,    Gs^Fp,    Gs^Fp,    Gs^Fp,    Gs^Fp,    Gs^Fp,    Gs^Fp,    Gs^Fp,       Hh,       Hh,       Mm,       Mm
       Mm,       Mm,       Mm,       Mm,       Mm,       Hh,       Mm,       Mm,       Mm,       Mm,       Mm,    Gs^Fp,    Gs^Fp,       Gg,    Gs^Fp,    Gs^Fp,       Hh,       Hh,       Mm,       Mm,       Mm,       Mm
       Mm,       Mm,       Mm,       Mm,       Mm,       Hh,       Mm,       Mm,       Mm,       Mm,       Mm,    Gs^Fp,    Gs^Fp,       Gg,    Gs^Fp,    Gs^Fp,       Hh,       Hh,       Mm,       Mm,       Mm,       Mm
