
border_size=1
usage=map

       Mm,       Mm,       Mm,       Mm,       Mm,       Mm,       Mm,       Mm,    Gs^Fp,    Gs^Fp,    Gs^Fp,       Gg,       Gg,       Gg,       Gg,       Gg,       Gg,       Gg,       Gg,       Gg,       Gg,       Gg,       Gg,       Mm,       Mm,       Mm,       Gg,       Gg,       Ce,       Ce,       Ce,       Gg,       Gg,       Mm,   Hh,       Mm,       Hh,       Hh,       Hh,       Hh,       Gg,       Gg
       Mm,       Mm,       Mm,       Mm,       Mm,       Mm,       Mm,       Mm,    Gs^Fp,    Gs^Fp,    Gs^Fp,       Gg,       Gg,       Gg,       Gg,       Gg,       Gg,       Gg,       Gg,       Gg,       Gg,       Gg,       Gg,       Mm,       Mm,       Mm,       Gg,       Gg,       Ce,       Ce,       Ce,       Gg,       Gg,       Mm,   Hh^Vhh,       Mm,       Hh,       Hh,       Hh,       Hh,       Gg,       Gg
       Mm,       Mm,       Mm,       Mm,       Hh,       Hh,       Hh,       Hh,       Hh,    Gs^Fp,    Gs^Fp,       Gg,       Gg,       Gg,    Gs^Fp,       Gg,       Gg,       Gg,    Gs^Fp,       Gg,       Gg,       Gg,       Gg,    Gs^Fp,    Gs^Fp,    Gs^Fp,       Gg,       Gg,       Ce,     2 Ke,       Ce,       Gg,    Gs^Fp,       Hh,       Hh,       Hh,       Hh,       Hh,    Gs^Fp,       Gg,       Ww,       Ww
   Hh,   Hh^Vhh,       Hh,       Hh,       Hh,       Hh,       Hh,       Hh,    Gs^Fp,    Gs^Fp,       Gg,       Gg,       Gg,    Gs^Fp,    Gs^Fp,    Gs^Fp,    Gs^Fp,    Gs^Fp,    Gs^Fp,    Gg^Vh,    Gs^Fp,       Gg,    Gs^Fp,       Gg,       Gg,       Gg,       Hh,       Gg,       Gg,       Ce,       Gg,    Gs^Fp,    Gs^Fp,    Gs^Fp,    Gs^Fp,    Gs^Fp,    Gs^Fp,    Gs^Fp,       Gg,       Ww,       Ww,       Ww
       Hh,       Hh,       Hh,       Hh,       Gg,    Gs^Fp,    Gs^Fp,    Gs^Fp,    Gs^Fp,    Gs^Fp,       Gg,       Gg,       Gg,    Gs^Fp,    Gs^Fp,    Gs^Fp,    Gs^Fp,    Gs^Fp,    Gs^Fp,    Gs^Fp,    Gs^Fp,    Gs^Fp,    Gs^Fp,    Gs^Fp,       Gg,    Gg^Vh,       Hh,    Gs^Fp,       Gg,       Gg,       Gg,    Gs^Fp,    Gs^Fp,    Gs^Fp,       Gg,    Gs^Fp,       Gg,       Gg,       Ww,       Ww,       Ww,       Ww
       Hh,       Hh,       Ww,       Gg,       Ww,       Gg,       Ww,       Gg,       Ww,       Gg,       Ww,       Gg,       Gg,       Gg,       Ww,    Gs^Fp,    Gs^Fp,    Gs^Fp,       Gg,    Gs^Fp,       Gg,    Gs^Fp,    Gs^Fp,    Gs^Fp,       Gg,    Gs^Fp,    Gs^Fp,    Gs^Fp,       Gg,       Gg,       Gg,       Gg,       Gg,       Gg,       Gg,    Gg^Vh,       Ww,       Ww,       Ww,       Ww,       Ww,       Ww
       Ww,       Ww,       Wo,       Ww,       Wo,       Ww,       Wo,       Ww,       Wo,       Ww,       Wo,       Ww,       Ww,       Ww,       Ww,       Ww,       Ww,       Ww,       Ww,       Ww,       Ww,       Gg,       Gg,       Gg,       Gg,       Gg,       Ww,       Gg,       Ww,       Gg,    Gs^Fp,       Gg,       Gg,    Gs^Fp,      Wwf,       Ww,       Ww,       Ww,       Ww,       Ww,       Ww,       Ww
       Wo,       Wo,       Wo,       Wo,       Wo,       Wo,       Wo,       Wo,       Wo,       Wo,       Wo,       Wo,       Wo,       Wo,       Wo,       Wo,       Wo,       Ww,       Wo,       Wo,       Wo,       Ww,       Ww,       Ww,       Ww,       Ww,       Ww,       Ww,       Ww,       Ww,       Ww,       Ww,      Wwf,       Ww,      Wwf,      Wwf,       Ww,       Ww,       Ww,       Ww,       Ww,       Ww
       Wo,       Wo,       Ww,       Wo,       Ww,       Wo,       Ww,       Wo,       Ww,       Wo,       Ww,       Wo,       Wo,       Wo,       Wo,       Wo,       Wo,       Wo,    Gs^Fp,    Gs^Fp,    Gs^Fp,       Wo,       Wo,       Wo,       Wo,       Wo,       Wo,       Ww,       Ww,       Ww,       Ww,       Ww,       Ww,      Wwf,       Ww,      Wwf,       Ww,       Ww,       Ww,       Ww,       Ww,       Ww
       Ww,       Ww,       Hh,       Ww,       Gg,       Ww,    Gs^Fp,       Ww,    Gs^Fp,       Ww,       Ww,       Ww,       Ww,       Ww,       Ww,       Ww,       Ww,       Wo,       Wo,    Gs^Fp,       Wo,       Gg,       Wo,       Wo,       Wo,       Wo,       Ww,       Ww,       Ww,       Ww,       Ww,       Ww,       Ww,      Wwf,      Wwf,      Wwf,       Ww,       Ww,       Ww,       Ww,       Ww,       Ww
       Hh,       Hh,       Hh,       Gg,       Gg,       Gg,       Gg,    Gs^Fp,       Gg,    Gs^Fp,    Gs^Fp,    Gs^Fp,    Gs^Fp,       Gg,       Gg,       Gg,       Gg,       Ww,       Ww,       Ww,       Ww,       Ww,       Ww,       Ww,       Ww,       Ww,       Ww,       Ww,       Ww,       Ww,       Ww,       Ww,      Wwf,      Wwf,      Wwf,      Wwf,      Wwf,       Ww,       Ww,       Ww,       Ww,       Ww
       Hh,       Hh,    Gs^Fp,       Gg,       Gg,       Gg,       Gg,       Gg,       Gg,    Gs^Fp,    Gs^Fp,    Gs^Fp,    Gs^Fp,       Gg,       Gg,       Gg,       Gg,       Gg,       Gg,       Gg,       Gg,       Gg,       Gg,    Gg^Vh,       Gg,       Gg,       Gg,       Ww,       Gg,       Ww,       Ce,       Ww,       Gg,       Ww,      Wwf,      Wwf,       Ww,       Ww,       Gg,       Gg,       Gg,       Gg
       Gg,       Gg,       Gg,       Gg,       Gg,       Gg,       Ce,       Gg,       Gg,       Gg,       Gg,    Gs^Fp,       Gg,       Gg,       Gg,       Gg,    Gs^Fp,    Gs^Fp,    Gs^Fp,       Gg,       Gg,       Gg,       Gg,       Gg,    Gg^Vh,       Gg,       Gg,       Gg,       Gg,       Ce,     3 Ke,       Ce,       Gg,       Gg,       Gg,       Ww,       Gg,       Gg,    Gs^Fp,       Gg,       Gg,       Gg
       Gg,       Gg,    Gg^Vh,       Gg,       Gg,       Gg,       Gg,       Ce,       Gg,       Gg,       Gg,       Gg,       Gg,       Gg,       Gg,       Gg,    Gs^Fp,    Gs^Fp,    Gs^Fp,       Gg,       Gg,       Gg,       Re,       Gg,       Re,       Gg,       Re,       Gg,       Re,       Re,       Ce,       Ce,       Gg,       Gg,       Gg,       Gg,       Gg,    Gs^Fp,       Ce,    Gs^Fp,       Gg,       Gg
       Gg,       Gg,       Gg,       Gg,    Gs^Fp,       Gg,    Gg^Vh,       Gg,       Gg,       Ce,       Ce,       Gg,       Gg,       Gg,       Gg,       Gg,       Gg,    Gs^Fp,       Re,       Gg,       Re,       Re,    Gs^Fp,       Re,       Gg,       Re,       Gg,       Re,       Gg,       Gg,       Gg,       Gg,       Gg,       Gg,       Gg,       Gg,       Gg,       Ce,     1 Ke,       Ce,       Gg,       Gg
       Gg,       Gg,       Ww,    Gs^Fp,       Ww,    Gs^Fp,       Gg,       Gg,       Gg,       Gg,       Gg,       Ce,       Gg,       Gg,       Re,       Re,       Re,       Re,       Gg,       Re,       Gg,    Gs^Fp,    Gs^Fp,    Gs^Fp,       Gg,       Re,       Gg,       Gg,       Gg,       Gg,    Gs^Fp,    Gs^Fp,    Gs^Fp,    Gs^Fp,    Gs^Fp,    Gs^Fp,    Gs^Fp,       Ce,       Ce,       Ce,       Gg,       Gg
       Gg,       Gg,       Ww,       Ww,       Gg,       Gg,       Gg,       Gg,       Gg,    Gg^Vh,       Gg,       Gg,       Re,       Re,       Gg,       Gg,       Gg,       Gg,       Gg,       Gg,       Gg,    Gs^Fp,    Gs^Fp,    Gs^Fp,       Gg,       Re,       Gg,       Gg,       Gg,    Gs^Fp,    Gg^Vh,    Gs^Fp,    Gs^Fp,    Gs^Fp,    Gs^Fp,    Gg^Vh,    Gs^Fp,       Gg,    Gs^Fp,       Gg,       Gg,       Gg
       Gg,       Gg,       Gg,       Gg,       Gg,       Ce,       Ce,       Re,       Re,       Re,       Re,       Re,       Ce,       Gg,    Gs^Fp,    Gs^Fp,    Gs^Fp,    Gs^Fp,       Gg,       Gg,       Gg,       Gg,       Gg,       Gg,       Re,       Re,    Gs^Fp,       Gg,    Gs^Fp,    Gs^Fp,    Gs^Fp,    Gs^Fp,    Gs^Fp,    Gs^Fp,    Gs^Fp,    Gs^Fp,       Gg,    Gs^Fp,    Gs^Fp,    Gs^Fp,       Gg,       Gg
       Gg,       Gg,       Gg,       Gg,       Gg,     4 Ke,       Ce,       Gg,    Gs^Fp,       Gg,    Gg^Vh,       Gg,       Ce,       Gg,    Gs^Fp,    Gs^Fp,    Gs^Fp,       Gg,    Gs^Fp,       Gg,       Gg,       Gg,    Gs^Fp,       Gg,       Re,    Gs^Fp,    Gs^Fp,    Gs^Fp,    Gs^Fp,    Gs^Fp,    Gs^Fp,    Gs^Fp,    Gs^Fp,    Gs^Fp,       Gg,       Gg,       Gg,    Gs^Fp,    Gs^Fp,    Gs^Fp,       Gg,       Gg
       Gg,       Gg,       Gg,       Gg,       Gg,       Gg,       Gg,       Gg,       Gg,       Gg,       Gg,       Gg,       Ce,       Gg,       Gg,    Gs^Fp,       Gg,       Gg,    Gs^Fp,       Gg,       Gg,    Gs^Fp,    Gs^Fp,    Gs^Fp,       Re,    Gs^Fp,    Gs^Fp,    Gs^Fp,       Hh,    Gs^Fp,       Gg,    Gs^Fp,    Gs^Fp,    Gs^Fp,    Gs^Fp,    Gs^Fp,    Gs^Fp,       Gg,       Gg,       Gg,       Gg,       Gg
       Gg,       Gg,       Gg,       Gg,    Gs^Fp,       Gg,    Gs^Fp,       Gg,    Gs^Fp,       Gg,       Gg,       Gg,       Gg,    Gs^Fp,       Gg,       Gg,       Gg,       Gg,       Gg,       Gg,       Gg,    Gs^Fp,    Gs^Fp,    Gs^Fp,       Re,       Gg,       Hh,       Hh,       Hh,       Hh,       Hh,       Hh,       Hh,    Gs^Fp,    Gs^Fp,    Gs^Fp,    Gs^Fp,       Gg,       Gg,       Gg,       Gg,       Gg
       Gg,       Gg,       Gg,       Gg,    Gs^Fp,       Gg,    Gs^Fp,       Gg,    Gs^Fp,       Gg,       Gg,       Gg,       Gg,    Gs^Fp,       Gg,       Gg,       Gg,       Gg,       Gg,       Gg,       Gg,    Gs^Fp,    Gs^Fp,    Gs^Fp,       Re,       Gg,       Hh,       Hh,       Hh,       Hh,       Hh,       Hh,       Hh,    Gs^Fp,    Gs^Fp,    Gs^Fp,    Gs^Fp,       Gg,       Gg,       Gg,       Gg,       Gg
