border_size=1
usage=map

Mm^Xm       , Mm^Xm       , Mm^Xm       , Mm^Xm       , Mm^Xm       , Mm^Xm       , Mm^Xm       , Mm^Xm       , Mm^Xm       , Mm^Xm       , Mm^Xm       , Mm          , Mm          , Mm          , Mm          , Gg          , Gg          , Gg          , Gg          , Gg          , Gg          , Mm          , Mm          , Mm^Xm       , Mm^Xm       , Mm^Xm       , Mm^Xm       , Mm^Xm       , Mm^Xm       , Mm          , Wo          , Wo          , Ai          , Ai          , Mm          , Mm          , Mm          
Mm^Xm       , Mm^Xm       , Mm^Xm       , Mm^Xm       , Mm^Xm       , Mm^Xm       , Mm^Xm       , Mm^Xm       , Mm^Xm       , Mm^Xm       , Mm^Xm       , Mm          , Mm          , Mm          , Mm          , Gg          , Gg          , Gg          , Gg          , Gg          , Gg          , Mm          , Mm          , Mm^Xm       , Mm^Xm       , Mm^Xm       , Mm^Xm       , Mm^Xm       , Mm^Xm       , Mm          , Wo          , Wo          , Ai          , Ai          , Mm          , Mm          , Mm          
Mm^Xm       , Mm^Xm       , Mm^Xm       , Mm^Xm       , Mm^Xm       , Mm^Xm       , Mm          , Mm^Xm       , Mm^Xm       , Mm^Xm       , Mm          , Mm^Xm       , Mm          , Mm          , Mm          , Ggf         , Ggf         , Gg          , Gg          , Gg          , Gg          , Mm          , Mm          , Mm^Xm       , Mm^Xm       , Mm^Xm       , Mm^Xm       , Mm^Xm       , Mm^Xm       , Mm          , Wo          , Ai          , Ai          , Wo          , Mm          , Mm          , Mm          
Mm^Xm       , Mm^Xm       , Mm^Xm       , Mm^Xm       , Mm          , Mm          , Mm          , Mm          , Mm          , Mm          , Mm          , Mm          , Mm          , Mm          , Hh          , Hh          , Gg          , Gg          , Gs^Fp       , Gs^Fp       , Gs^Fp       , Mm          , Mm          , Mm          , Mm          , Mm          , Mm          , Mm^Xm       , Mm          , Mm          , Wo          , Mm          , Mm          , Mm          , Mm^Xm       , Mm^Xm       , Mm^Xm       
Mm^Xm       , Mm^Xm       , Mm          , Mm          , Mm          , Mm          , Gs^Fp       , Gs^Fp       , Hh          , Mm          , Mm          , Mm          , Hh          , Hh          , Hh^Vhh      , Gg          , Gg          , Gg^Vc       , Gg          , Gs^Fp       , Chr         , Gs^Fp       , Gs^Fp       , Mm          , Mm          , Mm          , Mm          , Mm          , Wo          , Wo          , Mm          , Mm          , Mm^Xm       , Mm^Xm       , Mm^Xm       , Mm^Xm       , Mm^Xm       
Mm          , Mm          , Mm          , Mm          , Mm          , Mm          , Gs^Fp       , Gs^Fp       , Hh^Vhh      , Hh          , Hh          , Hh          , Hh          , Hh          , Gg          , Gs^Fp       , Gg          , Gg          , Gg          , Chr         , 3 Khr       , Chr         , Aa^Fpa      , Aa^Fpa      , Mm          , Mm          , Mm^Xm       , Mm          , Wo          , Mm          , Mm          , Mm^Xm       , Mm          , Mm          , Mm^Xm       , Mm^Xm       , Mm^Xm       
Mm          , Mm          , Mm          , Mm          , Mm          , Mm          , Hh          , Gs^Fp       , Hh          , Hh          , Gs^Fp       , Hh          , Gs^Fp       , Gg          , Gs^Fp       , Gs^Fp       , Gs^Fp       , Gg          , Aa          , Chr         , Chr         , Chr         , Aa^Fpa      , Aa^Fpa      , Mm          , Mm^Xm       , Wo          , Wo          , Mm^Xm       , Mm          , Mm          , Mm          , Hh          , Mm          , Mm          , Mm^Xm       , Mm^Xm       
Mm^Xm       , Mm^Xm       , Mm          , Hh^Vhh      , Hh          , Hh          , Hh          , Hh          , Gs^Fp       , Hh          , Hh          , Gs^Fp       , Gs^Fp       , Gs^Fp       , Gs^Fp       , Gs^Fp       , Gg          , Gg          , Aa          , Aa          , Aa^Fpa      , Aa^Fpa      , Aa^Fpa      , Aa^Fpa      , Mm^Xm       , Mm          , Wo          , Mm^Xm       , Mm          , Mm          , Hh          , Hh          , Hh          , Mm          , Mm          , Mm          , Mm          
Mm^Xm       , Mm^Xm       , Mm          , Hh          , Hh          , Gs^Fp       , Gs^Fp       , Hh          , Gs^Fp       , Gs^Fp       , Gg          , Gs^Fp       , Gs^Fp       , Gg          , Gs^Fp       , Gs^Fp       , Aa^Fpa      , Ha          , Mm          , Mm          , Mm          , Aa^Fpa      , Mm          , Mm^Xm       , Wo          , Wo          , Mm          , Mm          , Hh          , Hh          , Hh          , Gs^Fp       , Gs^Fp       , Hh          , Hh          , Mm          , Mm          
Mm^Xm       , Mm^Xm       , Mm          , Hh          , Hh          , Hh          , Gg          , Gs^Fp       , Gs^Fp       , Gs^Fp       , Gs^Fp       , Gg          , Aa^Fpa      , Gs^Fp       , Aa^Fpa      , Aa^Fpa      , Ha          , Aa^Vha      , Mm          , Mm          , Mm          , Mm          , Wo          , Wo          , Mm          , Mm          , Mm          , Mm          , Hh          , Hh          , Hh          , Gs^Fp       , Aa          , Gs^Fp       , Ha          , Mm          , Mm          
Mm^Xm       , Mm^Xm       , Mm          , Hh          , Gs^Fp       , Gs^Fp       , Gs^Fp       , Gs^Fp       , Gs^Fp       , Gs^Fp       , Gs^Fp       , Aa          , Aa^Fpa      , Ha          , Aa^Fpa      , Aa^Fpa      , Ha          , Mm          , Mm          , Mm          , Wo          , Wo          , Mm          , Mm          , Mm          , Mm          , Gs^Fp       , Gs^Fp       , Gs^Fp       , Gs^Fp       , Gs^Fp       , Aa          , Aa^Fpa      , Aa^Fpa      , Aa^Fpa      , Mm          , Mm          
Mm^Xm       , Mm^Xm       , Mm          , Hh          , Gg          , Gg          , Gs^Fp       , Gs^Fp       , Gs^Fp       , Gs^Fp       , Aa^Fpa      , Aa^Fpa      , Ha          , Aa^Fpa      , Mm          , Aa^Vha      , Mm          , Mm          , Wo          , Wo          , Mm          , Mm          , Mm          , Mm          , Gs^Fp       , Gs^Fp       , Gs^Fp       , Gs^Fp       , Gs^Fp       , Gs^Fp       , Gg          , Aa^Fpa      , Aa^Fpa      , Aa^Fpa      , Mm          , Mm^Xm       , Mm^Xm       
Mm^Xm       , Mm^Xm       , Mm          , Mm          , Mm          , Gg          , Ggf         , Gg          , Gg          , Ha          , Ha          , Ha          , Ha          , Mm          , Mm          , Mm          , Mm          , Wo          , Mm          , Mm          , Mm          , Mm          , Mm          , Mm          , Gg^Vc       , Gs^Fp       , Aa          , Gs^Fp       , Gs^Fp       , Gs^Fp       , Gg          , Aa^Fpa      , Aa^Fpa      , Mm          , Mm          , Mm^Xm       , Mm^Xm       
Mm^Xm       , Mm^Xm       , Mm          , Mm          , Mm          , Hh          , Gg          , Gg          , Ha          , Ha          , Ha          , Ha          , Mm          , Mm          , Mm          , Mm          , Wo          , Wo          , Mm          , Mm          , Mm          , Gs^Fp       , Gs^Fp       , Gg          , Gs^Fp       , Gs^Fp       , Gs^Fp       , Gs^Fp       , Gs^Fp       , Gg          , Gg          , Gg          , Aa^Fpa      , Mm          , Mm^Xm       , Mm^Xm       , Mm^Xm       
Mm^Xm       , Mm^Xm       , Hh          , Mm          , Mm          , Hh          , Gg          , Gg          , Aa^Vha      , Ha          , Mm          , Mm          , Mm          , Mm          , Wo          , Wo          , Mm          , Mm          , Mm          , Mm          , Mm          , Gs^Fp       , Gs^Fp       , Gg          , Gg          , Gs^Fp       , Gg          , Gs^Fp       , Aa          , Gs^Fp       , Gg          , Gg          , Mm          , Mm          , Mm^Xm       , Mm^Xm       , Mm^Xm       
Mm          , Mm          , Hh          , Gs^Fp       , Gs^Fp       , Gg          , Gg          , Gg          , Mm          , Mm          , Mm          , Mm          , Mm          , Wo          , Mm          , Mm          , Mm          , Mm          , Mm          , Mm          , Mm          , Gs^Fp       , Gg          , Gg          , Gg          , Gg          , Gg          , Gs^Fp       , Gs^Fp       , Gs^Fp       , Gg          , Gg          , Mm          , Mm          , Mm          , Mm^Xm       , Mm^Xm       
Mm          , Mm          , Hh^Vhh      , Gs^Fp       , Gs^Fp       , Gs^Fp       , Gs^Fp       , Gg          , Mm          , Mm          , Mm          , Mm          , Wo          , Wo          , Mm          , Mm          , Mm          , Mm          , Hh          , Mm          , Gg          , Gg          , Gg          , Gg          , Gg          , Gg          , Gg          , Gg          , Gg          , Gg          , Gg          , Gg          , Aa^Fpa      , Mm          , Mm          , Mm          , Mm          
Mm          , Mm          , Gs^Fp       , Gs^Fp       , Gg          , Gs^Fp       , Gs^Fp       , Gg^Vc       , Aa          , Mm          , Mm          , Wo          , Mm          , Mm          , Gg^Vc       , Mm          , Hh          , Hh          , Hh          , Hh          , Hh          , Gg          , Aa          , Aa          , Aa          , Gg          , Gg          , Gg          , Gg          , Gg          , Gg          , Aa          , Aa          , Aa^Fpa      , Mm          , Mm          , Mm          
Mm          , Mm          , Gs^Fp       , Gg          , Hh          , Gs^Fp       , Gs^Fp       , Gs^Fp       , Ai          , Ai          , Ai          , Wo          , Ai          , Ai          , Ai          , Gs^Fp       , Gg          , Hh          , Hh          , Hh          , Hh          , Aa          , Mm          , Aa          , Aa^Fpa      , Aa          , Aa^Fpa      , Gg          , Gg          , Gg          , Gg          , Gg          , Aa          , Hh          , Hh          , Mm          , Mm          
Mm^Xm       , Mm^Xm       , Hh          , Hh          , Gg          , Gg          , Gg          , Gg          , Ai          , Ai          , Ai          , Ai          , Ai          , Ai          , Ai          , Gs^Fp       , Gs^Fp       , Gg          , Hh          , Hh          , Ha          , Mm          , Mm          , Mm          , Aa^Fpa      , Aa^Fpa      , Aa^Fpa      , Gg          , Gg          , Gg          , Gg          , Gg          , Hh          , Hh          , Mm          , Mm          , Mm          
Mm^Xm       , Mm^Xm       , Mm          , Hh          , Gg          , Gg          , Gg          , Gg          , Ai          , Ai          , Ai          , Wo          , Wo          , Ai          , Ai          , Ai          , Gs^Fp       , Gg          , Hh          , Ha          , Mm          , Mm          , Wo          , Mm^Xm       , Mm^Xm       , Aa^Vha      , Mm^Xm       , Mm          , Mm          , Gg          , Gg          , Gg          , Hh          , Hh          , Mm          , Mm          , Mm          
Mm          , Mm          , Mm          , Hh          , Gg          , Gg          , Gg          , Ai          , Ai          , Ai          , Ai          , Ai          , Ai          , Ai          , Ai          , Ai          , Gs^Fp       , Gg          , Ha          , Ha          , Mm          , Mm^Xm       , Wo          , Wo          , Wo          , Mm          , Mm^Xm       , Mm^Xm       , Mm^Xm       , Hh^Vhh      , Gg          , Gg          , Gg          , Hh          , Mm          , Mm          , Mm          
Mm          , Mm          , Mm^Xm       , Hh          , Gg          , Gg          , Gg          , Ai          , Ai          , Ai          , Ai          , Ai          , Ai          , Ai          , Ai          , Ai          , Gg^Vc       , Gg          , Aa          , Ha          , Mm          , Mm^Xm       , Mm^Xm       , Wo          , Wo          , Mm          , Mm          , Mm          , Mm          , Mm          , Gg          , Gg          , Gg          , Mm          , Mm          , Mm          , Mm          
Mm          , Mm          , Mm          , Hh          , Hh          , Gg          , Gg          , Gg          , Gg          , Ai          , Ai          , Ai          , Ai          , Ai          , Ai          , Ai          , Ww^Bw/      , Aa          , Aa          , Ha          , Mm          , Mm^Xm       , Mm^Xm       , Mm^Xm       , Mm          , Wo          , Mm          , Mm          , Mm          , Mm          , Gg          , Gg          , Gg          , Mm          , Mm          , Mm          , Mm          
Mm          , Mm          , Mm          , Mm          , Hh          , Gg          , Gg          , Gg          , Gs^Fp       , Gg          , Gs^Fp       , Ai          , Gg          , Ai          , Gg          , Ww^Bw/      , Wo          , Wo          , Ai          , Ha          , Ha          , Mm          , Mm          , Mm          , Wo          , Wo          , Mm          , Hh          , Hh          , Hh          , Gg          , Gg          , Gg          , Mm          , Mm          , Mm          , Mm          
Mm^Xm       , Mm^Xm       , Mm          , Mm          , Hh          , Hh          , Gs^Fp       , Ggf         , Gs^Fp       , Gs^Fp       , Gs^Fp       , Gs^Fp       , Gs^Fp       , Gg^Vc       , Gs^Fp       , Gs^Fp       , Gs^Fp       , Wo          , Wo          , Ai          , Wo          , Ha          , Wo          , Wo          , Mm          , Mm          , Mm          , Mm          , Gs^Fp       , Hh          , Gs^Fp       , Gg          , Gg          , Gg          , Hh          , Mm          , Mm          
Mm^Xm       , Mm^Xm       , Mm          , Mm          , Ha          , Aa^Fpa      , Aa^Fpa      , Gs^Fp       , Aa^Fpa      , Gs^Fp       , Gs^Fp       , Aa          , Gs^Fp       , Gg          , Gs^Fp       , Gg          , Gs^Fp       , Gs^Fp       , Gs^Fp       , Wo          , Ai          , Wo          , Wo          , Ha          , Mm          , Mm^Xm       , Mm          , Aa^Fpa      , Gs^Fp       , Gs^Fp       , Hh          , Gg          , Ce          , Gg          , Gg          , Mm          , Mm          
Mm          , Mm          , Mm          , Ha          , Ha          , Ha          , Ha          , Aa^Fpa      , Aa^Vha      , Aa^Fpa      , Aa^Fpa      , Aa^Fpa      , Aa^Fpa      , Gs^Fp       , Gs^Fp       , Gs^Fp       , Gg          , Gg          , Gg          , Gs^Fp       , Wo          , Wo          , Ai          , Ha          , Mm          , Mm^Xm       , Mm^Xm       , Mm          , Hh          , Gs^Fp       , Gs^Fp       , Ce          , 1 Ke        , Ce          , Gg          , Gg          , Gg          
Mm          , Mm          , Mm          , Aa^Vha      , Ha          , Ha          , Ha          , Ha          , Ha          , Aa^Fpa      , Ha          , Aa^Vha      , Ha          , Aa^Fpa      , Aa^Fpa      , Aa          , Gg^Vc       , Gg          , Gs^Fp       , Gs^Fp       , Gg          , Wo          , Wo          , Ha          , Mm          , Mm^Xm       , Mm^Xm       , Mm          , Mm          , Hh          , Gg          , Ce          , Ce          , Ce          , Gg          , Gg          , Gg          
Mm          , Mm          , Mm^Xm       , Mm          , Mm          , Ha          , Ha          , Ha          , Ha          , Ha          , Ha          , Ha          , Ha          , Ha          , Ha          , Hh          , Hh          , Gs^Fp       , Gs^Fp       , Gs^Fp       , Gg          , Gg          , Wo          , Ha          , Mm          , Mm^Xm       , Mm^Xm       , Mm          , Mm          , Hh          , Gs^Fp       , Gg          , Gg          , Gg          , Hh          , Gg          , Gg          
Mm^Xm       , Mm^Xm       , Mm^Xm       , Mm          , Mm          , Mm          , Mm          , Ha          , Mm          , Ha          , Ha          , Ha          , Mm          , Mm          , Mm          , Hh          , Hh          , Hh          , Hh          , Gs^Fp       , Gs^Fp       , Gg          , Wo          , Ha          , Ha          , Mm          , Mm          , Mm^Xm       , Mm^Xm       , Mm          , Hh          , Gg          , Gg          , Gg          , Mm          , Mm          , Mm          
Mm          , Mm          , Mm^Xm       , Mm          , Mm^Xm       , Mm          , Mm          , Mm          , Mm          , Mm          , Mm          , Mm          , Mm          , Mm          , Mm          , Hh          , Hh          , Gs^Fp       , Hh          , Aa          , Gs^Fp       , Gg          , Gg          , Wo          , Wo          , Mm          , Mm          , Mm          , Mm^Xm       , Mm          , Mm          , Gg          , Ha          , Gg          , Ha          , Mm          , Mm          
Mm          , Mm          , Mm          , Mm^Xm       , Mm^Xm       , Mm^Xm       , Mm^Xm       , Mm          , Mm          , Mm^Xm       , Mm          , Mm          , Mm          , Mm          , Mm          , Hh          , Hh          , Hh          , Gs^Fp       , Gs^Fp       , Ce          , Ce          , Ce          , Gs^Fp       , Gs^Fp       , Wo          , Mm          , Mm          , Mm          , Mm          , Mm          , Ha          , Ha          , Ha          , Ha          , Mm          , Mm          
Mm^Xm       , Mm^Xm       , Mm^Xm       , Mm^Xm       , Mm^Xm       , Mm^Xm       , Mm^Xm       , Mm^Xm       , Mm^Xm       , Mm          , Mm          , Mm          , Mm          , Mm          , Hh^Vhh      , Hh          , Gs^Fp       , Hh          , Gs^Fp       , Gs^Fp       , Ce          , 2 Ke        , Ce          , Gs^Fp       , Gs^Fp       , Wo          , Mm          , Mm^Xm       , Mm^Xm       , Mm          , Mm          , Mm          , Mm          , Ha          , Ha          , Mm          , Mm          
Mm^Xm       , Mm^Xm       , Mm^Xm       , Mm          , Mm^Xm       , Mm^Xm       , Mm^Xm       , Mm^Xm       , Mm          , Mm^Xm       , Mm^Xm       , Mm          , Mm          , Mm          , Hh          , Hh          , Hh          , Gs^Fp       , Hh          , Gs^Fp       , Gs^Fp       , Ce          , Gg^Vc       , Gs^Fp       , Gs^Fp       , Wo          , Mm          , Mm          , Mm          , Mm^Xm       , Mm^Xm       , Mm          , Mm          , Mm          , Mm          , Mm          , Mm          
Mm^Xm       , Mm^Xm       , Mm^Xm       , Mm^Xm       , Mm          , Mm^Xm       , Mm^Xm       , Mm^Xm       , Mm^Xm       , Mm^Xm       , Mm^Xm       , Mm          , Mm          , Mm          , Mm          , Hh^Vhh      , Hh          , Hh          , Hh          , Hh          , Hh          , Gs^Fp       , Gs^Fp       , Gs^Fp       , Gs^Fp       , Wo          , Mm          , Mm          , Mm          , Mm          , Mm          , Mm          , Mm          , Mm          , Mm          , Mm          , Mm          
Mm^Xm       , Mm^Xm       , Mm^Xm       , Mm^Xm       , Mm          , Mm^Xm       , Mm^Xm       , Mm^Xm       , Mm^Xm       , Mm^Xm       , Mm^Xm       , Mm          , Mm          , Mm          , Mm          , Hh          , Hh          , Hh          , Hh          , Hh          , Hh          , Gs^Fp       , Gs^Fp       , Gs^Fp       , Gs^Fp       , Wo          , Mm          , Mm          , Mm          , Mm          , Mm          , Mm          , Mm          , Mm          , Mm          , Mm          , Mm          
