Ms, Ms, Ms, Ms, Ms, Ms, Ms, Ms, Ms, Ms, Ms, Ms, Aa^Fpa, Aa^Fpa, Aa^Fpa, Aa^Fpa, Aa^Fma, Aa^Fpa, Aa^Fpa, Aa^Fpa, Aa^Fpa, Aa^Fpa, Ms, Ms, Aa, Aa, Aa, Aa, Ms, Ms, Ms, Ms, Ms
Ms, Ms, Ms, Ms, Ms, Ms, Ms, Ms, Ms, Ms, Ms, Ms, Ha^Fma, Ha^Fpa, Aa^Fpa, Aa^Fpa, Aa^Fma, Aa^Fpa, Aa, Aa^Fpa, Aa, Aa^Fpa, Ms, Ms, Aa, Aa, Aa, Aa, Ms, Ms, Ms, Ms, Ms
Ms, Ms, Ms, Ms, Ms, Ms, Ha, Ha, Aa, Ms, Ms, Aa^Fpa, Aa^Fpa, Ha^Fpa, Aa, Aa, Aa, Aa, Aa, Aa, Aa, Aa, Ha^Voa, Aa, Aa, Aa, Aa, Aa, Aa, Aa, Aa, Ms, Ms
Ms, Ms, Ms, Ms, Ms, Ms, Ms, Aa, Aa, Ha, Ha, Aa^Fpa, Aa^Fpa, Aa^Fpa, Aa, Aa, Aa, Aa, Aa, Aa, Aa, Aa, Aa, Aa, Aa, Aa, Aa, Aa, Aa, Aa, Aa, Ms, Ms
Ms, Ms, Ms, Ms, Aa, Aa, Aa, Aa, Aa, Aa, Ha^Fpa, Ha^Fma, Ha^Fpa, Aa, Aa, Aa, Aa, Aa, Aa, Aa, Aa, Aa, Aa, Rd^Esa, Coa, Rd^Esa, Rd^Esa, Rd^Esa, Rd^Esa, Aa, Rd^Esa, Aa, Aa
Ms, Ms, Ms, Ms, Aa, Aa, Aa, Aa, Aa, Aa, Ha, Ha^Fpa, Ha, Aa, Aa, Aa, Aa, Aa, Rd^Esa, Rd^Esa, Rd^Esa, Rd^Esa, Rd^Esa, Coa, 2 Koa, Coa, Rd^Esa, Aa, Aa, Rd^Esa, Aa, Rd^Esa, Rd^Esa
Aa, Aa, Aa, Aa, Aa, Aa^Esa, Aa, Aa, Aa, Aa, Aa, Ha^Voa, Rd^Edt, Rd^Esa, Rd^Esa, Rd^Esa, Aa, Aa, Aa, Aa, Aa, Aa, Aa, Coa, Coa, Coa, Rd^Esa, Aa, Ha, Aa, Aa, Aa, Aa
Aa, Aa, Aa^Esa, Aa^Esa, Aa^Esa, Aa^Esa, Aa, Aa, Aa^Esa, Aa^Esa, Aa, Aa^Edt, Aa, Aa, Aa, Aa, Aa, Aa, Aa, Aa^Fpa, Aa^Fpa, Aa, Aa, Aa^Voa, Rd^Esa, Rd^Esa, Aa, Aa, Ha, Ha, Ha^Fpa, Aa, Aa
Aa, Aa, Aa, Aa, Aa, Aa, Aa, Aa, Aa^Esa, Aa, Aa, Aa, Aa, Aa, Aa, Aa, Rd^Esa, Aa, Aa, Aa^Fma, Aa^Fma, Aa^Fpa, Aa, Aa, Aa, Rd^Esa, Aa, Aa, Aa^Fpa, Aa^Fpa, Aa^Fpa, Ha^Fpa, Ha^Fpa
Aa, Aa, Aa, Aa, Aa^Esa, Aa^Esa, Aa^Esa, Aa^Esa, Aa, Aa, Aa, Aa, Aa^Esa, Aa^Esa, Aa, Aa, Rd^Esa, Aa, Aa^Fpa, Aa, Aa, Aa^Fpa, Aa, Aa, Aa, Aa, Aa, Ha^Fpa, Aa^Vea, Aa^Fet, Aa^Fpa, Ha, Ha
Aa, Aa, Aa, Aa, Aa, Aa, Aa, Aa, Aa, Aa, Aa, Aa, Aa^Esa, Aa, Aa, Aa, Aa, Rd^Esa, Aa^Voa, Aa^Fpa, Aa, Aa, Aa, Aa, Aa, Aa, Ha, Ha^Fpa, Aa^Fpa, Aa^Fpa, Ms, Ms, Ms
Aa^Esa, Aa^Esa, Aa^Esa, Aa, Aa, Aa, Aa^Esa, Aa, Aa^Esa, Aa, Aa, Aa^Esa, Aa, Aa, Aa^Esa, Aa, Aa, Aa, Aa, Aa^Edt, Rd^Esa, Aa, Aa, Aa, Ms, Ms, Ms, Aa^Fpa, Ms, Ms, Ms, Ms, Ms
Aa^Esa, Aa^Esa, Aa, Aa, Aa, Aa^Esa, Aa, Aa^Esa, Aa, Aa, Aa, Aa, Aa, Aa, Aa^Esa, Aa, Aa, Aa, Ha, Aa, Aa, Rd^Esa, Aa, Aa, Aa, Ms, Aa^Fpa, Ms, Ms, Ms, Aa, Ms, Ms
Aa, Aa^Esa, Aa, Aa, Aa, Aa, Aa, Aa, Aa, Aa, Aa, Aa, Aa^Esa, Aa^Esa, Aa, Aa, Aa, Aa, Ha^Fpa, Aa, Aa, Rd^Esa, Rd^Esa, Aa, Aa, Ms, Aa^Fpa, Aa^Fpa, Ha^Fpa, Ms, Aa, Aa, Aa
Aa, Aa, Aa, Aa, Ha, Aa, Aa^Voa, Aa, Aa, Aa, Aa, Aa, Aa^Esa, Aa, Aa, Aa, Aa, Aa, Aa^Fpa, Aa^Fma, Aa, Aa, Rd^Esa, Aa, Aa, Aa^Fpa, Aa, Aa^Fpa, Ha^Fpa, Ha, Aa^Fpa, Aa, Aa
Aa, Aa, Ha, Aa, Ha, Ha, Ha, Aa^Edt, Aa, Aa, Aa, Aa, Aa, Aa, Aa, Aa, Aa^Edt, Aa, Aa^Fpa, Aa^Fpa, Aa, Aa, Aa, Aa, Aa, Aa, Aa, Aa^Fpa, Ms, Aa^Fpa, Aa^Fpa, Aa, Aa
Aa, Aa, Aa, Ms, Ms, Ha, Ha, Aa, Aa, Rd^Esa, Rd^Esa, Aa, Aa, Aa, Aa^Fpa, Ha, Aa^Edt, Aa^Edt, Aa^Edt, Ha, Aa^Fpa, Aa, Aa^Voa, Aa, Aa, Aa, Aa, Ms, Ms, Aa, Aa, Aa, Aa
Aa, Aa, Aa, Ha, Ms, Ms, Ms, Aa, Aa, Aa, Rd^Esa, Aa, Aa, Aa, Aa^Fpa, Ha^Fpa, Ha, Coa^Ecf, Ha, Ha, Aa, Aa^Edt, Aa^Edt, Aa, Aa, Aa, Aa, Aa, Aa, Aa, Aa^Esa, Aa^Esa, Aa
Aa, Aa, Aa, Aa, Ha, Ms, Ms, Aa, Aa, Aa, Rd^Esa, Aa, Aa, Aa, Aa, Ha, Aa^Fpa, Ha, Aa, Aa, Aa, Aa, Rd^Esa, Aa, Aa, Aa, Aa^Esa, Aa, Aa, Aa^Esa, Aa, Aa, Aa
Aa, Aa, Ms, Ha, Ms, Ms, Ms, Ha, Aa, Aa, Aa, Rd^Esa, Aa, Aa, Aa, Aa^Fpa, Aa, Ha^Fpa, Aa, Aa, Aa, Aa, Rd^Esa, Aa, Aa, Aa^Esa, Aa, Aa, Aa, Aa^Esa, Aa^Esa, Aa, Aa
Aa, Aa, Aa, Ha, Ms, Ms, Ai, Wwrg, Wwrg, Aa, Aa, Aa, Aa, Aa^Voa, Rd^Edt, Aa, Aa, Aa, Aa, Aa, Aa, Aa, Aa, Rd^Esa, Aa, Aa^Esa, Aa^Esa, Aa, Aa, Aa, Aa^Esa, Aa, Aa
Aa, Aa, Ha, Ha, Ms, Ai, Ha, Wwrg, Ha, Aa, Aa, Aa, Aa, Aa, Rd^Esa, Aa, Rd^Esa, Aa, Aa, Aa, Rd^Esa, Aa, Rd^Esa, Rd^Esa, Rd^Esa, Aa, Aa^Esa, Aa, Aa, Aa, Aa, Aa^Esa, Aa
Aa, Aa, Ha, Ms, Ai, Ai, Ms, Ms, Ha, Aa, Aa, Rd^Esa, Aa, Aa, Aa, Rd^Esa, Aa, Rd^Esa, Aa, Aa, Aa^Edt, Rd^Esa, Aa, Rd^Esa, Aa, Aa, Aa, Aa, Aa, Aa, Aa, Aa^Esa, Aa
Ms, Ms, Ms, Ms, Ai, Ms, Ha, Ha, Aa^Edt, Aa, Rd^Esa, Rd^Esa, Aa, Aa, Aa, Aa, Aa, Aa, Aa, Aa^Voa, Aa^Edt, Aa^Edt, Aa, Rd^Esa, Aa, Aa, Aa, Aa, Aa, Aa, Aa, Aa, Aa
Ms, Ms, Wwrg, Ai, Ms, Ai, Wwg, Aa^Voa, Ha, Aa, Aa, Aa, Aa, Aa, Aa, Aa, Aa, Aa^Fpa, Aa^Fda, Aa^Fma, Aa^Fda, Aa, Ha, Aa, Aa, Aa^Voa, Rd^Edt, Aa, Aa, Ha, Ha, Ha, Aa
Ha, Ha, Ms, Ms, Ms, Ha, Ha, Ha, Ha, Aa, Aa, Aa, Rd^Esa, Aa, Aa, Aa, Aa^Fpa, Ha, Ha, Ha, Ha, Ha, Aa^Fda, Aa^Fma, Aa, Aa, Rd^Esa, Aa, Aa, Ha, Ha, Ha, Ha
Ms, Ms, Ms, Ms, Ms, Ms, Ms, Ms, Aa^Fpa, Ha, Aa, Aa, Rd^Esa, Aa, Aa, Aa^Fpa, Ha, Aa^Fma, Ha, Ha, Aa^Fda, Ha, Ha, Aa^Fma, Aa, Rd^Esa, Aa, Aa, Ha, Ha, Ms, Ha, Ha
Ms, Ms, Ms, Ms, Wwrg, Ms, Ms, Aa^Fpa, Aa^Fpa, Aa^Fma, Ha, Aa, Rd^Esa, Rd^Esa, Aa, Aa^Fpa, Ha, Ha, Aa^Fda, Aa, Aa, Aa, Aa, Aa, Rd^Esa, Rd^Esa, Aa, Ha, Ms, Ms, Ha, Ha, Ha
Ms, Ms, Ms, Ha, Ai, Ms, Ms, Ms, Ms, Ms, Ha, Aa, Aa, Rd^Esa, Aa, Aa, Ha, Ha, Ha, Aa, Aa, Aa, Aa, Aa, Aa, Aa, Ha, Ha, Ms, Ms, Ms, Ha, Ha
Ms, Ms, Ha, Ms, Ai, Ai, Ai, Ms, Ha^Fma, Ha^Fpa, Aa, Aa, Aa, Aa, Aa, Aa, Aa, Aa, Aa, Aa, Aa, Aa, Aa, Aa^Vca, Aa^Fma, Aa, Ha, Ms, Ms, Ms, Ms, Ms, Ms
Ms, Ms, Aa^Fpa, Ha, Ms, Ha^Fpa, Ai, Ai, Ai, Aa^Fpa, Aa, Aa, Aa, Aa, Aa, Aa, Aa, Aa, Aa, Aa, Rd^Esa, Rd^Esa, Aa, Aa, Aa^Fma, Ha^Fpa, Ha^Fma, Ms, Ms, Ms, Ms, Ms, Ms
Ms, Ms, Aa^Fpa, Ms, Ha, Aa^Fpa, Aa^Fpa, Aa^Fpa, Aa^Fpa, Aa, Rd^Esa, Rd^Esa, Rd^Esa, Rd^Esa, Aa, Aa, Aa, Aa, Aa, Aa, Rd^Esa, Aa, Aa, Aa^Fma, Aa^Fpa, Ha^Fma, Ms, Ms, Ms, Ms, Ms, Ms, Ms
Ms, Ms, Ms, Ms, Ha, Ms, Ha, Aa^Vla, Aa, Aa, Cea, Cea, Cea, Rd^Esa, Rd^Esa, Aa, Rd^Edt, Aa, Aa, Rd^Esa, Aa, Aa, Ai, Aa, Aa^Fma, Aa^Fpa, Aa^Fpa, Ms, Ms, Wwrg, Aa, Ms, Ms
Ms, Ms, Ms, Ms, Ms, Ms, Ha, Aa, Aa, Aa, Cea, 1 Kea, Cea, Rd^Esa, Aa, Rd^Esa, Aa, Aa^Voa, Aa, Aa, Aa, Aa, Ai, Ai, Ai, Ai, Ai, Aa^Fma, Wwg, Wwrg, Ai, Ai, Aa
Ms, Ms, Ms, Ms, Ms, Ha, Aa, Aa, Ha, Ha, Ha, Cea, Aa, Rd^Esa, Aa, Aa, Aa, Aa, Aa, Aa, Aa, Ai, Ai, Ai, Ai, Ai, Wog, Wog, Wog, Ai, Ai, Ai, Ai
Ha, Ha, Ha, Ms, Ha, Ha, Ha, Ha, Ms, Ms, Ms, Ha, Ha, Aa, Aa, Aa, Ha, Aa, Ha, Ha, Wwg, Wwg, Wwg, Wwg, Aa, Ai, Ai, Ai, Ai, Ai, Ai, Ai, Ai
Ha, Ha, Ha, Ha, Ha^Voa, Ha, Ms, Ms, Ms, Ms, Ms, Ms, Ha, Ha^Vca, Ha, Ha, Ms, Ms, Ms, Ha, Wwrg, Ai, Ha, Aa, Ha, Ha, Ms, Aa, Wwg, Wwg, Ms, Ms, Ms
Ms, Ms, Ms, Ha, Ha, Ha, Ms, Ms, Ms, Ms, Ms, Ms, Ms, Ha, Ha, Ms, Ms, Ms, Ms, Ms, Ms, Ms, Ms, Ha, Ms, Ms, Ms, Ms, Ms, Ms, Ms, Ms, Ms
Ms, Ms, Ms, Ms, Ms, Ms, Ms, Ms, Ms, Ms, Ms, Ms, Ms, Ms, Ms, Ms, Ms, Ms, Ms, Ms, Ms, Ms, Ms, Ms, Ms, Ms, Ms, Ms, Ms, Ms, Ms, Ms, Ms
Ms, Ms, Ms, Ms, Ms, Ms, Ms, Ms, Ms, Ms, Ms, Ms, Ms, Ms, Ms, Ms, Ms, Ms, Ms, Ms, Ms, Ms, Ms, Ms, Ms, Ms, Ms, Ms, Ms, Ms, Ms, Ms, Ms
