Gll^Fmf, Gd, Gd, Gd, Gd, Mm^Xm, Mm^Xm, Mm^Xm, Mm^Xm, Mm^Xm, Mm^Xm, Mm^Xm, Mm^Xm, Mm^Xm, Mm^Xm, Mm^Xm, Mm^Xm, Mm^Xm, Mm^Xm, Mm^Xm, Mm^Xm, Mm^Xm, Mm^Xm, Mm^Xm, Mm^Xm, Mm^Xm, Mm^Xm, Mm^Xm, Mm^Xm, Mm^Xm, Mm^Xm, Mm^Xm, Mm^Xm, Mm^Xm, Mm^Xm, Mm^Xm, Mm^Xm, Mm^Xm, Mm^Xm, Mm^Xm, Hh, Hh, Hh, Gs, Gs, Gs
Gll^Fmf, Gd^Fmf, Gd^Fp, Gd, Gd, Mm^Xm, Mm^Xm, Mm^Xm, Mm^Xm, Mm^Xm, Mm^Xm, Mm^Xm, Mm^Xm, Mm^Xm, Mm^Xm, Mm^Xm, Mm^Xm, Mm^Xm, Mm^Xm, Mm^Xm, Mm^Xm, Mm^Xm, Mm^Xm, Mm^Xm, Mm^Xm, Mm^Xm, Mm^Xm, Mm^Xm, Mm^Xm, Mm^Xm, Mm^Xm, Mm^Xm, Mm^Xm, Mm^Xm, Mm^Xm, Mm^Xm, Mm^Xm, Mm^Xm, Mm^Xm, Mm^Xm, Hh, Hh, Gs, Gs, Gs, Gs
Gd^Fmf, Gd^Fp, Gd^Fp, Gd^Fp, Gd, Gd, Gd, Gd, Hh, Hh, Mm, Mm, Mm, Mm, Mm, Mm, Mm, Mm, Mm, Mm^Xm, Mm^Xm, Mm^Xm, Mm^Xm, Mm^Xm, Mm^Xm, Mm^Xm, Mm, Mm, Mm, Mm, Mm, Mm, Mm, Mm, Mm, Hh, Hh, Hh, Hh, Hh, Gs, Gs, Gs, Gs, Gs, Gs
Gll^Fdf, Gd^Fmf, Gll^Fdf, Gd^Fmf, Gd, Gd, Hh, Hh, Mm, Mm, Mm, Mm, Mm, Mm, Mm, Mm, Mm, Mm, Mm, Mm, Mm, Mm^Xm, Mm^Xm, Mm^Xm, Mm, Mm, Mm, Mm, Mm, Mm, Mm, Mm, Mm, Mm, Mm, Mm, Mm, Hh, Gs, Gs, Gs, Gs, Gs, Gs, Gs, Gs
Gll^Fmf, Gll^Fmf, Gd, Gd, Gd, Gs, Mm, Mm, Mm, Mm, Mm, Hh, Hh, Mm, Mm, Mm, Mm, Mm, Mm, Mm, Mm, Mm, Mm, Mm, Mm, Mm, Mm, Mm, Mm, Mm, Mm, Mm, Mm, Mm, Mm, Mm, Mm, Mm, Gs, Gs, Gs, Gs, Gs, Gs, Gs, Gs
Gs, Gll^Fdf, Gd, Gs, Gs, Mm, Mm, Mm, Mm, Hh, Hh, Hh, Mm, Mm, Mm, Mm, Mm, Mm, Mm, Mm, Mm, Mm, Mm, Mm, Mm, Mm, Mm, Mm, Mm, Mm, Mm, Mm, Mm, Mm, Mm, Mm, Mm, Mm, Gs, Gs, Gs, Gs, Gs, Gs, Gs, Gs
Gs, Gs, Gd, Gd, Gd, Mm, Gll^Fdf, Mm, Hh, Hh, Mm, Mm, Mm, Mm, Mm, Mm, Mm, Mm, Mm, Mm, Mm, Mm, Mm, Mm, Mm, Mm, Gs, Mm, Gs, Mm, Mm, Mm, Mm^Vc, Mm, Mm, Mm, Mm, Mm, Mm, Gs, Gs, Gs, Gs, Gs, Gs, Gs
Gd, Gd, Gs, Gs, Mm, Mm, Mm, Mm, Mm, Mm, Mm, Mm, Mm, Mm, Mm, Mm, Gs, Gs^Edt, Gs^Edt, Gs, Gs, Hh, Hh, Mm, Hh, Hh, Gs^Fdf, Gs, Gs^Fdf, Gs, Gs, Mm, Mm, Mm, Mm, Mm, Mm, Mm, Mm, Gs, Gs, Gs, Gs, Gs, Gs, Gs
Gs, Gd, Gs, Gs, Gs, Mm, Hh, Hh, Mm, Mm, Mm, Mm, Gs, Mm, Gs, Mm, Wwg, Gs^Edt, Gs, Gs, Wwg, Hh^Fdf, Hh^Fdf, Hh, Hh^Fdf, Gs^Fdf, Wwg, Gs^Fdf, Gs^Fdf, Gs^Fdf, Gs, Gs, Mm, Mm, Mm, Mm, Mm, Mm, Mm, Hh, Gs, Gs, Gs, Gs, Gs, Gs
Gd, Gd, Gs, Gs, Hh, Mm, Mm, Mm, Mm, Mm, Mm, Gs, Gs, Gs, Gs, Gs, Gg^Fdf, Wwg, Wwg, Wwg, Wwg, Wwg, Wwg, Wwg, Wwg, Wwg, Gg^Efm, Gll^Fdf, Gll^Fdf, Gll^Fdf, Gll^Fdf, Gs, Mm, Mm, Mm, Mm, Mm, Mm, Mm, Hh, Hh, Gs, Gd, Gs, Gs, Gs
Gd, Gs, Gs, Gs, Hh, Hh, Mm, Mm, Mm, Mm, Hh, Gs, Gll^Gvs, Gll^Gvs, Gs, Gs, Gg^Fdf, Ds, Ds, Wwg, Gs, Wwg, Gs^Vc, Wwg, Gs, Gg, Gg, Gs, Gll^Fdf, Gll^Fdf, Gs, Gll^Fdf, Gs, Mm, Mm, Mm, Mm, Mm, Mm, Mm, Hh, Gs, Gd, Gd, Gd, Gs
Gs, Gs, Gs, Gs, Hh, Mm, Mm, Mm, Mm, Hh, Hh, Gs, Gll, Gll, Gs, Gs, Gg^Fdf, Gg^Fdf, Gs, Gs, Gs, Gs, Gs, Gs, Gll, Gg, Gs, Gs, Gll^Fdf, Gll^Fdf, Gs, Gs, Gs, Mm, Mm, Mm, Mm, Mm, Mm, Mm, Mm, Gd, Gs, Gs, Gd, Gs
Gs, Gs, Gd, Gs, Mm, Mm, Mm, Mm, Mm, Hh, Hh, Hh, Gs, Gll^Edb, Gll^Edb, Gll^Edb, Gs, Gs^Edt, Gll, Gg, Gs, Gg, Gll, Gll^Edb, Gll, Gg, Gs, Gs, Gs, Gs, Gll^Edt, Gs, Gs, Mm, Mm, Mm, Mm, Mm, Mm, Mm, Mm, Gd, Gs, Gd, Gd, Gs
Gd, Gs, Gd, Gd, Gs, Mm, Mm, Mm^Vc, Mm, Mm, Hh, Hh, Hh, Gs, Gll^Edb, Gs, Gs, Gs, Gs, Gll, Gll, Gll^Edb, Gll, Gll, Gs, Gs, Gs, Gs, Gs, Gs, Gs, Gs, Gll^Gvs, Hh, Hh, Hh^Fdf, Mm, Mm, Mm, Mm, Mm, Gd, Gd, Gd, Gd, Gs
Gs, Gd, Gs, Gd, Gs, Mm, Mm, Mm, Mm, Mm, Hh, Hh, Hh, Gs, Gll, Gll, Gs, Gll^Fdf, Gg, Gs, Gll, Gll, Gll, Gll, Gll^Edb, Gg, Gs, Gs, Gll^Fdf, Gll^Fdf, Gs, Gs, Gs, Hh, Wwg, Hh^Fdf, Mm, Mm, Mm, Mm, Mm, Gs, Gs, Gd, Gd, Gd
Gs, Gs, Gs, Gs, Gs, Hh, Mm, Mm, Mm, Mm, Mm, Hh, Hh, Gs, Gs, Gs, Gll^Fdf, Gll^Fdf, Gll, Gll^Edb, Gg, Gll^Edt, Gg, Gs, Gg, Gll, Gll, Gs, Gs, Gs, Gs, Gs, Gs, Wwg, Wwg, Wwg, Mm, Mm, Mm, Mm, Mm, Gs, Gs, Gs, Gd, Gd
Gd, Gs, Gs, Gs, Gs, Gd, Gd, Hh, Hh, Mm, Hh, Gs^Edb, Gs, Gs, Gs, Gll^Fdf, Gll^Fdf, Gs, Gg, Gg, Gs, Gg, Gs, Gg, Gs, Gs, Gll^Fdf, Gs, Gll^Fdf, Gs, Gll^Gvs, Gll^Gvs, Gs, Gs, Hh, Mm, Mm, Mm, Mm, Mm, Gs, Gs, Gs, Gd, Gd, Gd
Gs, Gd, Gd, Gs, Hh, Gs, Hh, Gd, Gs, Hh, Hh, Gs^Edb, Hh, Gs, Hh, Gs, Gs, Gll^Fdf, Gs, Gs, Gs, Gs, Gs, Gs, Gs, Gs, Hh, Hh^Fdf, Hh, Gll^Fdf, Gs, Gs, Gs, Hh, Hh, Hh, Hh, Mm, Mm, Mm, Gs, Gs, Gd, Gd, Gs, Gs
Gs, Gd, Gd, Gs, Gs, Hh, Hh, Gs, Gs, Hh, Hh, Hh, Hh, Hh, Mm, Hh, Hh, Gs, Mm, Gs, Gs, Gs, Hh, Hh, Hh, Hh, Mm, Hh, Mm, Hh, Mm, Mm, Mm, Hh, Hh, Hh, Hh, Hh, Gs, Gs, Gs, Gs, Gs, Gd, Gs, Gs
Gd, Gd, Gd, Gs, Gs, Gs, Hh, Hh, Gd, Hh, Hh, Hh, Mm, Mm, Mm, Hh, Mm, Mm, Hh, Hh, Ce, Ce, Ce, Hh, Mm, Mm, Mm, Mm, Mm, Mm, Mm, Mm, Mm, Mm, Mm, Hh, Gs, Gs, Gs, Gs, Gd, Gd, Gd, Gd, Gs, Gs
Gs, Gs, Gd, Gd, Gs, Gs, Hh, Hh, Hh, Gs, Gs, Mm, Mm, Mm, Mm, Mm, Mm, Hh, Mm, Hh, Ce, 1 Ke, Ce, Mm, Gs, Mm, Gs, Mm, Mm, Mm, Mm, Mm, Mm, Mm, Gs, Gd, Gd, Gs, Gd, Gd, Gs, Gs, Gs, Gs, Gs, Gs
Gs, Gd, Gs, Gs, Gs, Gs, Gs, Gs, Gs, Hh, Gs, Gs, Gs, Mm, Gs, Mm, Mm, Gs, Gs, Gs, Gs, Gd, Re, Gs, Gs, Gs, Gs, Gs, Mm, Mm, Gs, Mm, Gs, Gs, Gs, Gs, Gd, Gd, Gs, Gd, Gs, Gd, Gd, Gs, Wwg, Wwg
Gs, Gd, Gd, Gd, Gd, Gs, Gs, Gs, Gs, Gs, Gs, Gs, Gd, Gs, Gs, Gs, Gs, Gs, Gd, Gd, Gs, Gs, Gs, Re, Gd, Gs, Gs, Gs, Gs, Gs, Gs, Gs, Gs, Gs, Gd, Gd, Gd, Gd, Gd, Gd, Gs, Gd, Wwg, Wwg, Wwg, Wwg
Gd, Gd, Gd, Gs, Gd, Gs, Gs, Gs, Gs, Gs, Gs, Gd, Gd, Gd, Gs, Gs, Gd, Gd, Gd, Gs, Gs, Gs, Gs, Gd, Gd, Gs, Gs, Gs, Gs, Gs, Gs, Gs, Gd, Gs, Gd, Re, Re, Re, Re, Gs, Wwg, Wwg, Wwg, Wwg, Gd, Gd
Gs, Gs, Gd, Gs, Gs, Gd, Gs, Gs, Gd, Gd, Gs, Gs, Gd, Gs, Gd, Gd, Gs, Gs, Gs, Gs, Gs, Gs, Gd, Gs, Gs, Gd, Gd, Gs, Gd, Gd, Gd, Gd, Gs, Gs, Gd, Gd, Gs, Gs, Gd, Gd, Wwg^Bw\r, Wwg, Wwg, Gs, Gs, Gd
Gd, Gd, Gd, Gs, Gs, Gd, Gd, Gd, Gs, Gs, Gs, Gs, Gs, Gd, Gs, Gd, Gd, Gs, Gd, Gd, Gd, Gd, Gs, Gs, Gs, Gs, Gs, Gd, Gs, Gd, Gs, Gs, Gs, Gd, Gs, Gs, Gs, Gs, Wwg, Wwg, Wwg, Wwg^Bw\r, Gd, Gd, Gs, Gs
