Ha, Ha, Ha, Ha, Ms, Ms, Ms, Ms, Ms, Ms, Ha, Ha, Aa, Aa, Aa, Gll^Fp, Aa^Fp, Aa^Fp, Ha^Fp, Ha^Fp, Ms, Ms, Ms, Ms, Ms, Ms, Ms, Ms, Ms, Ms, Ha, Ha, Ha
Ha, Ha, Ha, Ha, Ms, Ms, Ms, Ms, Ms, Ms, Ha, Ha, Aa, Aa, Ha, Gs, Aa^Vc, Aa, Ha, Ha^Fp, Ms, Ms, Ms, Ms, Ms, Ms, Ms^Vc, Ms, Ms, Ms, Ha^Vc, Ha, Hh
Aa, Aa, Aa, Ha, Ha, Ms, Ha, Ha, Ha, Ha, Aa, Ha, Gs^Vc, Gs, Ha, Hh, Aa^Es, Aa, Aa, Ha, Ha, Ms, Ms, Ms, Ms, Ms, Ha, Ha, Ce, Ce, Ce, Hh, Hh
Ha, Ha, Ha, Ha, Ha, Ha, Aa^Es, Aa, Aa, Ha, Hh, Gs, Hh, Aa, Hh, Hh, Gs, Aa, Gs, Hh, Hh, Ha, Ha, Ms, Ha, Ha, Ha, Aa, Ce, 2 Ke, Ce, Aa^Vc, Aa
Ms, Ms, Ms, Ha, Ha, Aa, Aa, Aa, Aa, Gs, Mm, Hh, Hh, Gll, Gs, Gd, Gd, Gg, Ce, Ce, Ce, Ha, Gll^Fp, Hh, Hh, Ha, Re, Re, Aa, Ce, Ha, Re, Re
Ms, Ms, Ms, Ms, Ms, Ha, Aa, Aa, Ha, Mm, Mm, Mm, Hh, Gll^Fp, Gll^Fp, Gs, Ce, Ce, 1 Ke, Ce, Ce, Gs, Gs, Gll, Re, Re, Gs^Vc, Aa, Ha, Ha, Ha^Vc, Ha, Ha
Ms, Ms, Ms, Ms, Ha, Ha, Gs, Gs^Vc, Mm, Mm, Mm, Mm, Hh, Gll^Fp, Gs^Efm, Gs, Ce, Ce, Ce, Ce, Re, Re, Re, Re^Vc, Gs^Es, Gg, Aa, Ha, Ha, Ha, Ms, Ms, Ms
Ms, Ms, Ms, Ms, Ha, Gs^Vc, Aa, Ha, Mm, Mm, Mm, Mm, Ha, Gll, Aa, Gs, Gs, Ce, Re, Re, Gs, Aa, Gs, Gs, Aa, Aa, Ha, Ha, Ha, Ha, Ha, Ms, Ms
Ms, Ms, Hh^Vc, Ha, Ce, Ce, Ce, Hh, Ha, Mm, Ha, Ha, Gs, Aa, Aa, Gd, Re, Re, Gs, Gg^Es, Gg^Vc, Aa, Ha, Ha, Ha, Aa, Ms, Ms, Ms, Ha, Ms, Ms, Ms
Hh^Fp, Ha, Ha, Ha, Ce, 3 Ke, Ce, Re, Hh^Vc, Hh, Gs, Gs, Re, Gs^Vc, Re, Re, Gs, Gs, Gs^Fp, Gs, Aa, Ha, Ha, Ha, Ms, Ms, Ha, Ms, Ha, Ha, Ha, Ms, Ms
Gll^Fp, Gll, Gs^Vc, Gs, Re, Ce, Re, Re, Gs, Gs, Re, Gg, Gs, Re, Gll, Gll, Gs, Hh, Gs, Gs, Hh, Aa, Ha, Ha^Vc, Ha, Ha^Vc, Ms, Ha, Ms, Ms, Ha, Ms, Ms
Gll^Fp, Gll, Re, Re, Hh, Hh, Hh, Re, Gs, Gd, Aa, Gs^Es, Re, Re, Gll^Fp, Gll^Fp, Gll, Hh, Gs, Hh, Gs, Gg, Ha, Ms, Ha, Ms, Ha, Ms, Ms, Ms, Ha, Ms, Ms
Gs^Fp, Gll^Fp, Gll, Re, Hh, Hh, Hh, Gg, Gs^Vc, Aa, Gs, Re, Gs, Gll, Gll^Fp, Gs^Fp, Re, Hh, Gs, Gs, Ce, Ce, Ce, Ms, Ms, Ha, Ha, Ha, Ms, Ha, Ms, Ms, Ms
Gll, Gll^Fp, Gll, Hh, Gs^Vc, Hh, Gg, Gs, Gs^Eff, Gg, Re, Re, Aa, Gll^Fp, Gll^Fp, Gll, Hh, Re, Gs, Gg, Ce, 4 Ke, Ce, Ms, Ha, Ha, Ha, Ha, Aa, Ha, Ha, Ms, Ms
Aa, Aa, Aa, Aa, Gs, Gs^Es, Gs, Gd, Gg^Eff, Gs^Eff, Re, Aa, Aa, Gs, Gg, Gs, Gd, Gs^Vc, Gs, Hh, Hh^Vc, Ce, Gs, Ha, Gs, Aa, Aa, Aa, Aa, Ha, Ha, Ha, Ha
Ai, Ai, Ai, Aa, Aa, Gs, Gg, Gs, Re, Re, Gs, Gs, Gg, Gs, Aa, Gs, Gs, Gs, Gs, Hh, Hh, Hh, Gs, Gg, Gs^Vc, Gs, Gg, Gd, Aa, Aa, Aa, Gs, Ha
Wog, Ai, Ai, Aa, Wog, Wwg, Wwg, Gs, Wwg^Bw|, Gs, Wwg, Wwg, Wwg, Wwg, Wwg, Gs, Wwg, Gg, Wwg, Gg, Gs, Hh, Gd, Gd, Gg, Gg^Es, Gs, Aa, Gs, Aa^Es, Gd, Ha, Ha
Wog, Ai, Ai, Wog, Wog, Wog, Wog, Wwg, Wwg^Bw|, Wwg, Wog, Wog, Ai, Ai, Wog, Wog, Wog, Wog, Wog, Wwg, Wwg, Gs, Wwg, Gs, Wwg, Gs, Wwg, Aa, Aa, Gs, Aa, Gs, Aa
Wog, Wog, Wog, Wog, Wog, Wog, Wog, Wog, Wog^Bw|, Wog, Wog, Wog, Wog, Ai, Wog, Wog, Wog, Wog, Wog, Wog, Wog, Wwg, Wwg, Wwg, Wwg, Wwg, Wwg, Wwg, Ai, Aa, Aa, Aa, Aa
Wog, Wog, Wog, Wog, Wwg, Wog, Wwg, Wog, Wwg^Bw|, Wog, Wwg, Wog, Wwg, Wog, Wwg, Wog, Wog, Wog, Wog, Wog, Wog, Wog, Wog, Wog, Wog, Wog, Wog, Wwg, Wog, Ai, Ai, Ai, Ai
Wog, Wog, Wwg, Wwg, Ds, Wwg, Ds, Wwg, Re, Wwg, Ds, Wwg, Ds, Wwg, Ds, Wwg, Wwg, Wwg, Wwg, Wog, Wwg, Wog, Wog, Wog, Wog, Wog, Wog, Wog, Wog, Ai, Ai, Ai, Wog
Wwg, Wwg, Ds, Ds, Gs, Ds, Gs, Ds, Re, Ds, Gs, Ds, Ds, Ds, Ds, Ds, Ds, Ds, Ds, Wwg, Ds, Wwg, Wwg, Wwg, Wwg, Wog, Wwg, Wog, Wwg, Wog, Wog, Wog, Wog
Ds, Ds, Gg, Gd, Gs, Gs, Gs, Re, Gs, Gs, Gg, Gg, Gs, Gs, Gd^Es, Ds, Gs, Ds, Gs, Ds, Gs, Ds, Ds, Ds, Ds, Wwg, Ds, Wwg, Wwg, Wwg, Wog, Wog, Wog
Gs, Gs, Gs, Gs^Efm, Gs, Gd, Re, Re, Gs^Es, Gd, Gs, Gs, Gs, Gs, Gs, Gs, Gd, Gs, Gd^Efm, Gs, Gs, Gs, Gs, Gs, Gg, Ds, Gg, Ds, Ds, Wwg, Wwg, Wog, Wog
Gd, Gd^Es, Gs, Gg, Gd, Gs, Re, Gs, Gs, Gs, Gs, Gs, Gs, Gs, Gs, Gg, Gs, Gg, Gs, Gs, Gg, Gs, Gd, Gs, Gd, Gs, Gs, Ds, Wwg, Wwg, Wog, Wog, Wog
Gg, Gs, Gs, Gd, Gs, Gs, Re, Gs, Gs, Gs, Gs, Gs, Gd, Gs, Gd, Gd, Gs, Gs, Gd, Gs, Gd^Es, Gd^Es, Gg, Gs, Gg, Gs, Gd, Ds, Wwg, Wwg, Wog, Wog, Wog
