border_size=1
usage=map

Xos         , Xos         , Xos         , Xos         , Xos         , Xos         , Xos         , Xos         , Xos         , Xos         , Xos         , Xos         , Xos         , Xos         , Xos         , Xos         , Xos         , Xos         , Xos         , Xos         , Xos         , Xos         , Xos         , Xos         , Iwr         , Xos         , Xos         , Xos         , Xos         , Xos         , Xos         , Xos         
Xos         , Xos         , Xos         , Xos         , Xos         , Xos         , Xos         , Xos         , Xos         , Xos         , Xos         , Xos         , Xos         , Xos         , Xos         , Xos         , Xos         , Xos         , Xos         , Xos         , Xos         , Xos         , Xos         , Xos         , Iwr         , Xos         , Xos         , Xos         , Xos         , Xos         , Xos         , Xos         
Xos         , Xos         , Xos         , Xos         , Xos         , Xos         , Xos         , Xos         , Xos         , Xos         , Xos         , Xos         , Xos         , Xos         , Xos         , Xos         , Xos         , Xos         , Xos         , Xos         , Xos         , Xos         , Xos         , Xos         , Iwr         , Xos         , Xos         , Xos         , Xos         , Xos         , Xos         , Xos         
Xos         , Xos         , Sm          , Sm          , Sm          , Sm          , Sm          , Xos         , Sm          , Xos         , Uu^Uf       , Xos         , Xos         , Xos         , Xos         , Xos         , Xos         , Xos         , Xos         , Xos         , Xos         , Xos         , Xos         , Xos         , Iwr         , Xos         , Xos         , Xos         , Xos         , Xos         , Xos         , Xos         
Sm          , Xos         , Sm          , Xos         , Xos         , Xos         , Xos         , Sm          , Ww          , Sm          , Sm          , Xos         , Xos         , Xos         , Xos         , Xos         , Uu          , Xos         , Xos         , Xos         , Uu^Dr       , Xos         , Xos         , Xos         , Ur          , Xos         , Xos         , Xos         , Xos         , Xos         , Xos         , Xos         
Xos         , Sm          , Xos         , Xos         , Xos         , Xos         , Uu^Uf       , Sm          , Sm          , Ww          , Sm          , Xos         , Xos         , Xos         , Uu          , Uu          , Ur          , Uu          , Uu          , Xos         , Xos         , Uu          , Ur          , Ur          , Cud         , Ur          , Ur          , Xos         , Xos         , Xos         , Xos         , Xos         
Xos         , Xos         , Xos         , Xos         , Xos         , Xos         , Xos         , Sm          , Ww          , Ww          , Ww          , Sm          , Ur          , Xos         , Xos         , Ur^Dr       , Ur          , Ur          , Ur          , Ur          , Ur          , Ur          , Ur^Dr       , Cud         , 2 Kud       , Cud         , Ur          , Ur          , Ur          , Xos         , Xos         , Xos         
Xos         , Xos         , Xos         , Xos         , Xos         , Xos         , Xos         , Sm          , Ur          , Ww          , Uu          , Ur          , Uu          , Ur          , Ur          , Ur          , Xos         , Ur          , Ur          , Ur          , Ur          , Ur          , Ur          , Cud         , Cud         , Cud         , Ur          , Ur          , Xos         , Xos         , Xos         , Xos         
Xos         , Xos         , Xos         , Xos         , Xos         , Xos         , Uu          , Ur          , Ur          , Uu          , Uu          , Uu          , Uu          , Ur          , Ur          , Ur          , Ur          , Ur          , Rr          , Ur          , Ur^Ii       , Ur          , Uu          , Uu          , Ur          , Ur          , Xos         , Uu          , Uu^Dr       , Xos         , Xos         , Xos         
Xos         , Xos         , Xos         , Xos         , Xos         , Uu          , Uu          , Uu^Dr       , Ur          , Uu          , Uu          , Ur^Dr       , Xos         , Uu          , Ur          , Ur^Ii       , Rr^Ii       , Rr          , Rr^Ii       , Rr^Ii       , Rr          , Ur          , Qxu         , Qxu         , Qxu         , Ur^Dr       , Uu          , Xos         , Xos         , Xos         , Xos         , Xos         
Xos         , Xos         , Xos         , Xos         , Uu          , Xos         , Xos         , Ur          , Ur          , Ur          , Ur          , Ur          , Ur          , Ur          , Rr^Dr       , Rr          , Rr^Ii       , Rr^Ii       , Rr^Ii       , Rr          , Ur          , Uu          , Uu^Dr       , Qxu         , Qxu         , Qxu         , Ur          , Uu          , Uu          , Xos         , Xos         , Xos         
Xos         , Xos         , Uu          , Uu          , Qxu         , Ur          , Ur          , Ur          , Xos         , Uu          , Ur          , Ur^Ii       , Rr^Ii       , Rr          , Rr^Ii       , Rr^Ii       , Rr          , Rr          , Ur          , Ur^Ii       , Ur          , Qxu         , Qxu         , Qxu         , Uu^Dr       , Ur          , Uu          , Uu          , Xos         , Xos         , Xos         , Xos         
Xos         , Xos         , Xos         , Qxu         , Qxu         , Qxu         , Ur          , Ur          , Uu          , Uu          , Rr          , Rr          , Rr^Ii       , Rr^Ii       , Rr^Ii       , Rr          , Ur          , Ur          , Xos         , Uu          , Uu          , Uu^Dr       , Qxu         , Uu          , Uu          , Xos         , Xos         , Xos         , Xos         , Xos         , Xos         , Xos         
Xos         , Xos         , Uu^Dr       , Xos         , Xos         , Qxu         , Ur          , Ur          , Ur          , Ur          , Ur^Ii       , Rr^Ii       , Rr          , Rr^Dr       , Ur          , Ur^Ii       , Ur          , Ur          , Ur          , Uu          , Uu          , Ur          , Ur          , Ur          , Uu          , Uu          , Xos         , Xos         , Xos         , Xos         , Xos         , Xos         
Xos         , Xos         , Xos         , Uu          , Ur          , Ur          , Cud         , Ur          , Ur          , Ur          , Ur          , Ur          , Ur          , Ur          , Xos         , Ur          , Ur          , Ur          , Ur          , Ur          , Ur          , Ur          , Uu          , Uu          , Xos         , Xos         , Xos         , Xos         , Xos         , Xos         , Xos         , Xos         
Xos         , Xos         , Ur          , Ur          , Ur          , Cud         , 1 Kud       , Cud         , Ur          , Ur          , Ur^Dr       , Ur          , Ur          , Ur          , Ur          , Ur^Dr       , Xos         , Ur          , Uu          , Ur          , Uu          , Uu          , Xos         , Xos         , Xos         , Xos         , Xos         , Xos         , Xos         , Xos         , Xos         , Xos         
Xos         , Xos         , Xos         , Ur          , Ur          , Cud         , Cud         , Cud         , Ur          , Ur          , Xos         , Ur          , Uu          , Uu          , Ur          , Ur          , Uu          , Xos         , Xos         , Uu          , Xos         , Xos         , Xos         , Xos         , Xos         , Xos         , Xos         , Xos         , Xos         , Xos         , Xos         , Xos         
Xos         , Xos         , Xos         , Xos         , Xos         , Ur          , Ur          , Ur          , Xos         , Uu          , Uu^Dr       , Xos         , Xos         , Uu          , Uu          , Uu          , Xos         , Xos         , Xos         , Xos         , Xos         , Xos         , Xos         , Xos         , Xos         , Xos         , Xos         , Xos         , Xos         , Xos         , Xos         , Xos         
Xos         , Xos         , Xos         , Xos         , Xos         , Xos         , Iwr         , Xos         , Xos         , Xos         , Xos         , Xos         , Xos         , Xos         , Xos         , Xos         , Xos         , Xos         , Xos         , Xos         , Xos         , Xos         , Xos         , Xos         , Xos         , Xos         , Xos         , Xos         , Xos         , Xos         , Xos         , Xos         
Xos         , Xos         , Xos         , Xos         , Xos         , Xos         , Iwr         , Xos         , Xos         , Xos         , Xos         , Xos         , Xos         , Xos         , Xos         , Xos         , Xos         , Xos         , Xos         , Xos         , Xos         , Xos         , Xos         , Xos         , Xos         , Xos         , Xos         , Xos         , Xos         , Xos         , Xos         , Xos         
Xos         , Xos         , Xos         , Xos         , Xos         , Xos         , Iwr         , Xos         , Xos         , Xos         , Xos         , Xos         , Xos         , Xos         , Xos         , Xos         , Xos         , Xos         , Xos         , Xos         , Xos         , Xos         , Xos         , Xos         , Xos         , Xos         , Xos         , Xos         , Xos         , Xos         , Xos         , Xos         
Xos         , Xos         , Xos         , Xos         , Xos         , Xos         , Iwr         , Xos         , Xos         , Xos         , Xos         , Xos         , Xos         , Xos         , Xos         , Xos         , Xos         , Xos         , Xos         , Xos         , Xos         , Xos         , Xos         , Xos         , Xos         , Xos         , Xos         , Xos         , Xos         , Xos         , Xos         , Xos         
