Gg, Rr, Gs, Gg, Aa, Aa, Aa, Gg, Gs, Aa, Aa, Aa, Aa, Gd, Gs, Gg, Gs, Gg, Gg, Gg, Aa, Gg, Gd, Gg, Rr, Gg, Gg, Gg, Aa, Aa, Gg, Aa, Aa, Aa, Aa, Aa, Aa, Gd, Gd, Aa, Aa, Gg, Gg, Aa, Aa, Gg, Aa, Gg, Aa, Aa, Aa, Gd, Rr
Gs, Rr, Gg, Gg, Gg, Aa, Aa, Aa, Gd, Gd, Gd, Gd, Cer, Gd, Gd, Gs, Aa, Aa, Aa, Aa, Gg, Gd, Gg^Es, Gg, Rr, Gg, Aa, Aa, Gg, Aa, Gs, Gg, Aa, Aa, Gs, Gd, Gd, Gd, Gd, Aa, Aa, Aa, Aa, Aa, Aa, Aa, Gg, Aa, Aa, Aa, Gd, Gd, Rr
Gs, Rr, Rr, Gs, Gs^Es, Gg, Gs, Gs, Gd^Edb, Gd, Re, Cer, 8 Ker, Cer, Gd, Re, Gll, Aa, Aa, Aa, Gg, Gg^Vl, Gg, Gg, Rr, Gd, Gs, Gs, Gg^Vhr, Gs, Gs, Gs, Aa, Gg, Gs, Gd, Cer, Gd, Gs^Edb, Gg^Eff, Gg^Eff, Gg, Gg^Eff, Aa, Gg, Gs, Rr, Gg, Rr, Gs, Rr, Rr, Gd
Aa, Gs, Gg, Rr, Rr, Rr, Rr, Gg, Rr, Gs, Gs, Cer, Cer, Cer, Gd, Gll^Fdw, Aa^Fda, Aa^Fda, Gll^Fdw, Gll, Gll, Gg, Gs, Gg, Rr, Gs, Aa, Gg, Aa, Gg, Aa, Aa, Aa, Gs, Gd, Cer, 2 Ker, Cer, Gs, Gd, Gd, Gg^Eff, Gs, Gs^Eff, Rr, Rr, Gd, Rr, Gd, Rr, Gd, Aa, Aa
Aa, Aa, Aa, Aa, Gg, Gg, Gg, Rr, Gg, Rr, Rr, Gs, Gd, Re, Gll, Gll^Fdw, Gll^Fdw, Aa^Fda, Gll^Fdw, Gs^Fdw, Gs, Gs, Gs, Gg, Rr, Gg, Aa, Aa, Gd, Gs, Gs, Aa, Gd, Gd, Gd, Cer, Cer, Cer, Gd, Gs, Gg, Gs, Rr, Rr, Gg, Gg^Eff, Gg^Eff, Gd, Gd, Aa, Aa, Aa, Gd
Gg, Aa, Aa, Aa, Aa, Gg, Gs, Gg, Gs^Ecf, Gg, Gs, Rr, Rr, Gs, Gs, Gll^Fdw, Gll^Fdw, Gll, Gg, Gs, Gd, Gs, Gg, Gg, Rr, Gg, Gg, Gs, Gd, Gs, Aa, Aa, Gs, Gs, Gg^Vhr, Gd, Re, Gd, Re, Gg^Es, Gs, Gg, Rr, Gs, Re, Re, Gd, Gd, Gd, Aa, Aa, Aa, Gd
Gg, Aa, Aa, Gg, Gg, Aa, Gs, Gs, Gs^Es, Gs, Gg, Gg, Rr, Gs, Gs, Gs^Es, Gs, Gg, Gd, Gd, Gd, Gg, Gs, Gg, Rr, Gg, Gg, Gd, Gd, Gg, Gs, Gg, Gs, Re, Gd, Gd, Gs^Ecf, Gs, Gg, Re, Gg, Gg, Rr, Gg, Gs, Gs, Gd, Gd, Gd, Aa, Aa, Aa, Aa
Gs, Gg, Gg, Gg, Gg, Gd, Gd, Gs, Gs, Gg, Gg, Gg, Gg, Rr, Rr, Gg, Gg, Gs, Gs, Gs, Gg^Gvs, Gs^Gvs, Gg^Gvs, Gg, Rr, Gg, Gg, Gd, Gs, Gs^Es, Gg^Gvs, Gs, Gs, Gd, Gs, Gd, Gs, Gg, Gg, Gg, Rr, Rr, Gg, Gg, Gg, Gd^Ecf, Gd, Gd, Aa, Aa, Gd, Aa, Aa
Gs, Gs, Re, Re, Re, Gs, Gs, Gd, Gd, Gs, Gs, Gg, Gg, Gg, Gg, Rr, Rr, Gg^Fdw, Gg, Gg, Gs^Gvs, Gg^Gvs, Re, Gg, Rr, Gg, Gg, Gg, Gs^Gvs, Gg^Gvs, Gs^Gvs, Gg, Gg, Gs, Gg, Gs, Rr, Gg, Rr, Rr, Gs, Gs, Gs, Gs, Gs, Gs, Gd, Gd, Gd, Aa, Gd, Aa, Gd
Gd, Gs, Gd, Re, Gd, Re, Gs, Gg, Gg, Gd, Gg, Gs, Gd, Gs, Gg, Gg, Gg^Vhr, Rr, Rr, Gg, Ce, Ce, Re^Edt, Re^Vhcr, Rr, Gg, Gs, Re, Ce, Gs^Gvs, Gs^Gvs, Gs^Gvs, Gg, Gg, Rr, Rr, Gg, Rr, Gs, Rr, Rr, Gg, Re, Gg, Gg^Es, Gd, Cer, Cer, Cer, Gg^Edb, Gd, Aa, Gd
Gd, Gs, Cer, Cer, Cer, Gd, Gll, Gll^Fdw, Gll^Fdw, Gs^Fdw, Gg, Gs, Gd, Gd, Gll^Fdw, Gg, Re, Re, Ce^Edt, Rr, Re^Vhcr, Re^Edt, Rrc, Rrc, Ww^Bsb|, Rrc, Rrc, Re^Vhcr, Re, Ce, Gg, Gg, Rr, Rr, Gg, Gs, Gs, Gg, Gg, Gd, Rr, Gd, Re, Re, Gs, Gd, Cer, 3 Ker, Cer, Gd, Gd, Aa, Gd
Re, Gd, Cer, 7 Ker, Cer, Gll, Gll^Fdw, Gll^Fdw, Gll^Fdw, Gll^Fdw, Gll^Fdw, Gll, Gd, Gg, Gll, Gll^Fdw, Re, Re^Dr, Re^Vhcr, Rrc, Rrc, Rrc, Ww, Ww, Rrc, Ww, Ww, Rrc, Rrc, Gs, Rr, Rr, Gg, Gg, Gg, Gs, Gg, Gd, Gs, Gg, Rr, Gd, Gs, Gd, Re, Gd, Gd, Cer, Gd, Gd, Gd, Gd, Gd
Gd, Gd, Gd, Cer, Gd, Gd, Gll^Fdw, Gll^Fdw, Gll^Fdw, Gs^Fdw, Gll^Fdw, Gll, Gg, Gs, Gs, Gg, Gg, Re^Edt, Re^Edt, Rrc, Ww, Ww^Bsb\, Rrc, Rrc, Gg^Efm, Rrc^Vhc, Rrc, Ww, Ww^Bsb/, Rrc, Re, Gg, Gg, Gs^Es, Gs, Gg, Gg^Vhcr, Gg, Gg, Gg, Rr, Gs, Gd, Gd, Gd, Re, Gd, Gd, Gs, Gg^Vhr, Gd, Gg^Es, Gd
Rr, Gs, Gs, Gs, Gs, Gs, Gs, Gll^Fdw, Gg, Gll^Fdw, Gg, Gll, Gg^Gvs, Gg, Gg^Gvs, Gg^Eff, Gs^Eff, Re, Re^Vhcr, Rrc, Ww, Rrc^Vhc, Gg^Efm, Gg^Efm, Ch, Gg^Efm, Gg^Efm, Rrc, Ww, Rrc, Re^Vhcr, Ce^Dr, Gg^Edt, Gs, Gs, Gg, Gg, Gs, Gs, Gg, Gg, Rr, Rr, Gd, Gd, Gd, Rr, Gs, Gs, Gd, Rr, Rr, Rr
Gg, Rr, Rr, Rr, Rr, Gg, Rr, Gg, Gs, Gg, Gs, Gg^Gvs, Gg^Gvs, Gg^Gvs, Gg^Eff, Gg^Eff, Re^Edt, Ce, Re^Vhcr, Rrc, Ww, Rrc, Rrc^Vhc, Ch, 1 Kh, Ch, Rrc, Rrc^Vhc, Ww, Rrc, Re^Edt, Ce^Edt, Gg^Edt, Gg, Gll^Fdw, Gg, Gg, Gs, Gg^Es, Gg, Gg, Gg, Gd, Rr, Rr, Rr, Gg, Rr, Rr, Rr, Gd, Gs, Gg
Gg, Gg, Gs, Gs, Gs, Rr, Gg, Rr, Rr, Rr, Rr, Gs, Gs, Gg, Gg, Gg, Re^Edt, Ce^Edt, Re, Rrc, Ww, Ww, Rrc, Ch, Ch, Ch, Rrc, Ww, Ww, Rrc, Re^Vhcr, Ce^Edt, Gg, Gg, Gs, Gll, Gll^Fdw, Gll, Gs, Gg, Gg, Gs, Gd, Gg, Gs, Gg, Gg, Gg, Gg, Gs, Gg, Gs, Gs
Gs, Gs^Es, Gg, Gd, Gg, Gg, Gd^Gvs, Gs^Gvs, Gs, Gg, Gs, Rr, Rr, Rr, Rr, Gll^Fdw, Gg, Ce, Re^Vhcr, Rrc^Edt, Wwg^Dr, Ww^Bsb/, Ww, Rrc, Gg^Efm, Rrc, Ww, Ww^Bsb\, Ww^Bsb\, Rrc, Re, Re, Gs, Gg, Gg, Gll^Fdw, Gg, Gs, Gs, Gg, Gg, Gg^Vhhr, Gs, Gs, Ds, Wwf, Ww, Ww, Ww, Ww, Wwf, Ds, Wwf
Gll, Gg^Fdw, Gg^Fdw, Gd, Gs, Gg^Gvs, Gg, Gs, Gd^Gvs, Gd^Gvs, Gd, Gd, Gs^Fdw, Gs, Gg, Rr, Gg, Gs, Rrc, Rrc, Rrc^Edt, Ww, Ww, Rrc^Vhc, Rrc, Rr^Vhc, Ww, Ww, Ww, Rrc, Rr, Rr, Rr, Gg, Gg, Gg, Gg, Gg, Gg, Gg, Ww, Ww, Ww, Ww, Ww, Ww, Ww, Ww, Ww, Ww, Ww, Ww, Ww
Gll^Fdw, Gs, Gg^Fdw, Gd, Gd, Gs, Gg, Gs^Gvs, Gs, Gg, Gg, Gg, Ce, Gs, Gs, Rr, Rr, Rr, Gg, Rrc^Vhcr, Rrc, Rrc^Vhcr, Rrc, Ww, Ww^Bsb|, Ww, Rrc, Rrc^Vhcr, Ww, Re^Vhcr, Ww, Gg, Gs, Rr, Rr, Gg, Gg, Ds, Ww, Ww, Ww, Ww, Ww, Ww, Ww, Ww, Ww, Ww, Ww, Ww, Ww, Ww, Ww
Gll^Fdw, Gll, Gll^Fdw, Gll^Fdw, Gg, Gll^Fdw, Gg, Gs, Gg^Es, Gg, Gs, Re^Edt, Ce^Dr, Re^Edt, Rr, Rr, Gs, Gg, Gg, Gg, Gg, Rrc, Rrc^Vhcr, Rrc, Rrc, Rrc, Rrc, Rrc, Rrc^Es, Ww, Ww, Ww, Ww, Gg, Ww, Ww^Bsb\, Wwg^Edt, Ww, Ww, Ww, Ww, Ww, Ww, Ww, Ww, Ww, Gg, Gs, Gd, Gg, Gll, Gg, Gg
Gll^Fdw, Gll^Fdw, Gll, Gll, Gs, Gs, Gs, Gs, Gd, Gs, Re, Re^Edt, Rr, Rr, Rp^Vhcr, Gs, Gg, Gd, Gs, Gg, Gg, Rrc, Rrc, Rrc, Ch, Rrc, Rrc, Rrc, Ww, Ww, Ww, Ww, Ww, Ww, Ww, Ww, Ww, Ww^Bsb\, Ww^Bsb\, Ww, Gg, Ww, Gg, Ds, Gd, Gd, Gll, Gll, Gs^Fdw, Gll^Fdw, Gll^Fdw, Gll^Fdw, Gs^Fmw
Gg, Gll^Em, Gd, Gd, Cer, Gg, Gg, Gg^Ecf, Gg, Gs, Rr, Rr, Re^Edt, Ce^Edt, Gg, Gg, Gd, Gd, Gd, Gg, Gg^Efm, Ds, Ww, Ww, Ww, Ww, Ww, Ww^Bsb|, Ww, Ww, Ww, Ww, Ww, Ww, Ww, Ww, Ww, Re^Vhcr, Gg, Rr, Rr, Gg, Gs^Edb, Gd, Gll^Fdw, Gll^Fdw, Cer, Gll^Fdw, Gll^Fdw, Gs^Fdw, Gll^Fdw, Gs^Fdw, Gs^Fdw
Gs, Gs, Gd, Cer, 6 Ker, Cer, Gg, Gg, Gg, Rr, Gg, Re^Dr, Gs^Es, Gs, Gg, Gg, Gs, Gg, Ww, Ww, Ww, Ww, Ww, Ww, Ww, Ww, Ww, Ww^Bsb|, Ww, Ww, Ww, Wwf, Ds, Gs, Gg, Ds, Gg, Gg, Gs, Gg, Gg, Rr, Gg, Gll, Gd, Cer, 4 Ker, Cer, Gs^Fdw, Gll^Fdw, Gll^Fdw, Gll^Fdw, Gs^Fdw
Gs, Gd, Gd, Cer, Cer, Cer, Gs, Gg^Edb, Rr, Rr, Gg, Gs, Gg, Gd, Ds, Ww, Ww, Ww, Ww, Ww, Ww, Ww, Ww, Ww, Ww, Ww, Gg, Rrc, Gs, Gs, Cer, Gs, Gd, Gs^Es, Gs, Gg, Gg, Gg^Edt, Gs, Gg, Gs, Rr, Gg, Gs, Gd, Cer, Cer, Cer, Gll, Gll^Fdw, Gll^Fdw, Gll^Fdw, Gll^Fdw
Gd, Gd, Gd, Gd, Gd, Gd, Gg^Edt, Rr, Gg, Gg, Wwf, Ww, Ww, Ww, Ww, Ww, Ww, Ww, Ww, Ww, Ww, Ww, Gg, Gg, Gs, Gs, Gs, Rrc, Gs, Cer, 5 Ker, Cer, Gd, Gd, Gd, Gd, Gg, Gg, Gs, Gs, Gs, Rr, Rr, Gs, Re, Gd, Gd, Gd, Gd, Gll, Gs^Es, Gll, Gg
Gd, Gd, Gd, Gd, Gd, Gs, Rr, Rr, Gg, Wwf, Ww, Ww, Ww, Ww, Ww, Ww, Ww, Ww, Ds, Gg, Gs, Gd, Gs^Es, Gs, Gd, Re, Gs, Rrc, Rrc, Cer, Cer, Cer, Gd, Re, Gd, Gs^Es, Gs, Gg, Gs, Gd, Gd, Gd, Gs, Rr, Rr, Gs, Gs, Re, Re, Re, Gs, Gd, Gg
Gd, Gd, Rr, Gd, Gd, Gs, Rr, Gs, Gg, Wwf, Ww, Ww, Ww, Ww, Ww, Ww, Ww, Wwf, Gg, Gs, Gg, Gd, Gd, Gg, Gg, Re, Gg, Gg, Rr, Gs, Gd, Gd, Gd, Gd, Gd, Gs, Gs, Gd, Gs, Gs, Gg, Gs, Gg, Gg, Gg, Rr, Gd, Gd, Gd, Gd, Gd, Gd, Gg
