Xu, Xu, Xu, Xu, Xu, Xu, Xu, Xu, Xu, Xu, Xu, Qxu, Xu, Xu, Xu, Xu, Xu, Xu, Xu, Xu, Xu, Xu, Xu, Xu, Xu, Xu, Xu, Xu, Xu, Xu, Xu, Xu, Xu, Wo^Qhux, Xu, Xu, Xu, Wo^Qhux, Xu, Xu, Xu, Xu^Qhh, Ms^Qhh, Ms^Qhh, Ms^Qhh, Ha^Qhh, Ai^Qhh, Ai^Qhh
Xu, Xu, Xu, Xu, Xu, Xu, Xu, Xu, Xu, Xu, Xu, Xu, Xu, Xu, Xu, Xu, Xu^_s, Xu, Xu^_s, Xu, Xu, Xu, Xu, Xu, Xu, Xu, Xu, Xu, Xu, Xu, Xu, Xu, Xu, Wo^Qhux, Wo^Qhux, Xu, Wo^Qhux, Wo^Qhux, Wo^Qhux, Xu, Xu^Qhh, Xu^Qhh, Ms, Ms, Ms, Ha^Qhh, Ai, Ai^Qhh
Xu, Xu, Xu, Xu, Xu, Xu, Xu, Xu, Xu, Xu, Xu, Xu, Xu, Xu, Xu^_s, Xu^_s, Xu^_s, Xu^_s, Tb^Tf, Tb^Tf, Xu, Xu, Xu, Xu, Xu, Xu, Xu, Xu, Xu, Xu, Wo^Qhux, Xu, Xu, Xu, Xu, Wo^Qhux, Xu, Xu, Xu, Xu, Xu^Qhh, Xu^Qhh, Ms, Ms, Ha^Fda, Ai, Aa^Fdw, Ai^Qhh
Xu, Xu, Xu, Xu, Xu, Xu, Xu, Xu, Xu, Xu, Xu, Xu, Xu, Xu, Xu^_s, Uu^_s, Uu^_s, Xu^_s, Re, Wwf^Qhu, Uh, Uu^Dr, Uh^Qhh, Xu, Uu^Qhh, Xu, Xu, Xu, Xu, Xu, Wo^Qhux, Wo^Qhux, Wo^Qhux, Xu, Wo^Qhux, Wo^Qhux, Wo^Qhux, Wo^Qhux, Xu, Xu, Xu^Qhh, Ms, Ms, Ha, Aa^_mh, Aa, Ai, Aa^Qhhf
Xu, Xu, Xu, Xu, Xu, Xu, Xu, Xu, Xu, Xu, Xu, Xu, Xu, Xu, Xu^_s, Uu^_s, Uu^_s, Re^_s, Xu, Xu, Xu, Xu, Xu, Uu^Qhh, Ur, Uu, Xu, Xu, Xu, Xu, Xu, Wo^Qhux, Xu, Wo^Qhux, Wo^Qhux, Wo^Qhux, Wo^Qhux, Wo^Qhux, Xu, Xu^Qhh, Ms, Ms, Ha, Ha^Fda, Ha^Fda, Ai, Ai, Aa^Qhhf
Xu, Xu, Xu, Xu, Xu, Xu, Xu, Xu, Xu, Xu, Xu, Xu, Xu, Xu, Xu, Xu^_s, Xu, Xu, Xu, Xu, Xu, Xu, Xu, Xu, Ur, Ur, Xu, Xu, Xu, Xu, Xu, Xu, Xu, Wo^Qhux, Wo^Qhux, Wo^Qhux, Xu, Xu, Xu^Qhh, Xu^Qhh, Ms, Ha, Ha, Aa, Aa^Fdw, Aa^Fdw, Aa, Aa^Qhh
Xu, Xu, Xu, Xu, Xu, Xu, Xu, Xu, Xu, Xu, Xu, Xu, Xu, Xu, Xu, Xu, Xu, Xu, Uh^Qhh, Uu^Qhh, 6 Ur, Wwf^Qhu, Xu, Xu, Xu, Re^Pr/o, Uu, Xu, Xu, Uh^Qhh, Uu^Qhh, Xu, Xu, Xu, Wo^Qhux, Wo^Qhux, Xu, Xu, Xu^Qhh, Xu^Qhh, Ha, Ha, Aa, Aa, Aa^Qhh, Aa, Aa^Qhh, Aa^Qhh
Xu, Xu, Xu, Xu, Xu, Xu, Xu, Xu, Xu, Xu, Xu, Xu, Xu, Xu, Tb^Qhh, Tb^Qhh, Xu, Xu, Uh^Qhh, Ur, Ur, Uu^Em, Xu, Xu, Xu^Efs, Re, Uu^Dr, Xu, Uu^Qhu, Ur, Ur, Uu^Qhu, Wo^Qhux, Wo^Qhux, Xu, Xu, Xu, Xu, Xu^Qhh, Ms, Ms, Ha, Ms^Qhh, Aa^Qhh, Ha, Aa^Qhh, Aa, Aa
Xu, Xu, Xu, Xu, Xu, Xu, Xu, Xu, Xu, Xu, Xu, Xu, Xu, Xu, Uu^Em, Uu^Qhh, Uu^Em, Xu, Xu, Uu^Qhh, Xu, Re^Pr/, Re, Uu^Em, Uu^Em, Uu, Uu^Vu, Xu, Re^Pr\, Ur, Uu^Em, Uu^Qhu, Wo^Qhux, Xu, Xu, Xu, Xu, Xu, Xu^Qhh, Ms, Ms^Qhh, Ms^Qhh, Ms, Ha, Aa, Aa, Aa, Aa
Xu, Xu, Xu, Xu, Xu, Xu, Xu, Xu, Xu, Xu, Xu, Xu, Xu, Wwf^Qhu, Ur, Xu, Ur, Xu, Xu, Xu, Xu^Efs, Re, Uu, Uu, Re, Uu^Ii, Re^Ii, Re^Ii, Uh, Xu, Xu^Efs, Xu, Wo^Qhux, Xu, Xu, Xu, Xu, Xu, Xu, Xu^Qhh, Xu, Ms, Ha, Ha, Ha^Fda, Aa, Aa, Gd
Xu, Xu, Xu, Xu, Xu, Xu, Xu, Xu, Xu, Xu, Xu, Xu, Xu, Wwf^Qhu, Uu^Qhu, Ur, Re^Pr/, Xu, Uu, Uu, Uu^Ii, Uu^Vu, Uu^Ii, Re, Re, Re^Ii, Re^Ii, Qxu^Ii, Qxu, Uu^Qhu, Wwf^Qhu, Wwg^Qhu, Xu, Xu^Efs, Isa, Xu^Efs, Xu, Xu, Xu, Xu, Xu, Ms, Ms, Ms, Ha^Fda, Ha, Coa, Re
Xu, Xu, Xu, Xu, Xu, Xu, Xu, Xu, Xu, Xu, Xu, Xu, Xu, Xu, Xu, Xu, Uu^Vu, Re, Re, Re, Uu^Ii, Re^Ii, Re^Ii, Re, Re, Uu^Qhu, Uu^Qhu, Qxu, Ur^Qhu, Wwf^Qhu, Xu, Xu, Xu, Isa, Isa^Pr|o, Isa, Xu, Xu, Xu, Xu, Xu, Ms, Ha^Fda, Ha^Fda, Ha^Fda, Hhd^Vo, 2 Koa, Co
Xu, Xu, Xu, Xu, Xu, Xu, Xu, Xu, Xu, Xu, Xu, Xu, Xu, Xu, Xu, Xu, Ur^Qhh, Wwrg^Qhu, Uu, Uu, Re, Re^Ii, Uu^Qhu, Re, Uu^Qhu, Uu^Qhu, Urb, Urb, Urb^Ii, Ur^Qhu, Ur^Qhu, Uu^Ebn, Wwf^Qhu, Xu, Re, Xu, Xu, Xu, Xu, Xu, Xu, Ha, Aa, Ha, Aa^Fdw, Coa, Co, Gs
Xu, Xu, Xu, Xu, Xu, Xu, Xu, Xu, Xu, Xu, Xu^_s, Xu^_s, Xu^_s, Xu, Xu, Xu, Xu, Ur^Qhh, Uu^Ebn, Re, Re, Uu^Qhu, Uu^Qhu, Uu^Qhu, Urb, Urb, Urb, Urb^Efs, Urb^Ii, Urb^Ii, Urc^Ii, Uu, Uu, Wwrg^Qhu, Re, Uh^Qhh, Xu, Xu, Xu, Xu, Aa, Aa, Aa, Re, Re, Re, Co, Co
Xu, Xu, Xu, Xu, Xu, Xu, Xu, Xu, Xu, Xu^_s, Uu^_s, Uh^_s, Xu, Xu, Xu, Xu, Xu^Efs, Xu, Xu, Xu, Uu^Qhu, Uu^Qhu, Uu^Qhu, Urb, Urb^Efs, Urb, Urb, Urb, Ur, Urc^Ii, Co, Urc, Urc, Rb, Re, Uh^Qhh, Xu, Xu, Xu, Xu, Aa, Gd, Re, Aa^Voa, Re, Gs, Re, Gd
Xu, Xu, Xu, Xu, Xu, Xu, Xu, Xu, Xu, Xu^_s, Uu^Qhu, Uu^Qhu, Xu, Xu, Urb^Edt, Urb^Edt, Urb^Edt, Xu, Xu, Xu, Ur, Uu^Qhu, Re, Re, Re^Ii, Urb^Ii, Urc^Ii, Urc, Co, Co, Ch^Kov, Co, Co, Urc, Urc, Uu, Uh^Qhh, Xu, Xu, Uh, Gd, Re, Aa, Re, Gd, Re, Aa^Voa, Re
Xu, Xu, Xu, Xu, Xu, Xu, Xu, Xu, Xu, Xu, Uu, Uu^Qhu, Ur, Xu^Efs, Urb^Edt, Urb^Edt, Urb^Edt, Xu, Xu, Xu, Ur, Ur, Uu, Uu, Uu^Ii, Re^Ii, Uu^Ii, Urc, Urc, Co, Co, Co, Ur, Urc, Ur, Uu, Xu, Xu, Re, Uu, Re, Aa, Aa, Aa, Aa, Aa, Aa, Gd
Xu, Xu, Xu^Qhh, Xu^Qhh, Xu^Qhh, Xu^Qhh, Xu^Qhh, Xu, Xu, Uh, Xu, Uu, Uu, Ur, Re, Re, Uu^Dr, Xu, Xu^Efs, Xu, Re, Uu, Xu, Xu, Xu, Uu^Ii, Uu^Qhu, Uu, Uu, Urc, Urc, Urc, Re, Re, Xu, Uu^Ebn, Xu, Xu, Uu^Qhu, Re^Ii, Uu^Ii, Re^Ii, Uu, Ha, Ha, Ha, Gs, Gs
Xu^Qhh, Xu^Qhh, Ms^Xm, Xu^Qhh, Ms^Xm, Ms^Xm, Ms^Xm, Xu^Qhh, Xu^Qhh, Xu, Xu, Xu, Xu, Uu, Uu^Dr, Uu, Uu^Qhh, Uu, Re, Re, Re, Uu^Qhu, Xu, Xu, Xu, Xu, Xu, Re^Ebn, Uu, Uu, Ur, Uu, Uu, Re, Ur^Qhu, Xu, Xu, Re^Ii, Re, Uu^Em, Uu^Em, Uu^Qhu, Xu, Xu, Xu, Ha, Ha^Fda, Aa
Ha^Qhh, Ms, Ms, Ms, Ms, Ms, Ms, Ms, Ha, Xu^Qhh, Xu^Qhh, Xu, Xu, Xu, Xu, Uh^Qhh, Uh^Qhh, Wwf^Qhu, Wwrg^Qhu, Re, Xu, Uu^Qhu, Uu^Qhu, Xu, Xu, Xu, Xu, Re, Uu, Uu, Xu, Uu, Uu, Uu, Ur^Qhu, Ur^Qhu, Re, Re^Ii, Re, Uu, Uu^Em, Uu^Qhu, Xu, Xu, Ms, Ms, Ms, Ha
Ha^Qhh, Ha, Ha, Ha, Ha^_mh, Ha, Ha^Voa, Ms, Ms, Ha, Ha, Xu^Qhh, Xu^Qhh, Xu, Xu, Xu, Xu, Xu, Xu, Xu, Xu, Tb^Tf, Re, Uu, Uu, Xu, Uu^Qhu, 1 Uu, Qxu, Qxu, Xu, Uu^Em, Xu, Uu, Uu, Re, Uu^Em, Xu, Uu^Em, Uh, Uh, Xu, Xu, Ms, Ha^Fda, Ms, Ha, Aa
Aa^Qhh, Aa, Ha, Ha, Ha, Ha, Ha, Ms, Ha, Ha, Ha^Qhh, Ha^Qhh, Ha^Qhh, Ha^Qhh, Hhd, Xu, Xu, Xu, Xu, Xu, Uu^Em, Re, Uu^Em, Xu, Xu, Uu, Ur, Ur, Uu, Qxu, Xu, Xu, Xu, Uu^Qhu, Re, Uu, Uu, Uu, Uh, Uh, Xu, Xu, Xu, Ms, Ha, Ha^Fda, Aa, Aa
Aa^Qhh, Aa, Aa^Qhh, Ha^Voa, Ha^Fda, Ha^Fda, Aa^Fdw, Ha^Fda, Ha^Qhh, Ms^Qhh, Ha^Qhh, Ms^Qhh, Ms, Hhd, Hhd, Hhd, Re, Re, Re, Uu^Ii, Re, Re^Ii, Xu, Xu, Xu, Xu, Xu, Ur, Uu^Qhu, Xu, Xu, Xu, Xu, Xu, Uh^Qhh, Xu, Xu, Uh^Qhh, Uh^Qhh, Uh^Qhh, Uh, Xu, Uu^Ii, Re, Gd, Ha, Aa, Gd
Aa^Qhh, Aa^Qhh, Aa, Aa^Qhh, Aa^Qhh, Aa^Qhhf, Aa^Qhhf, Aa^Qhhf, Gd, Ha, Aa, Ha, Ha, Ha, Hhd, Gd, Re, Re, Re, Re^Ii, Ur, Xu, Xu, Xu, Tb^Tf, Tb^Tf, Uh^Em, Uh, Ur, Uu^Qhu, Urb^Edt, Urb^Edt, Xu, Xu, Xu, Uh^Qhh, Uh^Qhh, Uh^Qhh, Uh^Qhh, Uh^Qhh, Uu^Em, Uu, Gd, Re, Gd, Aa, Gs, Gs
Aa, Aa, Aa, Aa, Aa, Aa, Aa^Fdw, Aa^Fdw, Gs, Gs, Aa, Aa, Aa, Aa, Gd, Hhd, Re, Gd, Re, Xu, Xu, Ur, Ur^Ii, Xu, Rb^Em, Rb^Tf, Rb^Em, Uh^Em, Ur, Ur, Urb^Edt, Urb^Edt, Xu, Xu, Xu, Xu, Uh^Qhh, Xu, Xu, Xu, Uu^Qhu, Re^Ii, Gd, Gs, Aa, Gs^Vo, Co, Gd
Gg, Aa, Aa, Aa, Aa, Aa, Aa, Aa^Voa, Aa, Aa, Aa, Gd, Ce, Cea, Cea, Aa, Aa, Hhd, Hhd, Xu, Xu, Ur, Uh^Qhh, Uu^Qhu, Uu^Qhu, Rb^Em, Xu, Ur, Uu^Br\, Ur, Uh^Em, Xu, Xu, Xu, Ur, Uh^Qhh, Uh, Xu, Xu, Xu, Uu^Qhu, Uu^Qhu, Re, Aa, Aa, Coa, 3 Ko, Gd
Aa, Aa, Aa, Aa, Aa, Aa, Aa, Aa, Aa, Aa, Aa, Aa, Re, 4 Kea, Cea, Aa, Aa, Gd, Hhd^Fdw, Hhd^Vo, Xu, Xu, Xu, Uh^Qhh, Xu, Xu, Xu, Uu^Tf, Uh^Em, Uu^Br\, Uu^Br\, Xu, Ur^Br\, Uu^Qhu, Xu, Xu, Uh, Xu, Xu, Xu, Xu, Xu, Ms^Qhu, Aa^Voa, Aa^Qhu, Gd, Coa, Co
Aa, Aa, Gs, Aa, Aa, Aa, Aa, Aa, Aa, Aa, Rb, Aa, Aa, Aa, Aa, Aa, Gd, Aa, Gd, Hhd, Xu, Xu, Xu, Xu, Xu, Xu, Xu, Xu, Xu, Xu, Xu, Ur^Br/, Xu, Uu^Em, Uu^Em, Uu^Em, Xu, Xu, Xu, Xu, Xu^Qhu, Ms^Qhu, Ha, Ha^Qhu, Ha^Voa, Aa^Qhu, Aa^Qhu, Co
Aa, Aa, Gg, Aa, 5 Re, Aa, Gs^Fdw, Re, Aa^Fdw, Rb^Fdw, Aa^Fdw, Aa, Aa, Aa, Aa, Aa, Gd, Hhd, Aa, Ha, Ha, Xu, Xu, Xu, Xu, Xu, Xu, Xu, Xu, Xu, Xu, Xu, Xu, Xu, Uu^Br|, Xu, Xu, Xu, Xu^Qhu, Xu^Qhu, Ms, Ms, Ha^Fda, Ha^_ml, Aa^Fdw, Aa, Aa, Aa^Qhu
Gd, Aa, Gd, Re, Aa, Gs, Gd, Aa^Fda, Aa^Fda, Aa^Fdw, Gd^Fdw, Aa, Gs, Gd, Gd, Aa, Aa, Gs, Gg, Gd, Hh, Xu, Xu, Xu, Xu, Xu, Xu, Xu, Xu, Xu, Xu, Xu, Xu, Xu, Qxu^Br|, Xu, Xu, Xu, Xu^Qhu, Ms^Qhu, Ms^Qhu, Ms, Ms^Qhu, Ha^Qhu, Aa^Qhuf, Aa^Qhuf, Aa^Qhuf, Aa^Fdw
