border_size=1
usage=map

Gg          , Gg          , Gg          , Gg          , Gg          , Gg          , Gg          , Gg          , Gg          , Gg          , Gg          , Gg          , Gg          , Gg          , Gg          , Gg          , Gg          , Gg          , Gg          , Gg          , Gg          , Gg          , Gg          , Gg          , Rr          , Rr          , Gg          , Gg          , Gg          , Gg          , Gg          , Gg          , Gg          , Gg          , Hh          , Gg          , Gg          , Gg          
Gg          , Gg          , Gg          , Gg          , Gg          , Gg          , Gg          , Gg          , Gg          , Gg          , Gg          , Gg          , Gg          , Gg          , Gg          , Gg          , Gg          , Gg          , Gg          , Gg          , Gg          , Gg          , Gg          , Gg          , Rr          , Rr          , Gg          , Gg          , Gg          , Gg          , Gg          , Gg          , Gg          , Gg          , Hh          , Gg          , Gg          , Gg          
Gs^Fp       , Gs^Fp       , Gg^Vh       , Gg          , Gg          , Gg          , Gg          , Gg          , Gg          , Gg          , Gg          , Gg          , Gg          , Gg          , Gg          , Gg          , Gg          , Gg          , Gg          , Gg          , Gg          , Gg          , Gg          , Gg          , Gg          , Rr          , Gg          , Gg          , Gg          , Gg          , Gg          , Hh          , Hh          , Hh          , Hh          , Gg          , Gg          , Gg          
Gg          , Gg          , Gg          , Gg          , Gg          , Gg          , Gg          , Gg          , Gg          , Gg          , Gg          , Gg          , Gg          , Gg          , Gg          , Gg          , Gg          , Gg          , Gg          , Gg          , Gg          , Gs^Fp       , Ce          , Ce          , Ce          , Rr          , Gg          , Gg          , Gg          , Gg          , Gg          , Hh          , Hh          , Hh          , Hh          , Gg          , Gg          , Gg          
Gg          , Gg          , Gg          , Gg          , Gg          , Gg          , Gg          , Gg          , Gg          , Gg          , Gg          , Gg          , Gg          , Gg          , Gg          , Gg          , Gg          , Gg          , Gg          , Gg          , Gg          , Gg          , Ce          , 1 Ke        , Gg          , Rr          , Rr          , Gg          , Gg          , Gg          , Gg          , Hh          , Gg          , Hh          , Gg          , Gg          , Gg          , Gg          
Gg          , Gg          , Gg          , Gg          , Hh          , Hh          , Hh          , Gg          , Re^Gvs      , Gg^Vh       , Gg          , Gg          , Gg          , Gg          , Gg          , Gg          , Gg          , Gs^Fp       , Gg          , Gg          , Gg          , Gg          , Gs^Fp       , Gg          , Gs^Fp       , Gg          , Rr          , Gg          , Ggf         , Gg          , Gg          , Ggf         , Gg          , Gg          , Gg          , Gg          , Ggf         , Gg          
Gg          , Gg          , Gg          , Hh          , Hh          , Hh          , Re^Gvs      , Re^Gvs      , Re^Gvs      , Re^Gvs      , Gg          , Gg          , Gg          , Gg          , Gg          , Gg          , Gg          , Gg          , Gs^Fp       , Gs^Fp       , Gs^Fp       , Gs^Fp       , Hh          , Gg          , Gs^Fp       , Gg          , Rr          , Gg          , Gg          , Gg          , Gg          , Gg          , Gg          , Gg          , Gg          , Gg          , Ggf         , Gg          
Gg          , Gg          , Gg          , Gg          , Re^Gvs      , Re^Gvs      , Re^Gvs      , Re^Gvs      , Re^Gvs      , Re^Gvs      , Hh          , Hh          , Gg          , Gg          , Gg          , Gs^Fp       , Gg          , Gs^Fp       , Gg          , Hh          , Gs^Fp       , Gs^Fp       , Hh          , Hh          , Gg          , Gg          , Rr          , Gg          , Gg          , Gg          , Gg          , Gg          , Hh          , Hh          , Re^Gvs      , Gg          , Gg          , Gg          
Gg          , Gg          , Gg          , Gg          , Re^Gvs      , Re^Gvs      , Re^Gvs      , Re^Gvs      , Gg          , Gg          , Hh          , Hh          , Gg          , Gg          , Gg          , Gg          , Gg          , Gs^Fp       , Gg          , Gg          , Gs^Fp       , Gs^Fp       , Gs^Fp       , Gg          , Gg          , Rr          , Gg          , Gg          , Gs^Fp       , Gs^Fp       , Gg          , Hh          , Re^Gvs      , Re^Gvs      , Re^Gvs      , Re^Gvs      , Re^Gvs      , Gg          
Gg          , Gg          , Gg          , Gg^Vh       , Gg          , Re^Gvs      , Gg          , Gg          , Gs^Fp       , Gg          , Gg          , Gg          , Gg          , Gg          , Gg^Vh       , Gg          , Gg          , Gg          , Gg          , Gg          , Gg          , Gg          , Gs^Fp       , Gg          , Rr          , Rr          , Gg          , Gg          , Hh          , Hh          , Hh          , Hh          , Re^Gvs      , Gg^Vh       , Re^Gvs      , Re^Gvs      , Gg          , Gg          
Gg          , Gg          , Gg          , Gg          , Gg          , Gg          , Gs^Fp       , Gs^Fp       , Gs^Fp       , Gg          , Gg          , Gg          , Gg          , Gg          , Gg          , Gg          , Gg          , Gg          , Gg          , Gg          , Gs^Fp       , Gg          , Gg          , Gg          , Rr          , Gg          , Hh          , Hh          , Mm          , Mm          , Mm          , Hh          , Hh          , Re^Gvs      , Re^Gvs      , Gg          , Gg          , Gg          
Gg          , Gg          , Gg          , Gg          , Gg          , Gg          , Gs^Fp       , Gs^Fp       , Gs^Fp       , Gg          , Gg          , Gg          , Gg          , Gg          , Ggf         , Gg          , Gg          , Hh          , Hh          , Gg          , Ggf         , Gg          , Gg          , Gg          , Rr          , Gg          , Gg          , Hh          , Hh          , Mm          , Hh          , Gs^Fp       , Gg          , Hh          , Hh          , Gg          , Gg          , Gg          
Gg          , Gg          , Gg          , Gg          , Gg          , Gg          , Gg          , Gs^Fp       , Gg          , Gg          , Hh          , Hh          , Gg          , Gg          , Gg          , Gg          , Gg          , Hh          , Gg          , Gg          , Gg          , Hh          , Hh          , Gg          , Rr          , Hh          , Gg          , Gg          , Gg          , Hh          , Hh          , Gs^Fp       , Gg          , Gg          , Hh          , Gg          , Gg          , Gg          
Gg          , Gg          , Gg          , Gg          , Gg          , Gg          , Gg          , Gg          , Gg          , Gg          , Hh          , Gg^Vh       , Gg          , Gg          , Gg          , Gg          , Ggf         , Gg          , Ggf         , Ggf         , Hh          , Hh          , Gg          , Gg          , Gg          , Rr          , Rr          , Gg          , Hh          , Gg          , Gs^Fp       , Hh          , Gg          , Gg          , Gg          , Gg          , Gg          , Gg          
Gg          , Gg          , Hh          , Gg          , Hh          , Gg          , Hh          , Gg          , Hh          , Hh          , Mm          , Hh          , Hh          , Gg          , Hh          , Gg          , Gg          , Gg          , Gg          , Gg          , Re^Gvs      , Re^Gvs      , Gg          , Gg          , Ce          , Ce          , Rr          , Gg          , Gg          , Gg          , Gg          , Gg          , Gg          , Gg          , Gg          , Gg          , Gg          , Gg          
Gg          , Gg          , Gg          , Hh          , Gg          , Hh          , Hh          , Gg          , Hh          , Mm          , Mm          , Mm          , Hh          , Gs^Fp       , Gg          , Hh          , Gg          , Gg          , Gg          , Gg^Vh       , Re^Gvs      , Re^Gvs      , Gg          , Gg          , Gg^Vh       , Rr          , Gg^Vh       , Gg          , Ce          , Gg          , Gg          , Ggf         , Re^Gvs      , Re^Gvs      , Re^Gvs      , Re^Gvs      , Re^Gvs      , Gg          
Rr          , Rr          , Rr          , Gg          , Gg          , Hh          , Gs^Fp       , Hh          , Gg          , Hh          , Gs^Fp       , Hh          , Hh          , Gs^Fp       , Gs^Fp       , Gs^Fp       , Gs^Fp       , Gg          , Gg          , Re^Gvs      , Re^Gvs      , Re^Gvs      , Gg          , Ce          , Ce          , Rr          , Gg          , Ce          , 2 Ke        , Gg          , Ggf         , Ggf         , Re^Gvs      , Re^Gvs      , Re^Gvs      , Re^Gvs      , Gg          , Gg          
Gg          , Gg          , Gg          , Rr          , Rr          , Ce          , Gg^Vh       , Gg          , Rr          , Gg          , Gg          , Gg          , Hh          , Gs^Fp       , Gs^Fp       , Hh          , Hh          , Gg          , Gg          , Gg          , Gg          , Gg          , Gg          , Gg          , Rr          , Rr          , Gg^Vh       , Ce          , Gg          , Gg          , Ggf         , Gg          , Re^Gvs      , Re^Gvs      , Re^Gvs      , Gg          , Gg          , Ggf         
Gg          , Gg          , Gg          , Ce          , Gg^Vh       , Rr          , Rr          , Rr          , Ce          , Rr          , Gg          , Gs^Fp       , Gg          , Gs^Fp       , Gs^Fp       , Gg          , Gg          , Gg          , Gg          , Gg          , Re^Gvs      , Re^Gvs      , Re^Gvs      , Rr          , Gg          , Gs^Fp       , Gg          , Gg          , Gg          , Ggf         , Ggf         , Gg          , Gg^Vh       , Re^Gvs      , Re^Gvs      , Gg          , Gg          , Gg          
Gg          , Gg          , Gg          , Ce          , Ce          , Gg          , Gg^Vh       , Ce          , 3 Ke        , Rr          , Rr          , Gg          , Gg          , Gg          , Gg          , Gg          , Gg          , Gs^Fp       , Gg          , Gg          , Re^Gvs      , Re^Gvs      , Rr          , Rr          , Gg          , Gg          , Gg          , Gg          , Gg          , Gg          , Gg          , Gg          , Re^Gvs      , Re^Gvs      , Gg          , Hh          , Hh          , Hh          
Gg          , Gg          , Gg          , Gg          , Gg          , Gg          , Ce          , Ce          , Gg          , Gg          , Gg          , Rr          , Rr          , Gg          , Gg          , Ggf         , Gg          , Ggf         , Ggf         , Gg          , Gg          , Re^Gvs      , Rr          , Gg          , Gg          , Gg          , Hh          , Hh          , Gg          , Gs^Fp       , Gg          , Gg          , Gg          , Gg          , Gg          , Hh          , Gg          , Gg          
Gs^Fp       , Gs^Fp       , Gs^Fp       , Gg          , Gg          , Gg          , Gg          , Gg          , Gg          , Gg          , Re^Gvs      , Gg          , Re^Gvs      , Rr          , Rr          , Gg          , Gg          , Ggf         , Gg          , Gg          , Gg          , Gg          , Rr          , Gg          , Gg          , Hh          , Hh          , Hh          , Gg          , Gg          , Ggf         , Gg          , Gg          , Ggf         , Gg          , Gg          , Rr          , Rr          
Gg          , Gg          , Gg          , Gg          , Gg          , Gg          , Gg          , Gg          , Gg          , Gg          , Gg          , Re^Gvs      , Re^Gvs      , Re^Gvs      , Gg^Vh       , Rr          , Rr          , Gg          , Gg          , Gg          , Ce          , Ce          , Rr          , Gg          , Ce          , Gg          , Gg          , Gg          , Gg          , Gg          , Gg          , Gg          , Rr          , Rr          , Rr          , Rr          , Gg          , Gg          
Gg          , Gg          , Gg          , Gg          , Gg          , Gg          , Gg          , Gs^Fp       , Gg          , Gg          , Gg          , Gg          , Gs^Fp       , Re^Gvs      , Gg          , Gg          , Gg          , Rr          , Rr          , Gg          , Gg          , Gg          , Rr          , Gg          , Gg          , Ce          , Ce          , Gg          , Gg          , Gg          , Rr          , Rr          , Gg          , Gg          , Gg          , Gg          , Hh          , Hh          
Gg          , Gg          , Gg          , Hh          , Hh          , Gg          , Gg^Vh       , Gs^Fp       , Gs^Fp       , Gg          , Gg          , Gg          , Gg          , Gg          , Hh          , Gg          , Ce          , Ce          , Gg          , Rr          , Gg^Vh       , Gg^Vh       , Rr          , Gg          , Gg^Vh       , Gg          , Gg          , Gg          , Rr          , Rr          , Gg          , Gg          , Gg          , Ggf         , Gg          , Gg          , Hh          , Hh          
Gg          , Gg          , Gg          , Hh          , Re^Gvs      , Re^Gvs      , Re^Gvs      , Gs^Fp       , Gs^Fp       , Gg          , Gs^Fp       , Gg          , Ggf         , Gg          , Hh          , Gg          , Gg          , Gg          , Gg^Vh       , Rr          , Ww^Bw\      , Ww          , Ww^Bw|      , Ww          , Ww          , Gg          , Rr          , Rr          , Gg          , Gg          , Gg          , Gg          , Gg          , Gg          , Gg^Vh       , Gg          , Gg          , Gg          
Gg          , Gg          , Re^Gvs      , Re^Gvs      , Re^Gvs      , Re^Gvs      , Re^Gvs      , Gs^Fp       , Gg          , Gg          , Gg          , Gg          , Gg          , Gg          , Gg          , Gg          , Gg          , Gg          , Gg          , Ww          , Rp^Vhc      , Gg          , Ch          , Rp^Vhc      , Ww^Bw/      , Rr          , Gg^Vh       , Ce          , Ce          , Gg          , Hh          , Gg          , Gs^Fp       , Gg          , Gg          , Gg          , Gg          , Gg          
Gg          , Gg          , Re^Gvs      , Re^Gvs      , Re^Gvs      , Re^Gvs      , Re^Gvs      , Gg          , Ggf         , Gg          , Ggf         , Ggf         , Gg          , Gg          , Gg          , Ce          , Gg^Vh       , Gg          , Gg^Vh       , Ww          , Rp^Vhc      , Ch          , 5 Kh        , Ch          , Rp^Vhc      , Ww          , Gg^Vh       , Gg          , Ce          , Gg          , Gg          , Gg          , Gs^Fp       , Gg          , Gg          , Gg          , Gg          , Gg          
Gg          , Gg          , Gg          , Re^Gvs      , Re^Gvs      , Re^Gvs      , Gg          , Gg          , Ggf         , Gg          , Gg          , Gg          , Hh          , Gg          , Gg          , Ce          , Gg          , Gg          , Gg          , Ww          , Ww^Bw/      , Ch          , Ch          , Ch          , Ww^Bw\      , Ww          , Gg          , Gg          , Gg          , Gg          , Gg          , Gs^Fp       , Gs^Fp       , Hh          , Gg          , Gg          , Gs^Fp       , Gs^Fp       
Gg          , Gg          , Gg^Vh       , Re^Gvs      , Gg          , Gg          , Gg          , Gg          , Gg          , Gg          , Gg          , Hh          , Hh          , Hh          , Gg          , Ce          , Gg^Vh       , Gg          , Rr          , Rr          , Ww          , Rp^Vhc      , Rr          , Rp^Vhc      , Ww          , Ww^Bw\      , Rr          , Rr          , Rr          , Gg          , Ggf         , Gg          , Gg          , Gg          , Gs^Fp       , Gs^Fp       , Gs^Fp       , Gs^Fp       
Gg          , Gg          , Gg          , Gg          , Gg          , Gg          , Gg          , Gg          , Gg          , Ggf         , Ggf         , Gg          , Gg          , Gg          , Gg          , Gg          , Rr          , Gg          , Rr          , Gg^Vh       , Ww          , Ww          , Ww          , Ww^Bw|      , Ww          , Ww          , Ww          , Gg^Vh       , Gg          , Rr          , Rr          , Gg          , Ggf         , Gg          , Gg          , Gs^Fp       , Gg          , Gg          
Gg          , Gg          , Gg          , Gg          , Gg          , Gs^Fp       , Gg          , Ce          , Ce          , Gg          , Gg          , Ggf         , Rr          , Gg          , Rr          , Rr          , Ce          , Rr          , Gg          , Gg^Vh       , Ww          , Gg^Vh       , Gg          , Rr          , Gg^Vh       , Ww          , Ww          , Ww          , Ww          , Gg          , Gg          , Rr          , Gg          , Gg          , Gg          , Gg          , Ww          , Ww          
Gs^Fp       , Gs^Fp       , Gs^Fp       , Re^Gvs      , Re^Gvs      , Re^Gvs      , Gg          , Gg^Vh       , 4 Ke        , Ce          , Rr          , Rr          , Gg          , Rr          , Gg          , Gg          , Gg          , Ce          , Ww          , Ww          , Ss          , Gg          , Gg          , Rr          , Rr          , Gg          , Ss          , Ww          , Ww          , Ww          , Ww          , Rr          , Ww^Bw\      , Ww          , Ww          , Ww          , Wo          , Wo          
Gg          , Gg          , Gg          , Gg          , Gg          , Re^Gvs      , Gg^Vh       , Rr          , Rr          , Rr          , Gg^Vh       , Gg          , Re^Gvs      , Gg          , Re^Gvs      , Gg          , Gg          , Gg          , Ww          , Ww          , Ss          , Gg          , Ss          , Gg          , Gg          , Rr          , Ww          , Ww          , Wo          , Ww          , Wo          , Ww          , Wo          , Ww^Bw\      , Ww^Bw\      , Wo          , Ww^Bw\      , Ww^Bw\      
Gg          , Gg          , Gg          , Gs^Fp       , Gg          , Gg          , Gg          , Ce          , Rr          , Gg^Vh       , Ce          , Re^Gvs      , Re^Gvs      , Re^Gvs      , Re^Gvs      , Hh          , Gg          , Ww          , Ww          , Ww          , Ww          , Ss          , Ww          , Ss          , Ww          , Ww^Bw|      , Ww          , Wo          , Ww          , Wo          , Ww          , Wo          , Ww          , Ww          , Ww          , Gg^Vh       , Re^Gvs      , Gg          
Gg          , Gg          , Gg          , Gg          , Gg          , Gg          , Rr          , Gg          , Rr          , Ce          , Gg          , Gg          , Gg          , Gg          , Gg          , Hh          , Ww          , Ww          , Ww          , Ww          , Ww          , Wo          , Wo          , Wo          , Ww          , Ww^Bw|      , Ww          , Ww          , Ww          , Ww          , Gg          , Gg          , Gg          , Gg          , Gg          , Gg          , Re^Gvs      , Gg          
Gg          , Gg          , Gg          , Gg          , Rr          , Rr          , Gg          , Rr          , Gg          , Gg          , Gg          , Gg          , Gg          , Ww          , Ww          , Ww          , Ww          , Ww          , Wo          , Wo          , Ww          , Ww          , Ww          , Ww          , Gg          , Rr          , Gg          , Gg          , Gg          , Gg          , Hh          , Gg          , Gg          , Re^Gvs      , Re^Gvs      , Re^Gvs      , Re^Gvs      , Gg          
Gg          , Gg          , Gg          , Rr          , Rr          , Gg          , Gg          , Gg          , Gg          , Gg          , Ww          , Ww          , Ww          , Ww          , Wo          , Wo          , Wo          , Wo          , Ww          , Ww          , Gg          , Gg          , Gg          , Gg          , Gg          , Gg          , Gg          , Gg          , Gg          , Gg          , Gg          , Gg          , Re^Gvs      , Re^Gvs      , Re^Gvs      , Re^Gvs      , Re^Gvs      , Gg          
Gg          , Gg          , Gg          , Rr          , Rr          , Gg          , Gg          , Gg          , Gg          , Gg          , Ww          , Ww          , Ww          , Ww          , Wo          , Wo          , Wo          , Wo          , Ww          , Ww          , Gg          , Gg          , Gg          , Gg          , Gg          , Gg          , Gg          , Gg          , Re^Gvs      , Re^Gvs      , Re^Gvs      , Re^Gvs      , Gg          , Re^Gvs      , Gg          , Re^Gvs      , Gg          , Gg          
