border_size=1
usage=map

Xu          , Xu          , Xu          , Xu          , Xu          , Xu          , Xu          , Xu          , Xu          , Xu          , Xu          , Xu          , Xu          , Xu          , Xu          , Xu          , Xu          , Xu          , Xu          , Xu          , Xu          , Xu          , Xu          , Xu          , Xu          , Xu          , Xu          , Xu          , Xu          , Xu          , Xu          , Xu          , Xu          , Xu          , Xu          , Xu          , Xu          , Xu          , Xu          , Xu          , Xu          , Xu          , Xu          
Xu          , Xu          , Xu          , Xu          , Xu          , Xu          , Xu          , Xu          , Xu          , Xu          , Xu          , Xu          , Xu          , Xu          , Xu          , Xu          , Xu          , Xu          , Xu          , Xu          , Xu          , Xu          , Xu          , Xu          , Xu          , Xu          , Xu          , Xu          , Xu          , Xu          , Xu          , Xu          , Xu          , Xu          , Xu          , Xu          , Xu          , Xu          , Xu          , Xu          , Xu          , Xu          , Xu          
Xu          , Xu          , Xu          , Xu          , Xu          , Xu          , Xu          , Xu          , Xu          , Xu          , Xu          , Xu          , Xu          , Xu          , Xu          , Xu          , Xu          , Xu          , Xu          , Xu          , Xu          , Xu          , Xu          , Xu          , Xu          , Xu          , Xu          , Xu          , Xu          , Xu          , Xu          , Xu          , Xu          , Xu          , Xu          , Xu          , Xu          , Xu          , Xu          , Xu          , Xu          , Xu          , Xu          
Xu          , Xu          , Xu          , Xu          , Xu          , Xu          , Xu          , Xu          , Xu          , Xu          , Xu          , Xu          , Xu          , Xu          , Xu          , Xu          , Xu          , Xu          , Xu          , Xu          , Xu          , Xu          , Xu          , Xu          , Xu          , Xu          , Xu          , Xu          , Xu          , Xu          , Xu          , Xu          , Xu          , Xu          , Xu          , Xu          , Xu          , Xu          , Xu          , Xu          , Xu          , Xu          , Xu          
Xu          , Xu          , Xu          , Xu          , Xu          , Xu          , Xu          , Xu          , Xu          , Xu          , Xu          , Xu          , Xu          , Xu          , Xu          , Xu          , Xu          , Xu          , Xu          , Xu          , Xu          , Xu          , Xu          , Xu          , Xu          , Xu          , Xu          , Xu          , Uh          , Uh          , Uh          , Xu          , Xu          , Xu          , Xu          , Xu          , Xu          , Xu          , Xu          , Xu          , Xu          , Xu          , Xu          
Xu          , Xu          , Xu          , Xu          , Xu          , Xu          , Xu          , Xu          , Xu          , Xu          , Xu          , Xu          , Xu          , Xu          , Xu          , Xu          , Xu          , Xu          , Xu          , Xu          , Xu          , Xu          , Xu          , Xu          , Xu          , Xu          , Xu          , Xu          , Uu          , Uu          , Uh          , Uh          , Xu          , Xu          , Xu          , Xu          , Xu          , Xu          , Xu          , Xu          , Xu          , Xu          , Xu          
Xu          , Xu          , Xu          , Xu          , Xu          , Xu          , Xu          , Xu          , Xu          , Xu          , Xu          , Xu          , Xu          , Xu          , Xu          , Xu          , Xu          , Xu          , Xu          , Xu          , Xu          , Xu          , Xu          , Xu          , Xu          , Xu          , Uu          , Re          , Uu          , Uu^Vu       , Re          , Uu          , Xu          , Xu          , Xu          , Xu          , Xu          , Xu          , Xu          , Xu          , Xu          , Xu          , Xu          
Xu          , Xu          , Xu          , Xu          , Xu          , Xu          , Xu          , Xu          , Xu          , Xu          , Xu          , Xu          , Xu          , Xu          , Xu          , Xu          , Xu          , Xu          , Xu          , Xu          , Xu          , Xu          , Xu          , Xu          , Re          , Re          , Xu          , Uu          , Re          , Uu          , Uu          , Uu          , Xu          , Xu          , Xu          , Xu          , Xu          , Xu          , Xu          , Xu          , Xu          , Xu          , Xu          
Xu          , Xu          , Xu          , Xu          , Xu          , Xu          , Xu          , Xu          , Xu          , Xu          , Xu          , Xu          , Xu          , Xu          , Xu          , Xu          , Xu          , Xu          , Xu          , Xu          , Xu          , Xu          , Uu          , Uu          , Xu          , Xu          , Xu          , Xu          , Re          , Xu          , Xu          , Re          , Re          , Xu          , Xu          , Xu          , Xu          , Xu          , Xu          , Xu          , Xu          , Xu          , Xu          
Xu          , Xu          , Xu          , Xu          , Xu          , Xu          , Xu          , Xu          , Xu          , Xu          , Xu          , Xu          , Xu          , Xu          , Re          , Xu          , Xu          , Xu          , Xu          , Xu          , Xu          , Re          , Uh          , Xu          , Xu          , Xu          , Xu          , Re          , Xu          , Xu          , Xu          , Xu          , Re          , Xu          , Xu          , Xu          , Xu          , Xu          , Xu          , Xu          , Xu          , Xu          , Xu          
Xu          , Xu          , Xu          , Xu          , Xu          , Xu          , Xu          , Xu          , Xu          , Xu          , Uu          , Xu          , Uu          , Re          , Xu          , Re          , Uh          , Xu          , Uu          , Re          , Re          , Re          , Xu          , Xu          , Xu          , Xu          , Xu          , Uu          , Uu          , Uu          , Uu          , Uu          , Uu          , Uu          , Xu          , Xu          , Xu          , Xu          , Xu          , Xu          , Mm          , Mm          , Mm          
Xu          , Xu          , Xu          , Xu          , Xu          , Xu          , Xu          , Xu          , Re          , Re          , Xu          , Uh          , Xu          , Xu          , Xu          , Xu          , Xu          , Uh          , Xu          , Xu          , Xu          , Xu          , Xu          , Xu          , Xu          , Xu          , Xu          , Xu          , Uu          , Xu          , Xu          , Xu          , Xu          , Xu          , Xu          , Xu          , Xu          , Xu          , Xu          , Mm          , Ha          , Ha          , Ha          
Xu          , Xu          , Xu          , Xu          , Xu          , Xu          , Xu          , Xu          , Uu          , Xu          , Xu          , Xu          , Uu          , Xu          , Uu          , Xu          , Xu          , Xu          , Xu          , Xu          , Uu          , Uu          , Xu          , Xu          , Xu          , Xu          , Xu          , Xu          , Xu          , Re          , Re          , Xu          , Xu          , Xu          , Xu          , Xu          , Xu          , Xu          , Xu          , Mm          , Ha^Fpa      , Gg          , Gg          
Xu          , Xu          , Xu          , Xu          , Xu          , Xu          , Uh          , Uu          , Xu          , Xu          , Uu          , Uu          , Uu          , Uu          , Uu^Vu       , Xu          , Xu          , Xu          , Xu          , Xu          , Uu          , Xu          , Xu          , Xu          , Xu          , Xu          , Xu          , Xu          , Xu          , Xu          , Re          , Xu          , Xu          , Xu          , Xu          , Xu          , Xu          , Xu          , Mm          , Mm          , Ha^Fpa      , Aa^Fpa      , Aa^Fpa      
Xu          , Xu          , Xu          , Xu          , Xu          , Xu          , Uh          , Uu^Vu       , Uu          , Uu          , Re          , Uu          , Uu^Vu       , Uu          , Uu          , Uu          , Uu          , Xu          , Uu          , Uu          , Uu          , Uu          , Uu          , Uu          , Uu          , Xu          , Xu          , Xu          , Xu          , Xu          , Uu          , Xu          , Xu          , Xu          , Xu          , Xu          , Xu          , Mm          , Ha^Fpa      , Ha^Fpa      , Gg          , Aa^Fpa      , Aa^Fpa      
Xu          , Xu          , Xu          , Xu          , Xu          , Xu          , Uu          , Uu          , Uu          , Uu          , Re          , Uu          , Uu          , Uu          , Cud         , Uu          , Uu          , Uu          , Uu^Vu       , Re          , Uu          , Uu          , Re          , Uu          , Uu          , Uu          , Uh          , Xu          , Xu          , Uu          , Xu          , Xu          , Xu          , Xu          , Xu          , Xu          , Xu          , Mm          , Ha^Fpa      , Aa^Fpa      , Gg          , Aa^Fpa      , Aa^Fpa      
Xu          , Xu          , Xu          , Xu          , Xu          , Xu          , Uu          , Uu^Vu       , Uu          , Uu          , Uu          , Uu          , Uu          , Cud         , 2 Kud       , Cud         , Uu          , Uu          , Uu          , Uh          , Uh          , Uu^Vu       , Uu          , Re          , Uu          , Uu          , Uh          , Uh          , Xu          , Uu          , Xu          , Xu          , Xu          , Xu          , Xu          , Xu          , Mm          , Mm          , Ha          , Aa^Fpa      , Gg          , Gg          , Gg          
Xu          , Xu          , Xu          , Xu          , Xu          , Xu          , Uu          , Uu          , Re          , Re          , Uu          , Uu          , Uu          , Cud         , Cud         , Cud         , Re          , Uu          , Uh          , Uh          , Xu          , Xu          , Xu          , Uu          , Uu          , Uu          , Re          , Uu          , Uu          , Uu          , Uu          , Xu          , Uu          , Xu          , Uu          , Xu          , Uh          , Ha          , Gg          , Gg          , Aa^Fpa      , Gg          , Gg          
Xu          , Xu          , Xu          , Xu          , Xu          , Xu          , Uu^Vu       , Uu          , Uu          , Uu          , Uu          , Uu          , Uu          , Uu          , Uu          , Re          , Uu          , Uu          , Uh          , Xu          , Xu          , Xu          , Xu          , Xu          , Xu          , Uu          , Uu          , Re          , Uu          , Uu          , Re          , Uu          , Re          , Uu^Vu       , Uu          , Cud         , Uu^Ii       , Uu^Ii       , Gg          , Gg          , Gg          , Gg          , Gg          
Xu          , Xu          , Xu          , Xu          , Xu          , Xu          , Xu          , Uu          , Uu^Vu       , Uu          , Uu          , Uu          , Uu          , Uu          , Uu          , Uu^Vu       , Uu          , Uh          , Uh          , Xu          , Xu          , Xu          , Uu          , Xu          , Uu          , Uu^Vu       , Xu          , Uu          , Uu          , Uu          , Uu^Vu       , Re          , Uu          , Uu          , Uu          , 1 Kud       , Uh          , Uu^Ii       , Ha          , Gg          , Aa^Fpa      , Gg          , Gg          
Xu          , Xu          , Xu          , Xu          , Xu          , Xu          , Xu          , Uu          , Uu          , Uu          , Uu          , Uu          , Uu^Vu       , Uu          , Re          , Uu          , Uu          , Uh          , Uh          , Xu          , Uu          , Uu          , Xu          , Uu          , Xu          , Xu          , Xu          , Xu          , Xu          , Uu          , Uh          , Uh          , Xu          , Uh          , Xu          , Xu          , Xu          , Mm          , Mm          , Ha^Fpa      , Aa^Fpa      , Gg          , Gg          
Xu          , Xu          , Xu          , Xu          , Xu          , Xu          , Xu          , Uu          , Uu          , Uu          , Uu          , Uu          , Uu          , Uu          , Re          , Uu          , Uu          , Uh          , Xu          , Xu          , Uu          , Xu          , Xu          , Xu          , Xu          , Xu          , Xu          , Xu          , Xu          , Xu          , Xu          , Xu          , Xu          , Xu          , Xu          , Xu          , Xu          , Xu          , Ha          , Ha          , Gg          , Aa^Fpa      , Aa^Fpa      
Xu          , Xu          , Xu          , Xu          , Xu          , Xu          , Xu          , Xu          , Xu          , Uu          , Uu          , Xu          , Uu          , Uu          , Re          , Uu          , Uu          , Uu          , Uu          , Uu^Vu       , Xu          , Xu          , Xu          , Xu          , Xu          , Uu          , Xu          , Xu          , Xu          , Xu          , Xu          , Xu          , Xu          , Xu          , Xu          , Xu          , Xu          , Xu          , Mm          , Ha          , Ha          , Ha^Fpa      , Gg          
Xu          , Xu          , Xu          , Xu          , Xu          , Xu          , Xu          , Xu          , Xu          , Xu          , Xu          , Uu          , Xu          , Uu          , Uu          , Uu          , Re          , Uu          , Uu          , Uu          , Uu          , Xu          , Xu          , Xu          , Xu          , Uu          , Uu          , Xu          , Xu          , Xu          , Xu          , Xu          , Xu          , Xu          , Uh          , Xu          , Xu          , Xu          , Xu          , Mm          , Mm          , Ha          , Ha          
Xu          , Xu          , Xu          , Xu          , Xu          , Xu          , Xu          , Xu          , Xu          , Xu          , Xu          , Xu          , Xu          , Uu          , Xu          , Xu          , Uu          , Re          , Uu^Vu       , Uu          , Re          , Uu          , Uu          , Xu          , Cud         , Xu          , Uu          , Xu          , Xu          , Xu          , Uh          , Xu          , Uu          , Uu          , Xu          , Xu          , Xu          , Xu          , Xu          , Xu          , Xu          , Mm          , Mm          
Xu          , Xu          , Xu          , Xu          , Xu          , Xu          , Xu          , Xu          , Xu          , Xu          , Xu          , Xu          , Xu          , Uu^Vu       , Re          , Xu          , Xu          , Uu          , Uu          , Uu          , Uu          , Re          , Uu          , Re          , Cud         , Uu          , Uu^Uf       , Uu^Uf       , Uu          , Uh          , Uu          , Uu          , Uh          , Xu          , Xu          , Xu          , Xu          , Xu          , Xu          , Xu          , Xu          , Xu          , Xu          
Xu          , Xu          , Xu          , Xu          , Xu          , Xu          , Xu          , Xu          , Xu          , Xu          , Xu          , Xu          , Xu          , Xu          , Re          , Xu          , Xu          , Xu          , Xu          , Uu          , Re          , Uu          , Xu          , Uu          , Xu          , Uu          , Uu          , Uu^Uf       , Uu          , Uu          , Uu          , Uu          , Xu          , Xu          , Xu          , Xu          , Xu          , Xu          , Xu          , Xu          , Xu          , Xu          , Xu          
Xu          , Xu          , Xu          , Xu          , Xu          , Xu          , Xu          , Xu          , Xu          , Xu          , Xu          , Xu          , Xu          , Xu          , Uu^Vu       , Xu          , Xu          , Xu          , Xu          , Uu          , Re          , Uu          , Xu          , Xu          , Xu          , Uu          , Uh          , Uu          , Uu          , Uu          , Uu^Uf       , Uu^Uf       , Uu          , Xu          , Xu          , Xu          , Uu          , Uu^Uf       , Uu^Uf       , Xu          , Xu          , Xu          , Xu          
Mm          , Mm          , Mm          , Xu          , Xu          , Xu          , Xu          , Xu          , Xu          , Xu          , Xu          , Xu          , Xu          , Xu          , Xu          , Re          , Re          , Xu          , Uu          , Uu          , Uu          , Uu          , Xu          , Xu          , Xu          , Uh          , Uu          , Uu          , Uu          , Uu          , Uu          , Uu^Uf       , Uu          , Cud         , Uu          , Uu          , Uu          , Uu          , Uu          , Uu          , Xu          , Xu          , Xu          
Ha          , Ha          , Ha          , Mm          , Xu          , Xu          , Xu          , Xu          , Xu          , Xu          , Xu          , Xu          , Xu          , Xu          , Xu          , Xu          , Xu          , Uu          , Re          , Re          , Uu          , Xu          , Xu          , Xu          , Xu          , Uh          , Uh          , Uh          , Uu          , Uu          , Uu          , Uu          , Xu          , Xu          , Uu          , Uu          , Uu          , Uu          , Uu^Uf       , Uu^Uf       , Xu          , Xu          , Xu          
Gg          , Gg          , Ha          , Mm          , Mm          , Xu          , Mm          , Xu          , Xu          , Xu          , Xu          , Xu          , Xu          , Xu          , Xu          , Xu          , Uu          , Uu          , Uu          , Uu          , Xu          , Xu          , Xu          , Xu          , Xu          , Xu          , Xu          , Uu          , Uu          , Uu          , Uh          , Uh          , Xu          , Xu          , Uu^Uf       , Uu          , Uu          , Uu          , Uu          , Uu^Uf       , Xu          , Xu          , Xu          
Gg          , Gg          , Gg          , Ha          , Ha          , Mm          , Ha          , Mm          , Mm          , Xu          , Xu          , Xu          , Uu          , Xu          , Uu          , Uu          , Re          , Re          , Uu          , Uu          , Xu          , Xu          , Xu          , Xu          , Xu          , Xu          , Xu          , Xu          , Cud         , Uu          , Xu          , Xu          , Xu          , Xu          , Xu          , Uu          , Uu^Uf       , Uu          , Xu          , Xu          , Xu          , Xu          , Xu          
Aa^Fpa      , Aa^Fpa      , Gg          , Gg          , Gg          , Ha          , Gg          , Ha          , Ha          , Uh          , Uu^Ii       , Cud         , Uu          , Uu          , Uu          , Re          , Uu^Vu       , Uu          , Uu          , Uu          , Uh          , Xu          , Uh          , Xu          , Xu          , Xu          , Xu          , Xu          , Uu          , Cud         , Xu          , Xu          , Xu          , Xu          , Xu          , Xu          , Xu          , Xu          , Xu          , Xu          , Xu          , Xu          , Xu          
Aa^Fpa      , Aa^Fpa      , Gg          , Aa^Fpa      , Gg          , Gg          , Gg          , Gg          , Re          , Gg          , Uu^Ii       , Cud         , Cud         , Uu^Vu       , Xu          , Xu          , Xu          , Uh          , Uh          , Re          , Uu          , Uu          , Uh          , Uh          , Uh          , Xu          , Xu          , Xu          , Re          , Re          , Xu          , Xu          , Xu          , Xu          , Xu          , Xu          , Xu          , Xu          , Xu          , Xu          , Xu          , Xu          , Xu          
Gg          , Gg          , Gg          , Gg          , Gg          , Gg          , Gg          , Re          , Aa          , Gg          , Mm          , Uh          , Xu          , Xu          , Xu          , Xu          , Xu          , Xu          , Uh          , Re          , Uu          , Uu^Vu       , Uu          , Uh          , Uu          , Uh          , Uu^Vu       , Uu          , Uu          , Uu          , Xu          , Xu          , Xu          , Xu          , Xu          , Xu          , Xu          , Xu          , Xu          , Xu          , Xu          , Xu          , Xu          
Gg          , Gg          , Aa          , Gg          , Re          , Re          , Gg          , Aa^Fpa      , Gg          , Ha          , Mm          , Xu          , Xu          , Xu          , Xu          , Xu          , Xu          , Xu          , Uu          , Uu^Vu       , Uu          , Re          , Uu          , Uu^Vu       , Uu          , Uu          , Uu          , Re          , Uu          , Uu          , Uu          , Xu          , Xu          , Xu          , Xu          , Xu          , Xu          , Xu          , Xu          , Xu          , Xu          , Xu          , Xu          
Gg          , Gg          , Gg          , Aa          , Re          , Gg          , Gg          , Aa^Fpa      , Ha^Fpa      , Ha          , Mm          , Xu          , Xu          , Xu          , Xu          , Xu          , Xu          , Xu          , Uu          , Uu          , Re          , Uu          , Uu^Vu       , Re          , Uu          , Uu^Vu       , Uu          , Re          , Uu          , Uu^Vu       , Uh          , Uh          , Xu          , Xu          , Xu          , Xu          , Xu          , Xu          , Xu          , Xu          , Xu          , Xu          , Xu          
Gg          , Gg          , Re          , Gg          , Aa          , Gg          , Gg          , Gg          , Ha          , Mm          , Mm          , Xu          , Xu          , Xu          , Xu          , Xu          , Uh          , Uu          , Uu^Vu       , Re          , Uu^Vu       , Uu          , Uu          , Uu          , Uu          , Re          , Re          , Uu          , Uu^Vu       , Uu          , Uu          , Uh          , Xu          , Xu          , Xu          , Xu          , Xu          , Xu          , Xu          , Xu          , Xu          , Xu          , Xu          
Re          , Re          , Gg          , Aa          , Gg          , Gg          , Gg          , Aa^Fpa      , Ha          , Mm          , Xu          , Xu          , Xu          , Xu          , Uh          , Uh          , Uu          , Uu          , Re          , Uu          , Uu          , Uu          , Cud         , Uu          , Uu^Vu       , Uu          , Uu          , Uu          , Re          , Uu          , Uu^Vu       , Uh          , Uh          , Xu          , Xu          , Xu          , Xu          , Xu          , Xu          , Xu          , Xu          , Xu          , Xu          
Gg          , Gg          , Gg          , Gg          , Gg          , Aa^Fpa      , Gg          , Gg          , Ha          , Mm          , Xu          , Xu          , Xu          , Uh          , Uh          , Uh          , Uu          , Uu^Vu       , Uu          , Re          , Uu          , Uu          , Uu          , Uu          , Uu          , Uu          , Re          , Uu          , Uu^Vu       , Re          , Re          , Uu          , Uh          , Xu          , Xu          , Xu          , Xu          , Xu          , Xu          , Xu          , Xu          , Xu          , Xu          
Gg          , Gg          , Gg          , Gg          , Aa          , Aa^Fpa      , Ha^Fpa      , Ha          , Mm          , Mm          , Xu          , Xu          , Xu          , Uh          , Uu          , Uu^Vu       , Uu          , Uu          , Re          , Uu          , Uu          , Uu^Vu       , Uu          , Uu          , Uu          , Uu^Vu       , Re          , Uu          , Uu          , Uu          , Uh          , Uu          , Xu          , Xu          , Xu          , Xu          , Xu          , Xu          , Xu          , Xu          , Xu          , Xu          , Xu          
Gg          , Gg          , Gg          , Gg          , Aa          , Aa^Fpa      , Ha^Fpa      , Ha^Fpa      , Mm          , Mm          , Xu          , Xu          , Xu          , Uh          , Uu          , Uu          , Uu          , Uu          , Re          , Uu          , Uu          , Uu          , Uu          , Uu          , Uu          , Uu          , Re          , Uu          , Uu          , Uu          , Uh          , Uu          , Xu          , Xu          , Xu          , Xu          , Xu          , Xu          , Xu          , Xu          , Xu          , Xu          , Xu          
