border_size=1
usage=map

Wo          , Wo          , Ww          , Ww          , Ai          , Ai          , Ha          , Ai          , Ha          , Ha          , Mm          , Ha          , Mm          , Mm          , Mm          , Mm          , Mm          , Mm          , Mm          , Mm          , Mm          , Mm          , Mm          , Mm          , Mm          , Mm          , Mm          , Mm          , Mm          , Ha          , Ha          , Ha          , Ha          , Ha          , Mm          , Mm          , Mm          , Ha          , Mm          , Ha          , Mm          , Ha          , Mm          , Ha          , Ha          , Ha          , Ha          , Ai          , Ai          , Ww          , Ww          , Wo          , Wo          , Wo          , Wo          
Wo          , Wo          , Ww          , Ww          , Ai          , Ai          , Ha          , Ai          , Ha          , Ha          , Mm          , Ha          , Mm          , Mm          , Mm          , Mm          , Mm          , Mm          , Mm          , Mm          , Mm          , Mm          , Mm          , Mm          , Mm          , Mm          , Mm          , Mm          , Mm          , Ha          , Ha          , Ha          , Ha          , Ha          , Mm          , Mm          , Mm          , Ha          , Mm          , Ha          , Mm          , Ha          , Mm          , Ha          , Ha          , Ha          , Ha          , Ai          , Ai          , Ww          , Ww          , Wo          , Wo          , Wo          , Wo          
Ww          , Ww          , Ai          , Ai          , Ha          , Ha          , Mm          , Ha          , Mm          , Mm          , Ha          , Mm          , Aa          , Mm          , Ha          , Mm          , Ha          , Mm          , Mm          , Mm          , Mm          , Mm          , Ha          , Mm          , Mm          , Mm          , Mm          , Mm          , Ha          , Ha          , Ha          , Aa          , Aa          , Ha          , Ha          , Ha          , Mm          , Mm          , Mm          , Mm          , Mm          , Mm          , Mm          , Ha          , Ha          , Mm          , Ha          , Ai          , Ai          , Ai          , Ai          , Ww          , Ww          , Wo          , Wo          
Ai          , Ai          , Ha          , Ha          , Mm          , Mm          , Mm          , Mm          , Ha          , Ha          , Aa          , Cud         , Cud         , Aa          , Aa          , Aa          , Aa          , Ha          , Ha          , Mm          , Mm          , Ha          , Mm          , Mm          , Mm          , Mm          , Mm          , Ha          , Ha          , Ha          , Ha          , Aa          , Aa          , Ha          , Mm          , Mm          , Mm^Vhh      , Mm          , Mm          , Mm          , Ha          , Mm          , Ha          , Ha          , Mm          , Mm^Vhh      , Mm          , Ha          , Ha          , Ha          , Ai          , Ai          , Ww          , Ww          , Ww          
Ai          , Ai          , Ha          , Mm          , Mm          , Mm          , Mm          , Mm          , Ha          , Aa          , Aa          , Cud         , Kud         , Cud         , Cud         , Aa          , Aa          , Aa          , Ha          , Ha          , Ha^Vca      , Mm          , Mm          , Mm          , Mm          , Mm          , Mm          , Mm          , Mm          , Mm          , Mm          , Ha          , Aa          , Ha          , Mm          , Mm          , Mm          , Mm          , Mm          , Mm          , Ha          , Ha          , Ha          , Mm          , Mm          , Mm          , Mm          , Mm          , Mm          , Ha          , Ai          , Ww          , Ww          , Wo          , Wo          
Ha          , Ha          , Ha          , Mm          , Mm          , Mm          , Mm          , Mm          , Ha          , Aa          , Aa          , Cud         , Cud         , Cud         , Aa          , Aa          , Aa          , Aa          , Ha          , Mm          , Ha          , Mm          , Mm          , Mm          , Mm          , Mm          , Mm          , Mm          , Mm          , Mm          , Ha          , Ha          , Ha^Vca      , Ha          , Ha          , Mm          , Mm          , Mm          , Mm          , Ha          , Ce          , Ce          , Ce          , Ha          , Ha          , Mm          , Ha          , Mm          , Ha          , Ha          , Ai          , Ww          , Ww          , Wo          , Wo          
Ha          , Ha          , Aa          , Ha          , Ha          , Mm          , Mm          , Mm          , Mm          , Ha          , Mm          , Cud         , Aa          , Aa          , Ha          , Ha          , Ha          , Mm          , Mm          , Mm          , Mm          , Ha          , Mm          , Mm          , Mm          , Mm          , Ha          , Mm          , Ha          , Ha          , Aa          , Ha          , Aa          , Ha          , Mm          , Mm          , Mm          , Mm          , Mm          , Ha          , Ce          , 2 Ke        , Ce          , Ha          , Mm          , Ha          , Mm          , Ha          , Ha          , Ai          , Ai          , Ww          , Ww          , Wo          , Wo          
Aa          , Aa          , Aa          , Ha          , Ha          , Mm          , Mm          , Mm          , Mm          , Mm          , Re          , Re          , Mm          , Ha          , Mm          , Mm          , Mm          , Mm          , Mm          , Mm          , Mm          , Ha          , Ha          , Mm          , Ha          , Ha          , Aa          , Ha          , Gg          , Ha          , Gg          , Aa          , Ha          , Ha          , Mm          , Mm          , Mm          , Ha          , Mm          , Ha          , Ha          , Ce          , Ha          , Ha          , Mm          , Mm          , Mm          , Mm          , Ha          , Ww          , Ww          , Ww          , Ww          , Wo          , Wo          
Aa          , Aa          , Aa          , Aa          , Ha          , Mm          , Mm          , Mm          , Mm          , Re          , Mm          , Mm          , Mm          , Mm          , Mm          , Mm          , Mm          , Ha          , Ha          , Mm          , Ha          , Mm          , Ha          , Ha          , Aa          , Ha          , Gg          , Aa          , Ha          , Gg          , Ha          , Ha          , Mm          , Ha          , Mm          , Mm          , Mm          , Ha          , Ha          , Ha          , Mm          , Ha          , Mm          , Mm          , Mm          , Mm          , Mm          , Ha          , Ha          , Ww          , Ai          , Ww          , Ww          , Wo          , Wo          
Gg          , Gg          , Aa          , Aa          , Mm          , Mm          , Mm          , Mm          , Mm          , Re          , Mm          , Mm          , Mm^Vc       , Mm          , Mm          , Mm          , Mm          , Mm          , Ha          , Ha          , Aa          , Ha          , Aa          , Aa          , Ha          , Gg          , Ha          , Ha          , Mm          , Ha          , Mm          , Ha          , Mm          , Mm          , Mm          , Mm          , Mm^Vc       , Mm          , Mm          , Ha          , Mm          , Mm          , Mm          , Mm          , Mm          , Mm          , Ha          , Ha          , Ai          , Ai          , Ww          , Ww          , Ww          , Ww          , Ww          
Gg          , Gg          , Ha          , Ha          , Ha          , Mm          , Mm          , Mm          , Ha          , Re          , Mm          , Mm          , Mm          , Mm          , Mm          , Mm          , Mm          , Ha          , Ha          , Aa          , Aa          , Aa          , Ha          , Gg          , Mm          , Mm          , Mm          , Mm          , Mm          , Mm          , Mm          , Mm          , Mm          , Mm          , Mm          , Mm          , Mm          , Mm          , Mm          , Mm          , Ha          , Ha          , Ha          , Ha          , Mm          , Ha          , Ha          , Ai          , Ai          , Ww          , Ww          , Wo          , Ww          , Ww          , Ww          
Ha          , Ha          , Mm          , Mm          , Mm          , Mm          , Mm          , Ha          , Ha          , Re          , Mm          , Mm          , Mm          , Mm          , Mm          , Mm          , Ha          , Mm          , Ha          , Aa          , Aa          , Aa          , Re          , Ha          , Mm          , Mm          , Mm          , Mm          , Mm          , Mm          , Mm          , Mm          , Mm          , Mm          , Ha          , Mm          , Mm          , Mm          , Mm          , Mm          , Ha          , Ha          , Ai          , Ai          , Ha          , Ha          , Ha          , Ai          , Ai          , Ww          , Ww          , Ww          , Ww          , Ai          , Ai          
Mm          , Mm          , Mm          , Mm          , Mm          , Mm          , Mm          , Mm          , Re          , Mm          , Mm          , Mm          , Mm          , Mm          , Ha          , Mm          , Ha          , Ha          , Gg          , Gg          , Re          , Re          , Re          , Re          , Re          , Mm          , Re          , Mm          , Re          , Mm          , Re          , Mm          , Mm          , Mm          , Ha          , Ha          , Ha          , Mm          , Ha          , Ha          , Ai          , Ai          , Ai          , Ha          , Ai          , Ai          , Ai          , Ai          , Ww          , Ww          , Ww          , Ww          , Ai          , Ai          , Ai          
Mm          , Mm          , Ha          , Mm          , Ha          , Mm          , Ha          , Mm          , Re          , Mm          , Ha          , Mm          , Ha          , Mm          , Ha          , Ha          , Aa          , Gg          , Re          , Re          , Aa          , Aa          , Mm          , Aa          , Aa          , Re          , Mm          , Re          , Mm          , Re          , Mm          , Re          , Re          , Re          , Ai          , Ha          , Ai          , Ha          , Ai          , Ha          , Ai          , Ww          , Ai          , Ai          , Ww          , Ww          , Ww          , Ww          , Ww          , Ww          , Ai          , Ai          , Ha          , Ha          , Ha          
Ha          , Ha          , Aa          , Ha          , Aa          , Ha          , Gg          , Ha          , Re          , Ha          , Re          , Ha          , Ha          , Ha          , Aa          , Aa          , Re          , Re          , Aa          , Re          , Mm          , Mm          , Mm          , Aa          , Mm          , Mm          , Ha          , Mm          , Ha          , Mm          , Ha          , Ha          , Ww          , Re          , Ww          , Ai          , Ai          , Ai          , Ai          , Ai          , Ww          , Ww          , Ww          , Ww          , Wo          , Wo          , Ww          , Wo          , Ai          , Ai          , Ha          , Ha          , Mm          , Mm          , Mm          
Aa          , Aa          , Aa          , Aa          , Aa          , Aa          , Gg          , Gg          , Gg          , Re          , Gg          , Re          , Re          , Re          , Re          , Re          , Aa          , Re          , Ha          , Ha          , Mm          , Mm          , Mm          , Mm          , Ha          , Ha          , Ai          , Ha          , Ww          , Ha          , Ww          , Ha          , Ww          , Ww^Bw|      , Ww          , Ww          , Ww          , Ai          , Ww          , Ww          , Wo          , Wo          , Wo          , Wo          , Ww          , Wo          , Ww          , Ww          , Ha          , Ha          , Mm          , Mm          , Mm          , Mm          , Mm          
Gg          , Gg          , Gg          , Gg          , Gg          , Gg          , Aa          , Gg          , Aa          , Gg          , Aa          , Aa          , Aa          , Gg          , Aa          , Aa          , Ha          , Aa          , Ha          , Mm          , Ha          , Mm          , Ha          , Ha          , Ww          , Ai          , Ww          , Ai          , Ww          , Ww          , Wo          , Ww          , Ww          , Ww^Bw|      , Ww          , Wo          , Wo          , Ai          , Wo          , Wo          , Wo          , Wo          , Ww          , Ww          , Ww          , Ai          , Ai          , Ai          , Ha          , Mm          , Mm          , Ha          , Ha          , Ha          , Ha          
Gg          , Gg          , Gg          , Gg          , Aa          , Aa          , Aa          , Aa          , Gg          , Gg          , Ha          , Re          , Ha          , Aa          , Ha          , Mm          , Mm          , Mm          , Ha          , Ha          , Ww          , Ha          , Ww          , Ai          , Ai          , Ai          , Wo          , Ww          , Ai          , Ww          , Ww          , Ww          , Ww          , Ww^Bw|      , Ww          , Wo          , Wo          , Wo          , Wo          , Wo          , Ww          , Ww          , Ha          , Ww          , Ha          , Ai          , Mm          , Ha          , Mm          , Mm          , Ha          , Mm          , Ha          , Ha          , Ha          
Gg          , Gg          , Aa          , Gg          , Ha          , Gg          , Ha          , Gg          , Mm          , Mm          , Mm          , Mm          , Mm          , Ha          , Mm          , Mm          , Ha          , Ha          , Ww          , Ha          , Ww          , Ww          , Wo          , Ww          , Ai          , Ww          , Wo          , Ww          , Ww          , Ai          , Ai          , Ai          , Ww          , Ww^Bw|      , Ww          , Wo          , Wo          , Wo          , Ww          , Wo          , Ha          , Ww          , Ha          , Ha          , Mm          , Mm          , Mm          , Mm          , Mm          , Ha          , Ha          , Ha          , Ha          , Ha          , Ha          
Gg          , Gg          , Ha          , Gg          , Ha          , Ha          , Mm          , Ha          , Mm          , Ce          , 3 Ke        , Ce          , Mm          , Mm          , Ha          , Ha          , Ww          , Ww          , Wo          , Ww          , Wo          , Wo          , Ww          , Ww          , Ww          , Ww          , Ww          , Ww          , Ww          , Wo          , Ww          , Ai          , Ai          , Ww^Bw|      , Ww          , Wo          , Ww          , Ww          , Ww          , Ww          , Ha          , Ha          , Ha          , Ha          , Ha          , Ha          , Ha          , Ha          , Mm          , Mm          , Mm          , Ha          , Mm          , Mm          , Mm          
Ha          , Ha          , Mm          , Ha          , Mm          , Mm          , Mm          , Mm^Vc       , Mm          , Mm          , Ce          , Mm          , Mm          , Mm^Vc       , Ai          , Ww          , Wo          , Wo          , Wo          , Wo          , Ww          , Ww          , Ww          , Ai          , Ai          , Ai          , Ai          , Ai          , Ww          , Wo          , Ww          , Ai          , Ai          , Ww^Bw|      , Ai          , Ai          , Ai          , Ww          , Ha          , Ha          , Mm          , Ha          , Ha          , Mm          , Mm          , Mm          , Mm          , Mm          , Ha          , Ha          , Mm          , Mm          , Ha          , Mm          , Mm          
Mm          , Mm          , Ha          , Mm          , Ha          , Mm          , Ha          , Ha          , Ai          , Mm          , Ai          , Mm          , Ai          , Ai          , Ww          , Ww          , Wo          , Wo          , Wo          , Wo          , Ww          , Ai          , Ai          , Ai          , Ww          , Ai          , Ai          , Ww          , Ww          , Wo          , Ai          , Ai          , Ai          , Ww^Bw|      , Gg          , Gg          , Gg          , Ai          , Gg          , Ha          , Mm          , Ha          , Mm          , Ha          , Ha          , Mm          , Ha          , Mm          , Ha          , Ha          , Ha          , Mm          , Ha          , Mm          , Mm          
Ha          , Ha          , Ai          , Ha          , Ai          , Ha          , Ai          , Ai          , Ww          , Ai          , Ww          , Ww          , Ww          , Ww          , Wo          , Wo          , Ha          , Wo          , Ha          , Ha          , Aa          , Ww          , Ai          , Ai          , Ai          , Ai          , Aa          , Ai          , Ai          , Ww          , Ai          , Ai          , Aa^Vha      , Re          , Re          , Re          , Re          , Gg          , Gg          , Ha          , Ha          , Mm          , Ha          , Mm          , Ha          , Ha          , Aa          , Ha          , Aa          , Ha          , Aa          , Ha          , Aa          , Ha          , Ha          
Ww          , Ww          , Ww          , Ai          , Ww          , Ai          , Ww          , Ww          , Ww          , Ww          , Wo          , Ww          , Wo          , Ww          , Ha          , Ha          , Aa          , Ha          , Aa          , Ha          , Gg          , Aa          , Ha          , Aa          , Ha          , Aa          , Ha          , Gg          , Ha          , Ww          , Ha          , Gg          , Ha          , Gg          , Ha          , Gg          , Aa          , Re          , Re          , Ha          , Gg          , Ha          , Aa          , Ha          , Aa          , Ha          , Aa          , Ha^Vhha     , Ha          , Aa          , Ha          , Aa          , Ha          , Aa          , Aa          
Wo          , Wo          , Wo          , Ww          , Wo          , Ww          , Wo          , Wo          , Wo          , Wo          , Wo          , Wo          , Ww          , Ww          , Ha          , Aa          , Ha          , Gg          , Ha          , Gg          , Ha          , Ha          , Mm          , Ha          , Mm          , Ha          , Mm          , Ha          , Mm          , Ha          , Mm          , Ha          , Mm          , Ha          , Ha          , Gg          , Aa          , Aa          , Re          , Gg          , Aa          , Aa          , Aa          , Aa          , Ha          , Aa          , Ha          , Ha          , Mm          , Ha          , Mm          , Ha          , Mm          , Ha          , Ha          
Wo          , Wo          , Wo          , Wo          , Wo          , Wo          , Wo          , Wo          , Ww          , Wo          , Ww          , Ww          , Ha          , Ha          , Ha          , Aa          , Ha          , Mm          , Mm          , Mm          , Mm          , Mm          , Ha          , Ha          , Mm          , Mm          , Mm          , Mm          , Mm          , Mm          , Ha          , Ha          , Mm          , Ha          , Gg          , Aa          , Gg          , Aa          , Re          , Aa          , Aa          , Aa          , Gg          , Ha          , Mm          , Mm          , Mm          , Mm          , Mm          , Mm          , Mm          , Mm          , Mm          , Mm          , Mm          
Ww          , Ww          , Ww          , Wo          , Ww          , Wo          , Ww          , Ww          , Ha          , Ha          , Ha          , Ha          , Ha          , Ha          , Ha          , Gg          , Aa          , Mm          , Ha          , Mm          , Mm          , Ha          , Mm          , Mm          , Mm          , Mm          , Mm          , Mm          , Mm          , Mm          , Ha          , Mm          , Mm          , Ha          , Ha          , Gg          , Gg          , Aa^Vha      , Re          , Gg          , Re          , Gg          , Aa          , Ha          , Gg          , Ha          , Ha          , Mm          , Mm          , Mm          , Ha          , Mm          , Mm          , Mm          , Mm          
Ha          , Ha          , Ha          , Ww          , Ww          , Ww          , Ha          , Ha          , Mm          , Mm          , Mm          , Mm          , Mm          , Mm          , Ha          , Gg          , Ha          , Aa          , Aa          , Ha          , Gg          , Ha          , Ha          , Mm          , Ha          , Ha          , Ha          , Mm          , Mm          , Mm          , Mm          , Mm          , Ha          , Ha          , Ha          , Gg          , Ha          , Aa          , Gg          , Re          , Gg          , Re          , Re          , Gg          , Re          , Aa          , Aa          , Ha          , Ha          , Ha          , Mm          , Mm          , Mm          , Mm          , Mm          
Ha          , Ha          , Ha          , Ha          , Mm          , Ha          , Ha          , Mm          , Ha          , Mm          , Ha          , Mm          , Mm          , Mm          , Mm          , Ha          , Ha          , Gg          , Ha          , Gg          , Gg          , Ha^Vhha     , Aa          , Ha          , Gg          , Ha          , Ha          , Ha          , Ha          , Mm          , Mm          , Ha          , Mm          , Ha          , Ha          , Ha          , Ha          , Gg          , Ha          , Aa          , Gg          , Re          , Aa          , Re          , Re          , Aa          , Aa          , Ha          , Gg          , Ha          , Ha          , Mm          , Ha          , Mm          , Mm          
Ha          , Ha          , Ha          , Mm          , Mm          , Mm          , Mm          , Ha          , Ha          , Ha          , Ha          , Mm          , Mm          , Mm          , Mm          , Mm          , Mm          , Ha          , Mm          , Ha          , Ha          , Gg          , Ha          , Aa          , Ha          , Aa          , Aa          , Ha          , Ha          , Ha          , Mm          , Mm          , Mm          , Mm          , Mm          , Ha          , Ha          , Ha          , Mm          , Ha          , Ha          , Aa          , Ha          , Aa          , Re          , Aa          , Re          , Gg          , Gg          , Ha          , Gg          , Ha          , Ha          , Mm          , Mm          
Ha          , Ha          , Ha          , Mm          , Mm          , Mm          , Mm          , Ha          , Mm          , Ha          , Ha          , Ha          , Mm          , Mm          , Mm          , Ha          , Ha          , Ha          , Mm          , Mm          , Mm          , Ha          , Mm          , Ha          , Ha          , Gg          , Aa          , Gg          , Ha          , Ha          , Ha          , Mm          , Mm          , Mm          , Mm          , Ha          , Ha          , Mm          , Mm          , Ha          , Mm          , Ha          , Ha          , Gg          , Hh^Vhh      , Re          , Aa          , Re          , Ce          , Gg          , Gg          , Gg          , Aa          , Ha          , Ha          
Ha          , Ha          , Ha          , Mm          , Mm          , Ha          , Mm          , Ha          , Mm          , Mm          , Mm          , Mm          , Mm          , Mm          , Ha          , Ha          , Mm          , Mm          , Mm          , Mm          , Mm          , Mm          , Mm          , Mm          , Mm          , Ha          , Ha          , Ha^Vhha     , Gg          , Ha          , Mm          , Ha          , Mm          , Mm          , Mm          , Mm          , Mm          , Ha          , Mm          , Mm          , Mm          , Mm          , Ha          , Gg          , Ha          , Aa          , Aa          , Re          , Ce          , 1 Ke        , Ce          , Gg          , Re          , Aa          , Aa          
Ha          , Ha          , Ha          , Ha          , Mm          , Mm          , Mm          , Ha          , Mm          , Mm          , Mm          , Mm          , Mm          , Mm          , Mm          , Mm          , Mm          , Mm          , Mm          , Mm          , Mm          , Mm          , Mm          , Mm          , Mm          , Mm          , Ha          , Gg          , Gg          , Ha          , Mm          , Mm          , Mm          , Mm          , Mm          , Mm          , Mm          , Mm          , Mm          , Mm          , Mm          , Mm          , Mm          , Ha          , Mm          , Ha          , Ha          , Gg          , Gg          , Gg          , Aa          , Re          , Re          , Aa          , Aa          
Ha          , Ha          , Ha          , Ha          , Mm          , Mm          , Mm          , Mm          , Ha          , Mm          , Mm          , Mm          , Mm          , Mm          , Mm          , Mm          , Mm          , Mm          , Mm          , Mm          , Mm          , Mm          , Mm          , Mm          , Mm          , Mm          , Ha          , Ha          , Ha          , Ha          , Mm          , Mm          , Mm          , Mm          , Mm          , Mm          , Mm          , Mm          , Mm          , Mm          , Mm          , Mm          , Mm          , Mm          , Mm          , Ha          , Ha          , Ha          , Aa          , Aa          , Gg          , Gg          , Re          , Re          , Re          
Ha          , Ha          , Ha          , Ha          , Mm          , Mm          , Mm          , Mm          , Ha          , Mm          , Mm          , Mm          , Mm          , Mm          , Mm          , Mm          , Mm          , Mm          , Mm          , Mm          , Mm          , Mm          , Mm          , Mm          , Mm          , Mm          , Ha          , Ha          , Ha          , Ha          , Mm          , Mm          , Mm          , Mm          , Mm          , Mm          , Mm          , Mm          , Mm          , Mm          , Mm          , Mm          , Mm          , Mm          , Mm          , Ha          , Ha          , Ha          , Aa          , Aa          , Gg          , Gg          , Re          , Re          , Re          
