
border_size=1
usage=map

Ds          ,Ds          , Ds          , Re          , Ss          , Ss          , Ss          , Ss          , Ss          , Ss          , Re          , Re          , Ss          , Ss          , Ss          , Ss          , Ss          , Ss          , Ss          , Ss          , Ss          , Re          , Re          , Ss          , Ss          , Ss          , Ss          , Ss          , Ss          , Ss          , Ss          , Ss          , Ss          , Ss          , Ss          , Ss          , Ss          , Ss          , Ss          , Re          , Re          , Ss          , Ss          , Ds          , Ds          , Ds          , Ds          , Ds          , Re          , Re          , Hh          , Mm          , Mm          , Mm          , Mm          , Hh          , Hh          , Hh          , Hh          , Mm          , Mm          , Mm          , Mm          , Mm          , Mm          , Mm          , Mm          
Ds          ,Ds          , Ds          , Re          , Ss          , Ss          , Ss          , Ss          , Ss          , Ss          , Re          , Re          , Ss          , Ss          , Ss          , Ss          , Ss          , Ss          , Ss          , Ss          , Ss          , Re          , Re          , Ss          , Ss          , Ss          , Ss          , Ss          , Ss          , Ss          , Ss          , Ss          , Ss          , Ss          , Ss          , Ss          , Ss          , Ss          , Ss          , Re          , Re          , Ss          , Ss          , Ds          , Ds          , Ds          , Ds          , Ds          , Re          , Re          , Hh          , Mm          , Mm          , Mm          , Mm          , Hh          , Hh          , Hh          , Hh          , Mm          , Mm          , Mm          , Mm          , Mm          , Mm          , Mm          , Mm          
Ds          ,Ds          , Gg^Vh       , Re          , Re          , Re          , Ch          , Ch          , Ch          , Ds          , Ds          , Ds          , Ds          , Ds          , Ss          , Ss          , Ss          , Ss          , Ss          , Ss          , Ss          , Ss          , Re          , Re          , Re          , Re          , Re          , Ss          , Ss          , Ss          , Ss          , Ss          , Ss          , Ss          , Ss          , Ss          , Ss          , Re          , Re          , Re          , Re          , Re          , Re          , Re          , Ss          , Ds          , Gg^Vh       , Ds          , Ds          , Re          , Re          , Mm          , Mm          , Mm          , Mm          , Re          , Re          , Re          , Re          , Hh          , Mm          , Mm          , Mm          , Mm          , Mm          , Mm          , Mm          
Ds          ,Ds          , Ss          , Ss          , Ss          , Ss          , Ch          , 2 Kh        , Ch          , Ss          , Ds          , Ds          , Gg^Vh       , Re          , Re          , Ss          , Ss          , Ss          , Ss          , Ss          , Ss          , Ss          , Re          , Re          , Gg^Vh       , Re          , Ss          , Ss          , Ss          , Ss          , Re          , Re          , Re          , Re          , Ds          , Ds          , Ds          , Ds          , Ds          , Ss          , Ss          , Ss          , Ss          , Ss          , Ss          , Ss          , Ss          , Ss          , Re          , Re          , Re          , Hh          , Mm          , Mm          , Mm          , Hh          , Gg^Vh       , Re          , Hh          , Mm          , Mm          , Mm          , Mm          , Gg^Vh       , Mm          , Mm          , Mm          
Ss          ,Ss          , Ss          , Ss          , Ss          , Ss          , Ss          , Ch          , Re          , Re          , Ss          , Ss          , Ss          , Ss          , Re          , Re          , Re          , Ss          , Ss          , Ss          , Ss          , Ss          , Ss          , Re          , Re          , Re          , Re          , Re          , Re          , Re          , Re          , Ss          , Ss          , Re          , Ds          , Ds          , Gg^Vh       , Ds          , Ss          , Ss          , Ss          , Ss          , Ss          , Ss          , Ss          , Ss          , Ss          , Ss          , Ss          , Re          , Re          , Hh          , Hh          , Mm          , Mm          , Mm          , Hh          , Hh          , Mm          , Mm          , Mm          , Mm          , Mm          , Mm          , Mm          , Mm          , Mm          
Ss          ,Ss          , Ss          , Ss          , Ss          , Ss          , Ss          , Ss          , Re          , Re          , Ss          , Ss          , Ss          , Ss          , Ss          , Ss          , Re          , Re          , Re          , Ss          , Ss          , Ss          , Re          , Re          , Ss          , Ss          , Ss          , Ss          , Ss          , Ss          , Ss          , Ss          , Re          , Re          , Ss          , Re          , Re          , Ss          , Ss          , Ss          , Ss          , Ss          , Ss          , Gg^Vh       , Ds          , Ds          , Ss          , Ss          , Ss          , Gg^Vh       , Re          , Re          , Hh          , Mm          , Mm          , Mm          , Mm          , Mm          , Mm          , Mm          , Mm          , Hh          , Hh          , Mm          , Mm          , Mm          , Mm          
Ss          ,Ss          , Ss          , Ss          , Ss          , Ss          , Ss          , Ss          , Ss          , Re          , Re          , Ss          , Ss          , Ss          , Ss          , Ss          , Ss          , Ss          , Re          , Re          , Ss          , Re          , Re          , Ss          , Ss          , Ss          , Ss          , Ss          , Ss          , Ss          , Ss          , Ss          , Re          , Ss          , Ss          , Ss          , Re          , Re          , Ss          , Ss          , Ss          , Ss          , Ds          , Ds          , Ds          , Ds          , Re          , Re          , Re          , Re          , Re          , Hh          , Mm          , Mm          , Mm          , Mm          , Mm          , Mm          , Mm          , Mm          , Mm          , Hh          , Hh          , Hh          , Mm          , Mm          , Mm          
Ss          ,Ss          , Ss          , Ss          , Ss          , Ss          , Ss          , Ss          , Ss          , Ds          , Ds          , Ds          , Ds          , Re          , Re          , Ss          , Ss          , Ss          , Ds          , Ds          , Ds          , Ds          , Ss          , Ss          , Ss          , Ss          , Ss          , Ss          , Ss          , Ss          , Ss          , Re          , Re          , Ss          , Ss          , Ss          , Ss          , Re          , Re          , Ss          , Re          , Re          , Re          , Ss          , Ss          , Ss          , Ss          , Ss          , Ss          , Re          , Re          , Re          , Hh          , Mm          , Mm          , Hh          , Hh          , Mm          , Mm          , Mm          , Mm          , Mm          , Mm          , Mm          , Mm          , Mm          , Mm          
Ss          ,Ss          , Ss          , Ss          , Ss          , Ss          , Gg^Vh       , Ds          , Ds          , Ds          , Ds          , Gg^Vh       , Ss          , Ss          , Re          , Ss          , Ss          , Ss          , Ss          , Ds          , Gg^Vh       , Ds          , Ds          , Ss          , Ss          , Ss          , Ss          , Ss          , Ss          , Ss          , Re          , Re          , Ss          , Ss          , Ss          , Ss          , Ss          , Ss          , Re          , Re          , Re          , Ss          , Ss          , Ss          , Ss          , Ss          , Ss          , Ss          , Ss          , Re          , Re          , Hh          , Hh          , Mm          , Mm          , Hh          , Hh          , Mm          , Gg^Vh       , Mm          , Mm          , Mm          , Mm          , Mm          , Mm          , Mm          , Mm          
Ss          ,Ss          , Re          , Re          , Ss          , Re          , Re          , Re          , Ds          , Ds          , Ds          , Ss          , Ss          , Ss          , Re          , Re          , Ss          , Ss          , Ss          , Ss          , Ss          , Ss          , Re          , Re          , Re          , Re          , Ss          , Ss          , Ss          , Re          , Re          , Re          , Ss          , Ss          , Ss          , Ss          , Ss          , Ss          , Ds          , Ds          , Ds          , Gg^Vh       , Ds          , Ss          , Ss          , Ss          , Ss          , Ss          , Re          , Re          , Re          , Hh          , Mm          , Mm          , Mm          , Mm          , Mm          , Mm          , Mm          , Mm          , Mm          , Mm          , Mm          , Gg^Vh       , Mm          , Mm          , Mm          
Re          ,Re          , Re          , Re          , Re          , Re          , Re          , Re          , Re          , Re          , Re          , Ss          , Ss          , Ss          , Ss          , Ds          , Ds          , Gg^Vh       , Ss          , Ss          , Ss          , Ss          , Ss          , Ss          , Re          , Re          , Re          , Re          , Re          , Re          , Ss          , Re          , Re          , Re          , Ss          , Re          , Re          , Re          , Re          , Ds          , Ds          , Ds          , Ds          , Ss          , Ss          , Ss          , Ss          , Ss          , Ss          , Re          , Re          , Hh          , Mm          , Mm          , Gg^Vh       , Mm          , Mm          , Hh          , Hh          , Hh          , Hh          , Mm          , Mm          , Mm          , Mm          , Mm          , Mm          
Ss          ,Ss          , Ss          , Ss          , Re          , Ss          , Ss          , Re          , Re          , Re          , Re          , Re          , Ss          , Ss          , Ss          , Ss          , Ds          , Ds          , Ds          , Ss          , Ss          , Ss          , Re          , Re          , Re          , Ss          , Re          , Gg^Vh       , Re          , Re          , Ss          , Ss          , Ss          , Ds          , Gg^Vh       , Ds          , Ss          , Ss          , Ss          , Ss          , Re          , Re          , Re          , Re          , Ss          , Ss          , Ss          , Ss          , Ss          , Ss          , Re          , Re          , Hh          , Mm          , Mm          , Mm          , Hh          , Ds          , Ch          , Ds          , Ds          , Hh          , Mm          , Mm          , Mm          , Mm          , Mm          
Ss          ,Ss          , Ss          , Ss          , Ss          , Ss          , Ss          , Re          , Ss          , Ss          , Re          , Re          , Re          , Re          , Ss          , Ss          , Ss          , Ss          , Re          , Re          , Ss          , Re          , Re          , Ss          , Ss          , Ss          , Re          , Ss          , Ss          , Ss          , Ss          , Ss          , Ss          , Ds          , Ds          , Ds          , Ss          , Ss          , Ss          , Ss          , Ss          , Ss          , Re          , Re          , Ch          , Re          , Ss          , Ss          , Ss          , Ss          , Ss          , Re          , Re          , Hh          , Mm          , Hh          , Ds          , Ch          , 5 Kh        , Ch          , Re          , Ds          , Hh          , Mm          , Mm          , Mm          , Mm          
Ss          ,Ss          , Ss          , Ss          , Ss          , Ss          , Re          , Re          , Ss          , Ss          , Ss          , Ss          , Gg^Vh       , Re          , Re          , Re          , Ch          , Ch          , Ch          , Gg^Vh       , Re          , Re          , Ss          , Ss          , Ss          , Ss          , Re          , Ss          , Ss          , Ss          , Ss          , Ss          , Ss          , Ss          , Ss          , Re          , Re          , Ss          , Re          , Re          , Gg^Vh       , Re          , Re          , Ch          , 4 Kh        , Ch          , Re          , Ss          , Ss          , Ss          , Re          , Re          , Re          , Re          , Hh          , Hh          , Ds          , Re          , Ch          , Re          , Re          , Ds          , Hh          , Mm          , Mm          , Mm          , Mm          
Ss          ,Ss          , Ss          , Ss          , Ss          , Ss          , Ds          , Ds          , Ds          , Ss          , Ss          , Ss          , Ss          , Ss          , Re          , Re          , Ch          , 1 Kh        , Ch          , Re          , Ss          , Ss          , Ss          , Ss          , Ss          , Ss          , Re          , Ss          , Ss          , Ss          , Ss          , Ss          , Ss          , Ss          , Ss          , Re          , Re          , Re          , Re          , Ss          , Ss          , Ss          , Re          , Re          , Ch          , Re          , Re          , Ss          , Ss          , Ss          , Re          , Re          , Gg^Vh       , Hh          , Mm          , Mm          , Hh          , Ds          , Re          , Re          , Gg^Vh       , Hh          , Hh          , Mm          , Mm          , Mm          , Mm          
Ss          ,Ss          , Ss          , Ss          , Ds          , Ds          , Ds          , Gg^Vh       , Ds          , Ds          , Ss          , Ss          , Ss          , Ss          , Ss          , Re          , Re          , Ch          , Re          , Re          , Ss          , Ss          , Ss          , Ss          , Ss          , Re          , Re          , Ss          , Ss          , Ss          , Ss          , Ss          , Re          , Re          , Re          , Re          , Ss          , Ss          , Ss          , Ss          , Ss          , Ss          , Ss          , Ss          , Re          , Ss          , Ss          , Ss          , Ss          , Ss          , Ss          , Re          , Re          , Hh          , Mm          , Mm          , Mm          , Hh          , Hh          , Hh          , Hh          , Hh          , Mm          , Mm          , Mm          , Mm          , Mm          
Ss          ,Ss          , Ss          , Ss          , Ss          , Ss          , Ds          , Ds          , Ds          , Ds          , Ss          , Ss          , Ss          , Ss          , Ss          , Ss          , Gg^Vh       , Re          , Re          , Ss          , Ss          , Ss          , Ss          , Ss          , Ds          , Ds          , Ds          , Ds          , Ds          , Re          , Re          , Re          , Re          , Ss          , Re          , Ss          , Ss          , Ss          , Ss          , Ss          , Ss          , Ss          , Re          , Re          , Re          , Ss          , Ss          , Ss          , Ss          , Ss          , Ss          , Re          , Hh          , Mm          , Mm          , Gg^Vh       , Mm          , Mm          , Mm          , Mm          , Mm          , Mm          , Mm          , Mm          , Mm          , Mm          , Mm          
Ss          ,Ss          , Ss          , Ss          , Ss          , Ss          , Ss          , Re          , Re          , Ss          , Ss          , Ss          , Ss          , Ss          , Ss          , Ss          , Ss          , Ss          , Ss          , Ss          , Re          , Re          , Re          , Re          , Ds          , Gg^Vh       , Ds          , Ds          , Ss          , Ss          , Ss          , Ss          , Ss          , Ss          , Re          , Ss          , Ss          , Ss          , Ss          , Ss          , Ss          , Re          , Re          , Ss          , Ss          , Ss          , Ss          , Ss          , Ss          , Ss          , Re          , Re          , Hh          , Mm          , Mm          , Mm          , Hh          , Hh          , Mm          , Mm          , Gg^Vh       , Mm          , Hh          , Hh          , Mm          , Mm          , Mm          
Ss          ,Ss          , Ss          , Ss          , Ss          , Ss          , Ss          , Ss          , Re          , Re          , Ss          , Ss          , Ss          , Ss          , Ss          , Ss          , Ss          , Ss          , Re          , Re          , Re          , Ss          , Ss          , Ss          , Ss          , Ss          , Ss          , Re          , Re          , Ss          , Ss          , Ss          , Ss          , Ss          , Ds          , Ds          , Ds          , Ss          , Ss          , Ss          , Ss          , Re          , Ss          , Ss          , Ss          , Ds          , Ds          , Ds          , Re          , Re          , Re          , Re          , Re          , Hh          , Mm          , Mm          , Mm          , Hh          , Hh          , Mm          , Mm          , Mm          , Mm          , Hh          , Mm          , Mm          , Mm          
Ss          ,Ss          , Ss          , Ss          , Ss          , Ss          , Ss          , Ss          , Ss          , Re          , Ss          , Ss          , Ss          , Ss          , Ss          , Re          , Re          , Re          , Re          , Ss          , Ss          , Ss          , Ss          , Ss          , Ss          , Ss          , Ss          , Ss          , Re          , Re          , Ss          , Ss          , Ss          , Ss          , Gg^Vh       , Ds          , Ds          , Ss          , Ss          , Ss          , Ss          , Re          , Re          , Re          , Ds          , Ds          , Gg^Vh       , Ds          , Ss          , Ss          , Re          , Gg^Vh       , Re          , Hh          , Hh          , Mm          , Mm          , Mm          , Mm          , Mm          , Mm          , Mm          , Mm          , Mm          , Hh          , Mm          , Mm          
Ss          ,Ss          , Ss          , Ss          , Ss          , Ds          , Ds          , Gg^Vh       , Ds          , Ds          , Ds          , Re          , Re          , Re          , Re          , Re          , Gg^Vh       , Re          , Re          , Re          , Ss          , Ss          , Ss          , Ss          , Ss          , Ss          , Ss          , Ss          , Ss          , Re          , Re          , Ss          , Ss          , Ss          , Ss          , Ss          , Re          , Re          , Ss          , Ss          , Ss          , Re          , Ss          , Ss          , Ss          , Ss          , Ds          , Ds          , Ss          , Ss          , Ss          , Re          , Re          , Re          , Re          , Hh          , Mm          , Mm          , Mm          , Mm          , Mm          , Mm          , Gg^Vh       , Mm          , Mm          , Mm          , Mm          
Ss          ,Ss          , Ss          , Ss          , Ss          , Ds          , Ds          , Ds          , Ds          , Ss          , Ss          , Ss          , Ss          , Ss          , Ss          , Re          , Ss          , Ss          , Ss          , Re          , Re          , Re          , Ss          , Ss          , Ss          , Ss          , Ss          , Ss          , Ss          , Ss          , Re          , Re          , Re          , Ss          , Ss          , Ss          , Ss          , Re          , Re          , Re          , Re          , Re          , Ss          , Ss          , Ss          , Re          , Re          , Ss          , Ss          , Ss          , Ss          , Ss          , Re          , Re          , Re          , Re          , Hh          , Mm          , Mm          , Hh          , Hh          , Mm          , Mm          , Mm          , Mm          , Mm          , Mm          
Ss          ,Ss          , Ss          , Ss          , Ss          , Ss          , Re          , Re          , Ss          , Ss          , Ss          , Ss          , Ss          , Ss          , Ss          , Re          , Ss          , Ss          , Ss          , Ss          , Ss          , Re          , Ds          , Ds          , Ds          , Ds          , Re          , Re          , Re          , Re          , Re          , Ds          , Ds          , Ds          , Re          , Ss          , Ss          , Ss          , Ss          , Ds          , Gg^Vh       , Ds          , Ds          , Re          , Re          , Re          , Ss          , Ss          , Ss          , Ss          , Ss          , Ss          , Ss          , Re          , Re          , Re          , Hh          , Hh          , Mm          , Mm          , Mm          , Hh          , Hh          , Mm          , Mm          , Mm          , Mm          
Ss          ,Ss          , Ss          , Ss          , Re          , Re          , Ch          , Re          , Re          , Ss          , Ss          , Ss          , Ss          , Ss          , Re          , Re          , Ss          , Ss          , Ss          , Ss          , Ss          , Ds          , Ds          , Gg^Vh       , Ds          , Ss          , Ss          , Ss          , Ss          , Ss          , Ss          , Ds          , Gg^Vh       , Ds          , Re          , Re          , Re          , Re          , Ds          , Ds          , Ds          , Ds          , Ss          , Ss          , Ss          , Ss          , Ss          , Ss          , Ss          , Ss          , Ss          , Ss          , Re          , Re          , Re          , Re          , Hh          , Mm          , Mm          , Mm          , Mm          , Mm          , Mm          , Mm          , Mm          , Mm          , Mm          
Ss          ,Ss          , Ss          , Ss          , Re          , Ch          , 3 Kh        , Ch          , Re          , Ss          , Ss          , Ss          , Ss          , Re          , Re          , Ss          , Ss          , Ss          , Ss          , Ss          , Ss          , Re          , Ss          , Ss          , Ss          , Ss          , Ss          , Ss          , Ss          , Ss          , Ds          , Ds          , Ss          , Ss          , Ss          , Ss          , Ss          , Ss          , Re          , Re          , Re          , Ss          , Ss          , Ss          , Ss          , Ss          , Ss          , Ss          , Ss          , Ss          , Ss          , Re          , Re          , Gg^Vh       , Re          , Hh          , Hh          , Mm          , Mm          , Mm          , Hh          , Mm          , Mm          , Mm          , Gg^Vh       , Mm          , Mm          
Ss          ,Ss          , Ss          , Ss          , Re          , Ch          , Ch          , Ch          , Re          , Re          , Ds          , Ds          , Ds          , Ds          , Ss          , Ss          , Ss          , Ss          , Ss          , Ss          , Re          , Re          , Ss          , Ss          , Ss          , Ss          , Ss          , Ss          , Ss          , Ss          , Re          , Ss          , Ss          , Ss          , Ss          , Ss          , Ss          , Ss          , Ss          , Ss          , Re          , Re          , Ss          , Ss          , Ss          , Ss          , Ss          , Ss          , Ss          , Ss          , Ss          , Ss          , Re          , Re          , Re          , Hh          , Mm          , Mm          , Mm          , Hh          , Hh          , Hh          , Mm          , Mm          , Mm          , Mm          , Mm          
Ss          ,Ss          , Ss          , Ss          , Ss          , Re          , Re          , Re          , Ss          , Ss          , Ds          , Gg^Vh       , Ds          , Ss          , Ss          , Ss          , Ss          , Ss          , Ss          , Ss          , Re          , Ss          , Ss          , Ss          , Ss          , Ss          , Ss          , Ss          , Ss          , Ss          , Re          , Ss          , Ss          , Ss          , Ss          , Ss          , Ss          , Ss          , Ss          , Ss          , Ss          , Re          , Re          , Ds          , Ds          , Gg^Vh       , Ds          , Ss          , Ss          , Ss          , Ss          , Ss          , Re          , Re          , Hh          , Hh          , Mm          , Mm          , Mm          , Mm          , Mm          , Mm          , Mm          , Mm          , Mm          , Mm          , Mm          
Ss          ,Ss          , Ss          , Ss          , Ss          , Re          , Re          , Re          , Ss          , Ss          , Ds          , Gg       , Ds          , Ss          , Ss          , Ss          , Ss          , Ss          , Ss          , Ss          , Re          , Ss          , Ss          , Ss          , Ss          , Ss          , Ss          , Ss          , Ss          , Ss          , Re          , Ss          , Ss          , Ss          , Ss          , Ss          , Ss          , Ss          , Ss          , Ss          , Ss          , Re          , Re          , Ds          , Ds          , Gg       , Ds          , Ss          , Ss          , Ss          , Ss          , Ss          , Re          , Re          , Hh          , Hh          , Mm          , Mm          , Mm          , Mm          , Mm          , Mm          , Mm          , Mm          , Mm          , Mm          , Mm          
