border_size=1
usage=map

Ch          , Ch          , Ch          , Ch          , Ds          , Gg          , Re          , Re          , Re          , Re          , Re          , Re          , Gg          , Gg          , Gs          , Gs          , Gs          , Gs          , Gg          , Gg          , Ds          , Ds          , Ds          , Gg          , Gg          , Gg          , Ds          , Ds          , Ds          , Gg          , Gs          , Gs          , Gs          , Ds          , Ds          , Ww          , Ww          , Ds          , Ss          , Ss          , Ss          , Ss          , Ds          , Gg          , Ds          , Ds          , Ds          
Ch          , Ch          , 2 Kh        , Ch          , Ds          , Gg^Vh       , Re          , Re          , Re          , Re          , Re          , Re          , Gg          , Gg          , Gg          , Gg          , Gg          , Gg          , Gg          , Gg          , Ds          , Ds          , Ds          , Gg          , Gg          , Gg          , Ds          , Ds          , Ds          , Gg          , Gs          , Gs          , Gg          , Ds          , Ds          , Ww          , Ww          , Ds          , Ss          , Ss          , Ss          , Ss          , Ds          , Gg^Vh       , Ds          , Ds          , Ds          
Ch          , Ch          , Ch          , Ch          , Ds          , Ds          , Re          , Re          , Re          , Re          , Re          , Gg          , Gg          , Gg          , Re          , Re          , Re          , Gg          , Gs          , Ds          , Ds          , Gg^Vh       , Ds          , Gg          , Gg          , Gg          , Gg          , Ds          , Ds          , Ds          , Gg          , Gg          , Gg          , Ds          , Ww          , Ww          , Ds          , Ss          , Ss          , Ss          , Ss          , Ds          , Ds          , Ds          , Ds          , Ss          , Ss          
Re          , Re          , Re          , Ds          , Ds          , Gg^Vh       , Gg          , Gg          , Gg          , Gg          , Gg          , Gg          , Gg          , Re          , Re          , Re          , Re          , Re          , Gs          , Gg          , Gg          , Ds          , Ds          , Ds          , Ds          , Gg          , Gg          , Gg          , Gg^Vh       , Ds          , Gg          , Gg          , Ds          , Ds          , Ww          , Ds          , Re          , Re          , Ss          , Gg^Vh       , Ss          , Ss          , Ss          , Re          , Re          , Ss          , Ss          
Re          , Re          , Re          , Re          , Re          , Gg          , Gg          , Gg          , Ds          , Ds          , Ds          , Gg          , Gg          , Gg          , Gg^Vh       , Re          , Re          , Gs          , Gs          , Gg          , Gg          , Ds          , Gg          , Gg          , Gg          , Gg          , Re          , Re          , Re          , Ds          , Gg          , Ds          , Ds          , Ds          , Ww          , Ds          , Ss          , Ds          , Ds          , Ss          , Ss          , Ss          , Ss          , Ss          , Ds          , Ds          , Ds          
Re          , Re          , Re          , Hh          , Re          , Re          , Gg          , Gg          , Ds          , Gg          , Gg          , Gg          , Gg          , Gg          , Gg          , Gg          , Gg          , Gg          , Gg          , Gg          , Ds          , Ds          , Gg          , Gg          , Gg          , Re          , Hh          , Hh          , Hh          , Re          , Ds          , Ds          , Ds          , Ww          , Ww          , Ds          , Ss          , Ss          , Ds          , Ds          , Ss          , Ss          , Ss          , Re          , Re          , Ds          , Ds          
Hh          , Hh          , Hh          , Re          , Hh          , Re          , Re          , Ds          , Ds          , Ds          , Gg          , Re          , Re          , Re          , Re          , Ds          , Ds          , Ds          , Ds          , Ds          , Ds          , Re          , Re          , Re          , Ds          , Ds          , Re          , Gg^Vh       , Hh          , Hh          , Re          , Ds          , Ds          , Ww          , Ds          , Ds          , Ss          , Re          , Re          , Re          , Re          , Ss          , Re          , Re          , Ss          , Ss          , Ss          
Mm          , Mm          , Hh          , Hh          , Re          , Re          , Re          , Gg          , Gg          , Gg          , Gg          , Re          , Re          , Re          , Re          , Re          , Re          , Ds          , Ds          , Ds          , Ds          , Re          , Re          , Re          , Re          , Ds          , Ds          , Re          , Re          , Re          , Re          , Ds          , Ds          , Ww          , Ds          , Ds          , Ds          , Ss          , Ss          , Ss          , Ds          , Gg^Vh       , Ds          , Ss          , Ss          , Ss          , Ss          
Mm          , Mm          , Mm          , Hh          , Re          , Hh          , Re          , Gg          , Gg          , Gg          , Gg          , Gg          , Re          , Re          , Re          , Gg          , Gs          , Gg          , Gg          , Gg          , Gg          , Gg^Vh       , Gg          , Re          , Re          , Ds          , Ds          , Gg          , Gg          , Ds          , Ds          , Ds          , Ds          , Ww          , Ds          , Ss          , Ss          , Ss          , Ss          , Ds          , Ds          , Ds          , Re          , Ss          , Ss          , Ss          , Ss          
Mm          , Mm          , Hh          , Hh          , Hh          , Re          , Re          , Re          , Gg          , Gg          , Gg          , Gg          , Ds          , Ds          , Gg          , Gg          , Gs          , Gs          , Ds          , Ds          , Ds          , Ds          , Ds          , Re          , Re          , Re          , Gg          , Gg          , Gs          , Gg          , Gg          , Ds          , Ww          , Ww          , Ds          , Ss          , Ss          , Ss          , Re          , Re          , Ss          , Ss          , Re          , Ss          , Ss          , Gg^Vh       , Gg          
Mm          , Mm          , Mm          , Gg^Vh       , Hh          , Re          , Hh          , Re          , Re          , Re          , Re          , Ds          , Ds          , Gg          , Gg          , Gg          , Gg          , Gg          , Gg          , Ds          , Ds          , Ds          , Ds          , Re          , Ds          , Ds          , Ds          , Gg          , Gs          , Gs          , Ds          , Ds          , Ww          , Ds          , Ss          , Ss          , Ss          , Re          , Re          , Ss          , Ss          , Ds          , Ds          , Ds          , Ds          , Re          , Re          
Mm          , Mm          , Mm          , Hh          , Hh          , Hh          , Re          , Re          , Re          , Re          , Ds          , Ds          , Ds          , Ds          , Gg          , Gg          , Gg^Vh       , Gg          , Ch          , Ch          , Ch          , Gg          , Gg          , Gg          , Gg          , Ds          , Ds          , Gg          , Gs          , Ds          , Ds          , Ww          , Ww          , Ds          , Ss          , Ss          , Ds          , Gg^Vh       , Re          , Ss          , Ss          , Ss          , Ss          , Ds          , Ds          , Ss          , Ss          
Mm          , Mm          , Mm          , Mm          , Mm          , Hh          , Re          , Re          , Re          , Re          , Gg          , Gg          , Gg          , Gg          , Gg          , Gg          , Gg          , Gg          , Ch          , 1 Kh        , Ch          , Gg          , Gg          , Gg          , Ds          , Ds          , Ds          , Ds          , Ds          , Ds          , Ds          , Ww          , Ds          , Re          , Re          , Ds          , Ds          , Ss          , Re          , Re          , Re          , Ss          , Ss          , Ss          , Gg^Vh       , Ss          , Ss          
Mm          , Mm          , Mm          , Mm          , Hh          , Hh          , Re          , Re          , Ds          , Ds          , Ds          , Re          , Re          , Gg          , Gg          , Gg          , Ds          , Ds          , Ds          , Ch          , Gg          , Gg          , Gg          , Gg          , Gg^Vh       , Re          , Re          , Re          , Ds          , Ds          , Ds          , Ww          , Ww          , Ds          , Ss          , Ss          , Ss          , Ss          , Ss          , Ss          , Ds          , Ds          , Ds          , Ss          , Ss          , Ss          , Ss          
Mm          , Mm          , Mm          , Hh          , Hh          , Hh          , Re          , Re          , Ds          , Ds          , Re          , Re          , Re          , Re          , Re          , Ds          , Ds          , Ds          , Gg^Vh       , Ds          , Ds          , Re          , Re          , Re          , Gs          , Gg          , Re          , Re          , Re          , Re          , Ds          , Ds          , Ww          , Ds          , Ss          , Ss          , Gg^Vh       , Ss          , Ss          , Re          , Re          , Ds          , Ds          , Ds          , Re          , Re          , Re          
Mm          , Mm          , Mm          , Mm          , Mm          , Hh          , Re          , Re          , Ds          , Ds          , Re          , Re          , Re          , Re          , Re          , Gg          , Ds          , Ds          , Ds          , Ds          , Ds          , Re          , Re          , Gs          , Gg          , Gg          , Re          , Re          , Gg          , Ds          , Ds          , Ds          , Ww          , Ds          , Ss          , Ss          , Ss          , Ss          , Re          , Re          , Ss          , Ss          , Ss          , Ss          , Ss          , Re          , Re          
Mm          , Mm          , Mm          , Mm          , Hh          , Hh          , Re          , Re          , Re          , Re          , Gs          , Gs          , Re          , Re          , Gg          , Gg          , Gs          , Gg          , Ds          , Ds          , Ds          , Gg          , Gg          , Gg          , Ds          , Ds          , Gg          , Gg          , Gg          , Gg          , Ds          , Ww          , Ww          , Ds          , Re          , Re          , Ds          , Ds          , Ds          , Ss          , Ss          , Ss          , Ss          , Ss          , Re          , Re          , Re          
Mm          , Mm          , Mm          , Mm          , Mm          , Hh          , Re          , Re          , Re          , Re          , Re          , Gs          , Gg          , Gg          , Gg          , Gs          , Gs          , Gg          , Gg          , Gg          , Gg          , Ds          , Ds          , Ds          , Gg^Vh       , Ds          , Ds          , Gg          , Gs          , Ds          , Ww          , Ww          , Ds          , Ss          , Ss          , Ss          , Ss          , Ss          , Ds          , Ds          , Gg^Vh       , Re          , Re          , Re          , Re          , Ss          , Ss          
Mm          , Mm          , Mm          , Mm          , Mm          , Hh          , Re          , Hh          , Re          , Re          , Gg          , Gg          , Gg          , Gg          , Gg          , Ds          , Re          , Re          , Re          , Re          , Re          , Re          , Ds          , Ds          , Ds          , Gg          , Ds          , Ds          , Ds          , Ww          , Ww          , Ds          , Ss          , Ss          , Ds          , Ds          , Re          , Re          , Re          , Ss          , Ss          , Ss          , Ss          , Ss          , Ss          , Ss          , Ss          
Mm          , Mm          , Mm          , Gg^Vh       , Mm          , Mm          , Hh          , Re          , Re          , Gg          , Gg          , Gg          , Gg^Vh       , Gg          , Ds          , Ds          , Ds          , Ds          , Re          , Re          , Gg^Vh       , Re          , Gg          , Gg          , Gg          , Gs          , Ds          , Ww          , Ww          , Ww          , Ds          , Ss          , Ss          , Ds          , Ds          , Ss          , Ss          , Ss          , Ch          , Ch          , Ch          , Ss          , Ds          , Ds          , Re          , Re          , Re          
Mm          , Mm          , Mm          , Mm          , Mm          , Hh          , Hh          , Re          , Re          , Re          , Gg          , Gg          , Gg          , Gg          , Gs          , Gg          , Ds          , Ds          , Ds          , Re          , Re          , Re          , Re          , Gg          , Gg          , Gs          , Ds          , Ww          , Ds          , Ds          , Ss          , Ss          , Ss          , Ss          , Ss          , Ss          , Ss          , Ss          , Ch          , 3 Kh        , Ch          , Ds          , Ds          , Ds          , Ss          , Ss          , Ss          
Mm          , Mm          , Mm          , Mm          , Mm          , Mm          , Hh          , Re          , Re          , Gg          , Gg          , Gg          , Gs          , Gs          , Gg          , Gg          , Gg          , Gg          , Gg          , Gg          , Gg          , Gg          , Gg          , Gg          , Gg          , Gs          , Ds          , Ww          , Ww          , Ds          , Re          , Re          , Re          , Re          , Ss          , Ss          , Gg^Vh       , Re          , Re          , Ch          , Re          , Re          , Ss          , Ss          , Ss          , Ss          , Ss          
Mm          , Mm          , Mm          , Mm          , Mm          , Mm          , Hh          , Re          , Re          , Gg^Vh       , Ds          , Ds          , Ds          , Gg          , Gg          , Gg^Vh       , Gg          , Gg          , Ds          , Ds          , Gg          , Gg          , Re          , Re          , Re          , Ds          , Ds          , Ds          , Ww          , Ds          , Ss          , Ss          , Ss          , Ds          , Ds          , Ss          , Ds          , Ss          , Ss          , Ss          , Ss          , Re          , Gg^Vh       , Ss          , Ss          , Ss          , Ss          
Mm          , Mm          , Mm          , Mm          , Hh          , Hh          , Hh          , Re          , Hh          , Re          , Ds          , Ds          , Ds          , Ds          , Ds          , Re          , Re          , Ds          , Ds          , Ds          , Ds          , Re          , Re          , Re          , Gg          , Ds          , Ds          , Ww          , Ww          , Ds          , Gg^Vh       , Ss          , Ss          , Ss          , Ds          , Ds          , Ds          , Ss          , Ss          , Ss          , Ss          , Re          , Re          , Re          , Ss          , Ss          , Ss          
Mm          , Mm          , Mm          , Mm          , Gg^Vh       , Mm          , Hh          , Hh          , Re          , Hh          , Re          , Ds          , Ds          , Ds          , Re          , Re          , Re          , Re          , Re          , Ds          , Ds          , Ds          , Ds          , Ds          , Ds          , Ds          , Ww          , Ww          , Ds          , Ss          , Ss          , Ss          , Ss          , Re          , Re          , Ss          , Ss          , Gg^Vh       , Ss          , Ss          , Ss          , Ss          , Ds          , Ds          , Ds          , Ss          , Ss          
Mm          , Mm          , Mm          , Mm          , Mm          , Mm          , Mm          , Hh          , Hh          , Re          , Re          , Re          , Re          , Re          , Re          , Re          , Gg^Vh       , Re          , Re          , Re          , Re          , Ds          , Ds          , Ds          , Ds          , Ww          , Ww          , Ds          , Ss          , Ss          , Ss          , Ss          , Re          , Re          , Ss          , Ss          , Ss          , Ss          , Ss          , Re          , Re          , Re          , Ds          , Ds          , Ds          , Ds          , Ds          
Mm          , Mm          , Mm          , Mm          , Mm          , Mm          , Mm          , Hh          , Hh          , Re          , Re          , Re          , Re          , Re          , Re          , Re          , Re          , Re          , Re          , Re          , Re          , Ds          , Ds          , Ds          , Ds          , Ww          , Ww          , Ds          , Ss          , Ss          , Ss          , Ss          , Re          , Re          , Ss          , Ss          , Ss          , Ss          , Ss          , Re          , Re          , Re          , Ds          , Ds          , Ds          , Ds          , Ds          
