border_size=1
usage=map

Gs^Fp       , Gs^Fp       , Gs^Fp       , Gs^Fp       , Gs^Fp       , Gs^Fp       , Gs^Fp       , Gg          , Gg          , Re          , Gg          , Gg          , Gg          , Gg          , Gg          , Gs^Fms      , Gs^Fms      , Ww          , Gs^Fms      , Gs^Fms      , Gs^Fms      
Gs^Fp       , Gs^Fp       , Gs^Fp       , Gs^Fp       , Gg          , Gs^Fp       , Gs^Fp       , Gg          , Re          , Re          , Gg          , Gg          , Gg          , Gg          , Gg          , Gs^Fms      , Gs^Fms      , Ww          , Gs^Fms      , Gs^Fms      , Gs^Fms      
Gs^Fp       , Gs^Fp       , Gs^Fp       , Gs^Fp       , Gs^Fp       , Gs^Fp       , Re          , Re          , Gg          , Re          , Gg          , Gg          , Gg          , Gg          , Gg          , Gs^Fms      , Gs^Fms      , Ww          , Ww          , Gs^Fms      , Ww          
Gs^Fp       , Gs^Fp       , Re          , Re          , Re          , Re          , Gs^Fp       , Gs^Fp       , Gs^Fp       , Re          , Gs^Fp       , Gg          , Gs^Fms      , Gs^Fms      , Gs^Fms      , Gs^Fms      , Gs^Fds      , Gs^Fds      , Ww          , Ww          , Gs^Fds      
Gs^Fp       , Re          , Gs^Fp       , Gs^Fp       , Gs^Fp       , Gs^Fp       , Gs^Fp       , Gs^Fp       , Gs^Fp       , Re          , Gs^Fp       , Gs^Fp       , Gg          , Gg          , Gs^Fms      , Gs^Fms      , Gs^Fds      , Gg^Vh       , Ss          , Gs^Fds      , Ss          
Gs^Fp       , Re          , Gs^Fp       , Gs^Fp       , Gs^Fp       , Gs^Fp       , Gs^Fp       , Gs^Fp       , Gs^Fp       , Re          , Gs^Fp       , Gg          , Gs^Fms      , Gg          , Gs^Fms      , Gs^Fms      , Gs^Fds      , Ss          , Ss          , Ss          , Gs^Fds      
Re          , Re          , Gs^Fp       , Gs^Fp       , Gs^Fp       , Gs^Fp       , Gs^Fp       , Gs^Fp       , Gs^Fp       , Re          , Gs^Fp       , Gg          , Gg          , Gs^Fds      , Gs^Fds      , Gs^Fds      , Ss          , Ss          , Ss          , Gs^Fds      , Gs^Fds      
Hh          , Hh^Fp       , Hh^Fp       , Hh^Fp       , Hh^Fp       , Gs^Fp       , Gs^Fp       , Gs^Fp       , Gs^Fp       , Re          , Re          , Gs^Fp       , Re          , Gs^Fds      , Gs^Fds      , Gs^Fds      , Ss          , Ss          , Ss          , Ss          , Ss          
Mm          , Hh          , Hh          , Hh          , Hh          , Gg          , Gs^Fp       , Gs^Fp       , Gs^Fp       , Gg          , Gs^Fp       , Re          , Re          , Re          , Gs^Fms      , Gs^Fds      , Gs^Fds      , Gg          , Ss          , Ss          , Ss          
Mm^Xm       , Mm          , Mm          , Hh          , Hh          , Gg          , Gg          , Gs^Fp       , Gs^Fp       , Gg          , Gg          , Gs^Fms      , Gs^Fms      , Re          , Gs^Fms      , Gg          , Gs^Fms      , Gg          , Ss          , Ss          , Ss          
Mm^Xm       , Mm^Xm       , Mm^Xm       , Mm          , Mm          , Hh          , Hh^Fp       , Gs^Fp       , Gs^Fp       , Gs^Fp       , Gg          , Gg          , Re          , Re          , Gs^Fms      , Gs^Fms      , Ss          , Ss          , Ss          , Ss          , Ss          
Mm          , Mm^Xm       , Mm^Xm       , Mm          , Mm          , Hh          , Hh          , Hh^Fp       , Gs^Fp       , Gs^Fp       , Gs^Fp       , Re          , Gs^Fp       , Re          , Gs^Fms      , Gs^Fms      , Gs^Fms      , Ss          , Ss          , Ss          , Ss          
Mm          , Mm          , Mm          , Hh          , Hh          , Hh          , Hh^Fp       , Gs^Fp       , Gs^Fp       , Gs^Fp       , Gg^Vh       , Gs^Fp       , Re          , Re          , Gs^Fp       , Gs^Fms      , Gs^Fms      , Gs^Fds      , Gs^Fds      , Ss          , Gs^Fds      
Hh          , Mm          , Hh          , Hh^Fp       , Gs^Fp       , Hh^Fp       , Hh^Fp       , Gs^Fp       , Gs^Fp       , Gs^Fp       , Gg          , Gs^Fp       , Re          , Re          , Re          , Re          , Gs^Fms      , Gs^Fds      , Gs^Fds      , Gs^Fds      , Gs^Fds      
Ww          , Hh          , Ww          , Ww          , Ww          , Gs^Fp       , Gs^Fp       , Gs^Fp       , Re          , Gs^Fp       , Re          , Re          , Gg          , Gs^Fp       , Re          , Gs^Fp       , Gs^Fms      , Gs^Fms      , Gs^Fms      , Gs^Fds      , Gs^Fds      
Ww          , Ww          , Ww          , Ww          , Gg          , Gs^Fp       , Gs^Fp       , Re          , Gs^Fp       , Gg          , Re          , Gs^Fp       , Gg          , Re          , Gs^Fp       , Gs^Fp       , Gg          , Gs^Fms      , Gs^Fms      , Gs^Fms      , Gs^Fms      
Ww          , Ww          , Ww          , Gg          , Gs^Fms      , Gs^Fp       , Gs^Fp       , Gs^Fp       , Gs^Fp       , Gg          , Re          , Re          , Gs^Fp       , Gs^Fp       , Re          , Gs^Fp       , Gs^Fp       , Gs^Fp       , Gs^Fp       , Gs^Fms      , Gs^Fms      
Gs^Fms      , Ww          , Gg^Ve       , Gs^Fms      , Gs^Fms      , Gs^Fp       , Gs^Fp       , Gs^Fp       , Gs^Fp       , Re          , Re          , Gg          , Gs^Fp       , Gs^Fp       , Gs^Fp       , Gs^Fp       , Gs^Fp       , Gs^Fp       , Gg          , Hh^Fms      , Hh^Fms      
Gs^Fms      , Gs^Fms      , Gs^Fms      , Gs^Fms      , Gs^Fms      , Gs^Fp       , Gs^Fms      , Gs^Fms      , Gg          , Gg          , Re          , Gg          , Gg^Vh       , Gs^Fp       , Gs^Fp       , Gs^Fp       , Gs^Fp       , Gs^Fp       , Hh          , Hh^Fms      , Hh^Fms      
Gs^Fms      , Gs^Fms      , Gs^Fms      , Gs^Fms      , Gg          , Gs^Fms      , Gs^Fms      , Gs^Fms      , Re          , Re          , Re          , Gs^Fp       , Gg          , Gs^Fp       , Gs^Fms      , Gs^Fms      , Hh          , Hh          , Mm          , Mm          , Mm^Xm       
Gs^Fms      , Gs^Fms      , Gs^Fms      , Gg          , Gs^Fms      , Gs^Fms      , Re          , Gs^Fms      , Gg          , Gs^Fms      , Gg          , Re          , Re          , Gg          , Re          , Gs^Fms      , Hh          , Mm          , Mm^Xm       , Mm^Xm       , Mm^Xm       
Gs^Fms      , Gs^Fms      , Gg^Fet      , Gs^Fms      , Gs^Fms      , Gs^Fms      , Re          , Gs^Fms      , Gs^Fms      , Gs^Fms      , Gg^Ve       , Gg          , Re          , Re          , Gs^Fms      , Hh          , Mm          , Mm          , Mm          , Mm^Xm       , Mm          
Gs^Fms      , Gs^Fms      , Gs^Fms      , Gs^Fms      , Gs^Fms      , Gs^Fms      , Gg          , Gs^Fms      , Gs^Fms      , Gs^Fms      , Gs^Fms      , Gs^Fms      , Re          , Gg          , Gs^Fms      , Re          , Gs^Fds      , Mm          , Mm          , Mm          , Re          
Gs^Fms      , Gs^Fms      , Gs^Fms      , Gs^Fms      , Gg^Vh       , 2 Kh        , Ch          , Gs^Fms      , Gs^Fms      , Gs^Fms      , Gs^Fms      , Gg          , Rd          , Gg          , Gs^Fms      , Gs^Fds      , Gg          , Re          , Re          , Re          , Gs^Fds      
Gs^Fms      , Gs^Fms      , Gs^Fms      , Gg          , Gg          , Gs^Fms      , Gs^Fms      , Gs^Fms      , Gs^Fms      , Gs^Fms      , Rd          , Rd          , Gs^Fms      , Gg          , Hh          , Gg          , Hh^Fds      , Hh^Fds      , Hh^Fds      , Gs^Fds      , Gs^Fds      
Gs^Fms      , Gs^Fms      , Gs^Fms      , Gs^Fms      , Gs^Fms      , Gs^Fms      , Gg          , Gs^Fms      , Gs^Fms      , Gs^Fms      , Gg          , Rd          , Rd          , Hh          , Gs^Fms      , Hh          , Hh          , Hh          , Hh          , Gg          , Gs^Fds      
Ww          , Wwf         , Wwf         , Gg          , Ww          , Ww          , Gs^Fms      , Gs^Fms      , Gs^Fms      , Gg          , Gs^Fms      , Re          , Gg          , Gg          , Gs^Fds      , Hh^Fds      , Hh^Fds      , Hh          , Hh          , Hh^Fds      , Gs^Fds      
Re          , Re          , Gs^Fms      , Ww          , Ww          , Ww          , Ww          , Gg          , Ww          , Ww          , Ww          , Re          , Wwf         , Gg          , Ww          , Gs^Fds      , Ww          , Ww          , Ww          , Ww          , Ww          
Hh          , Rd          , Re          , Ww          , Gs^Fms      , Ww          , Gs^Fms      , Ww          , Gs^Fms      , Gs^Fms      , Gs^Fms      , Wwf         , Gg          , Ww          , Gs^Fds      , Ww          , Gs^Fds      , Gs^Fds      , Ww          , Ww          , Gg          
Hh^Fms      , Hh          , Re          , Hh          , Hh          , Gs^Fms      , Gs^Fms      , Gs^Fms      , Gs^Fms      , Gg^Ve       , Rd          , Rd          , Gs^Fms      , Gg          , Gs^Fds      , Gs^Fds      , Gs^Fms      , Ww          , Gs^Fds      , Ww          , Gg          
Hh^Fms      , Hh^Fms      , Hh^Fms      , Hh          , Gs^Fms      , Gg          , Gs^Fms      , Gs^Fms      , Gs^Fms      , Gs^Fms      , Gg          , Rd          , Rd          , Gg^Ve       , Gg          , Gs^Fms      , Gs^Fms      , Gs^Fds      , Gs^Fms      , Gg          , Gg          
Hh          , Hh          , Gs^Fms      , Gg          , Gs^Fms      , Gs^Fms      , Gs^Fms      , Gg          , Gg          , Gs^Fms      , Gg^Vh       , Rd          , Gs^Fms      , Gs^Fms      , Gs^Fms      , Gs^Fms      , Gg          , Gs^Fms      , Gs^Fms      , Gs^Fms      , Gs^Fms      
Gs^Fms      , Gs^Fms      , Gs^Fms      , Gs^Fms      , Re          , Re          , Gs^Fms      , Gg          , Gg          , Gs^Fms      , Gs^Fms      , Rd          , Gs^Fms      , Gs^Fms      , Gg          , Gs^Fms      , Gg          , Gg          , Gs^Fms      , Gs^Fms      , Gs^Fms      
Re          , Gs^Fms      , Gg          , Re          , Gg          , Re          , Gg          , Gg          , Gs^Fms      , Gs^Fms      , Gs^Fms      , Rd          , Gs^Fms      , Gg^Vh       , Gs^Fms      , Gg          , Gs^Fms      , Gs^Fms      , Gs^Fms      , Gs^Fms      , Gs^Fms      
Gs^Fms      , Re          , Re          , Gg          , Gg          , Gs^Fms      , Chr         , Gs^Fms      , Gg          , Gg          , Gg          , Rd          , Gg          , Gs^Fms      , Gs^Fms      , Gs^Fms      , Hh          , Hh          , Hh^Fms      , Hh^Fms      , Gs^Fms      
Gs^Fms      , Gs^Fms      , Gs^Fms      , Gs^Fms      , Gs^Fms      , Chr         , Gs^Fms      , Gg          , Gg          , Gs^Fms      , Rd          , Rd          , Re          , Gg          , Gg          , Gs^Fms      , Gs^Fms      , Hh          , Gs^Fms      , Hh^Fms      , Gs^Fms      
Gs^Fms      , Gs^Fms      , Gs^Fms      , Re          , Gs^Fms      , Chr         , Gg          , Chr         , Gg          , Gs^Fms      , Rd          , Gs^Fms      , Gg          , Re          , Re          , Gs^Fms      , Gs^Fms      , Gs^Fms      , Gs^Fms      , Gg^Vh       , Gg          
Gs^Fms      , Gs^Fms      , Gg          , Gg          , Gg          , Gg          , Gg          , Gs^Fms      , Re          , Rd          , Gs^Fms      , Gg          , Gs^Fms      , Gs^Fms      , Gs^Fms      , Re          , Re          , Gs^Fms      , Gs^Fms      , Gs^Fms      , Gs^Fms      
Gs^Fms      , Gs^Fms      , Gs^Fms      , Gg^Ve       , Gs^Fms      , Gg          , Rd          , Rd          , Gg          , Gs^Fms      , Gs^Fms      , Gg          , Gs^Fms      , Gg^Ve       , Gs^Fms      , Gs^Fms      , Re          , Gg          , Gs^Fms      , Gs^Fms      , Gs^Fms      
Gs^Fms      , Gs^Fms      , Gs^Fms      , Gs^Fms      , Gs^Fms      , Gs^Fms      , Rd          , Gg          , Gg          , Gs^Fms      , Gg          , Gs^Fms      , Gg          , Gs^Fms      , Gg          , Gs^Fms      , Re          , Gs^Fms      , Gs^Fms      , Gs^Fms      , Gs^Fms      
Gs^Fms      , Gs^Fms      , Gs^Fms      , Gg          , Gg          , Re          , Rd          , Gg          , Gg^Vh       , Gg          , Gs^Fms      , Gs^Fms      , Gs^Fms      , Gg          , Gg          , Gg          , Gs^Fms      , Re          , Re          , Re          , Re          
Gs^Fms      , Gs^Fms      , Gs^Fms      , Gs^Fms      , Gg          , Gg          , Gs^Fms      , Rd          , Rd          , Gs^Fms      , Gs^Fms      , Gg          , Gs^Fms      , Gg          , Gs^Fms      , Gg          , Gs^Fms      , Gs^Fms      , Gs^Fms      , Gg          , Gg          
Gs^Fms      , Gs^Fms      , Gs^Fms      , Gs^Fms      , Gs^Fms      , Gg          , Rd          , Rd          , Gs^Fms      , Gg          , Gs^Fms      , Gs^Fms      , Gg          , Gg          , Gg          , Gg          , Gg          , Gs^Fms      , Gs^Fms      , Gg          , Gs^Fms      
Gg          , Gs^Fms      , Gg          , Gg          , Rd          , Rd          , Gs^Fms      , Gg          , Gs^Fms      , Gg          , Gg          , Gg          , Gs^Fms      , Gs^Fms      , Gs^Fms      , Gg          , Gs^Fms      , Gs^Fms      , Gs^Fms      , Gs^Fms      , Gs^Fms      
Gg          , Gg          , Gg          , Gs^Fms      , Gg          , Rd          , Rd          , Gg          , Gg          , Gg          , Gg          , Gs^Fms      , Re          , Gg          , Gs^Fms      , Gs^Fms      , Gg          , Gg          , Gg          , Gs^Fms      , Gs^Fms      
Gg          , Gg          , Gg          , Gs^Fms      , Gg          , Gs^Fms      , Gs^Fms      , Rd          , Gs^Fms      , Gs^Fms      , Gs^Fms      , Re          , Gs^Fms      , Gs^Fms      , Gg          , Gs^Fms      , Gs^Fms      , Gg          , Gs^Fms      , Gs^Fms      , Gs^Fms      
Gs^Fms      , Gs^Fms      , Gs^Fms      , Gs^Fms      , Gg          , Gg          , Gs^Fms      , Rd          , Gs^Fms      , Gg          , Gg          , Gs^Fms      , Gg^Vh       , Gg          , Gg          , Gs^Fms      , Gg          , Gs^Fms      , Gg          , Gg          , Gs^Fms      
Gs^Fms      , Gs^Fms      , Gs^Fms      , Gg^Vh       , Gs^Fms      , Gs^Fms      , Rd          , Rd          , Rd          , Rd          , Rd          , Gs^Fms      , Gs^Fms      , Gs^Fms      , Gs^Fms      , Gs^Fms      , Rd          , Gs^Fms      , Rd          , Gs^Fms      , Gs^Fms      
Gg          , Gs^Fms      , Gg          , Gs^Fms      , Rd          , Rd          , Gg          , Gg          , Gg          , Gg          , Gg          , Gg          , Rd          , Gg          , Rd          , Gs^Fms      , Gs^Fms      , Rd          , Gs^Fms      , Rd          , Rd          
Rd          , Rd          , Rd          , Rd          , Gg          , Gg          , Gg          , Gg          , Ce          , Ce          , Ce          , Gg          , Gg          , Rd          , Gg          , Gg          , Gg          , Gs^Fms      , Gg          , Gg          , Gg          
Gg          , Gs^Fms      , Gg          , Rd          , Gg          , Gg          , Gg          , Ce          , Ce          , 1 Ke        , Ce          , Ce          , Gg          , Gg          , Gg          , Gg          , Gs^Fds      , Gs^Fds      , Hh          , Hh          , Hh          
Gg          , Gg          , Gg          , Gg          , Gg          , Gg          , Gg          , Gg          , Gg          , Ce          , Gg          , Gg          , Gg          , Gg          , Gg          , Gg          , Gg^Vh       , Hh^Fds      , Hh^Fds      , Mm          , Hh          
Ww          , Ww          , Ww          , Gs^Fds      , Gs^Fds      , Gs^Fds      , Gs^Fds      , Gg          , Gg          , Gg          , Gg          , Gg          , Gg          , Gg          , Gg          , Gs^Fds      , Gs^Fds      , Hh^Fds      , Hh^Fds      , Hh          , Gs^Fds      
Ww          , Ww          , Ww          , Ww          , Gs^Fds      , Gs^Fds      , Gs^Fds      , Gg          , Gg          , Gg          , Gg          , Gg          , Gg          , Gg          , Gg          , Gg          , Gg          , Gs^Fds      , Gs^Fds      , Gs^Fds      , Gs^Fds      
Ww          , Ww          , Ww          , Gs^Fds      , Gs^Fds      , Gs^Fds      , Gs^Fds      , Gg          , Gg          , Gg          , Gg          , Gg          , Gg          , Gg          , Gg          , Gg          , Gg          , Gg          , Gs^Fds      , Gs^Fds      , Gs^Fds      
