Mm^Xm       , Mm^Xm       , Mm^Xm       , Mm          , Mm          , Hh          , Hh          , Hh          , Gg          , Gg          , Gs^Fp       , Gs^Fp       , Gs^Fp       , Ggf         , Rr          , Gg          , Gg          , Gg          , Gs^Fp       , Gs^Fp       , Gs^Fp       , Gs^Fp       , Gs^Fp       , Ggf         , Gs^Fp       , Ggf         
Mm^Xm       , Mm^Xm       , Mm^Xm       , Mm          , Mm          , Mm          , Gs^Fp       , Hh          , Hh          , Hh          , Ch          , 3 Kh        , Ch          , Gg          , Rr          , Gg          , Gg          , Gg          , Gs^Fp       , Gs^Fp       , Gs^Fp       , Gg          , Gs^Fp       , Gs^Fp       , Gs^Fp       , Gs^Fp       
Mm^Xm       , Mm^Xm       , Mm^Xm       , Mm          , Hh          , Gs^Fp       , Gg          , Hh          , Gs^Fp       , Gg          , Gg^Vh       , Ch          , Gg^Vh       , Rr          , Rr          , Gg          , Gg          , Gg          , Gg          , Gs^Fp       , Gg          , Gs^Fp       , Gg^Vh       , Gs^Fp       , Re          , Gs^Fp       
Mm          , Mm          , Mm          , Mm          , Mm^Vhh      , Hh          , Gg          , Gg          , Gs^Fp       , Gg          , Gg          , Gg          , Gg          , Rr          , Gg          , Gg          , Gg          , Ggf         , Gg          , Gg          , Gg          , Re          , Gg          , Gs^Fp       , Re          , Gs^Fp       
Mm          , Mm          , Mm          , Gs^Fp       , Gs^Fp       , Hh          , Hh          , Gg          , Gg          , Gg          , Gg          , Gg          , Gg          , Rr          , Gg          , Gg          , Ggf         , Gg          , Gg          , Gg          , Gg          , Gg          , Gs^Fp       , Gs^Fp       , Gs^Fp       , Gs^Fp       
Gg          , Hh          , Gs^Fp       , Gs^Fp       , Gs^Fp       , Hh          , Gs^Fp       , Gg          , Gg          , Gg          , Gg          , Gg          , Gg          , Hh          , Rr          , Rr          , Gg          , Hh          , Gg          , Gg          , Gg          , Gg          , Gg          , Gg          , Gg          , Gg          
Hh          , Hh          , Gg^Vh       , Gg          , Hh          , Gg          , Gg          , Gg          , Gs^Fp       , Gg          , Gg          , Gg          , Hh^Vhh      , Hh          , Hh          , Rr          , Hh          , Gg          , Hh          , Gg          , Gg          , Gg          , Gg          , Gg          , Gs^Fp       , Gg          
Hh          , Gg          , Gs^Fp       , Gg          , Gs^Fp       , Gg          , Gs^Fp       , Gs^Fp       , Gg          , Gg          , Gg          , Hh          , Hh          , Rr          , Rr          , Hh          , Gg          , Gg          , Gg          , Gg          , Gg          , Gg          , Gg          , Gs^Fp       , Gs^Fp       , Gs^Fp       
Gg          , Gg          , Gg          , Hh          , Gg          , Gg          , Gg          , Gg          , Gg          , Gg          , Gg          , Hh          , Gg          , Rr          , Hh          , Hh          , Hh          , Hh          , Gg          , Gg          , Gg          , Gg          , Gg          , Gg          , Gs^Fp       , Gs^Fp       
Gg          , Hh          , Hh          , Gg          , Hh          , Gg          , Gg          , Gg          , Gg          , Gg          , Hh          , Rr          , Rr          , Hh          , Re          , Gg          , Re          , Re          , Gg          , Re          , Gg          , Gg          , Gg          , Re          , Gg          , Gg          
Gg          , Gg          , Gg          , Ggf         , Gg          , Ggf         , Gg          , Gg          , Gg          , Rr          , Rr          , Hh          , Hh          , Hh          , Gg          , Hh          , Gg          , Gg          , Hh          , Gg          , Re          , Gg          , Re          , Gg          , Re          , Re          
Gg          , Ggf         , Gg          , Gg          , Gg          , Gg          , Gg          , Gg          , Gg          , Rr          , Hh          , Hh          , Mm          , Mm          , Hh          , Mm          , Hh          , Gg          , Gg          , Gg          , Gg          , Gg          , Gg          , Ce          , Gg          , Gg          
Gg          , Hh          , Gg          , Gg          , Gg          , Gg          , Gg          , Gg          , Hh          , Gg          , Rr          , Hh          , Gs^Fp       , Hh          , Hh          , Mm          , Hh          , Hh          , Gg          , Gg^Vh       , Gg          , Gg          , Ce          , 2 Ke        , Ce          , Gg          
Gs^Fp       , Gs^Fp       , Hh          , Gs^Fp       , Hh          , Gg          , Gg          , Gg          , Gg          , Ggf         , Rr          , Rr          , Hh          , Hh          , Hh          , Mm          , Hh          , Hh          , Gg          , Gg          , Gg          , Ce          , Ce          , Gs^Fp       , Ce          , Gg          
Gs^Fp       , Gs^Fp       , Gs^Fp       , Gs^Fp       , Hh          , Gg          , Gg          , Gg          , Gg          , Gg          , Gg          , Rr          , Gg          , Hh          , Gs^Fp       , Mm          , Mm          , Mm          , Hh          , Hh          , Gg          , Gg          , Gs^Fp       , Ce          , Ce          , Gg          
Gs^Fp       , Gg          , Gs^Fp       , Gs^Fp       , Gs^Fp       , Gg          , Gg          , Ggf         , Gg          , Gg          , Gg          , Rr          , Gg          , Gs^Fp       , Hh          , Hh          , Mm          , Hh          , Mm          , Hh          , Gs^Fp       , Gs^Fp       , Gs^Fp       , Gg          , Gg^Vh       , Gg          
Gs^Fp       , Gs^Fp       , Gs^Fp       , Gg          , Gg          , Gg          , Gg          , Gg          , Gg          , Gg          , Gg          , Gg          , Rr          , Gg          , Gs^Fp       , Gs^Fp       , Hh          , Mm          , Mm^Vhh      , Mm          , Gs^Fp       , Hh          , Hh          , Gg          , Gg          , Ww          
Gs^Fp       , Gg          , Gs^Fp       , Gg          , Gg^Vh       , Gg          , Gg          , Re^Gvs      , Re^Gvs      , Re^Gvs      , Gg          , Gg          , Rr          , Gg          , Gs^Fp       , Hh          , Hh          , Gs^Fp       , Mm          , Mm          , Hh          , Re          , Hh          , Ww          , Wwf         , Gg          
Gg          , Gg          , Gg          , Gg          , Gg          , Re^Gvs      , Re^Gvs      , Re^Gvs      , Re^Gvs      , Re^Gvs      , Re^Gvs      , Gg          , Rr          , Gg          , Gg          , Hh          , Hh          , Hh          , Hh^Vhh      , Hh          , Mm          , Mm          , Re          , Wwf         , Gg          , Hh          
Gg          , Gg          , Gg          , Gg          , Re^Gvs      , Re^Gvs      , Re^Gvs      , Re^Gvs      , Re^Gvs      , Gg          , Gg          , Rr          , Rr          , Gg          , Gg          , Gg          , Gs^Fp       , Gg          , Hh          , Hh          , Hh          , Ww          , Ww          , Mm          , Re          , Re          
Ww          , Wwf         , Gg          , Gg          , Gg          , Gg          , Re^Gvs      , Gg          , Gg          , Gg          , Gg          , Rr          , Gg          , Gg          , Gg          , Gg          , Gg          , Gg          , Gg          , Gg          , Hh          , Ww          , Hh          , Hh          , Mm          , Gg          
Gg          , Gg          , Ww          , Ww          , Wwf         , Ww          , Gg          , Gg          , Gg          , Gg          , Gg          , Gg          , Rr          , Gg          , Gg          , Ww          , Gg          , Gg          , Gg          , Ww          , Wwf         , Gg          , Hh          , Gs^Fp       , Hh^Vhh      , Gs^Fp       
Gg          , Gg          , Gg^Vh       , Gg          , Gg          , Gg          , Wwf         , Ww          , Ww          , Wwf         , Ww          , Ww          , Rr          , Gg          , Ww          , Wo          , Gg          , Ww          , Ww          , Wo          , Ww          , Gg          , Gg          , Gg          , Gs^Fp       , Gs^Fp       
Gg          , Gg          , Gg          , Gg          , Gg          , Gg          , Gg          , Gg          , Gg          , Gg          , Gg          , Gg          , Ww^Bw|      , Ww          , Ww          , Ww          , Ww          , Gg          , Ww          , Ww          , Ww          , Gg          , Gg          , Gg          , Gg          , Re          
Gg          , Gg          , Gg          , Gg          , Gg          , Gg          , Gg          , Ggf         , Gg          , Gg          , Gg          , Rr          , Rr          , Ww          , Ww          , Ww          , Gg          , Ww          , Ww          , Gg          , Ww          , Gg          , Gg          , Gg          , Re          , Gg          
Gg          , Ce          , Ce          , Ce          , Gg          , Gg          , Gg          , Gg          , Gg          , Ggf         , Gg          , Rr          , Gg          , Ww          , Wo          , Wo          , Ww          , Ww          , Gg^Vh       , Wwf         , Ww          , Gg          , Gg          , Re          , Re          , Gg          
Gg          , Ce          , 1 Ke        , Ce          , Gg          , Gg          , Gg          , Gg          , Gg          , Gg          , Gg          , Rr          , Gg          , Gg          , Ww          , Ww          , Ww          , Gg          , Ww          , Re          , Gg          , Gs^Fp       , Gs^Fp       , Re          , Gs^Fp       , Gs^Fp       
Gg          , Ce          , Ce          , Ce          , Gg          , Gg          , Gg          , Gg          , Gg          , Ggf         , Gg          , Gg          , Rr          , Gg          , Ww          , Gg          , Gg          , Ggf         , Gg          , Re          , Gg          , Gs^Fp       , Gs^Fp       , Gs^Fp       , Gg          , Gg          
Gg          , Gg          , Gg          , Gg          , Gg          , Gg          , Gg          , Gs^Fp       , Gg          , Gg          , Gg          , Gg          , Rr          , Gg          , Gg          , Gg          , Ggf         , Gg          , Re          , Gg          , Gs^Fp       , Gs^Fp       , Re          , Gg^Vh       , Gs^Fp       , Gs^Fp       
Gg          , Gg          , Gg          , Gg          , Gg          , Gg          , Gg          , Gs^Fp       , Gs^Fp       , Gg          , Gg          , Rr          , Rr          , Re          , Re          , Re          , Re          , Re          , Re          , Re          , Re          , Re          , Re          , Gs^Fp       , Gs^Fp       , Gs^Fp       
Gg          , Gg          , Gg          , Gg          , Gg          , Gs^Fp       , Gs^Fp       , Gs^Fp       , Gs^Fp       , Gg          , Gg          , Rr          , Gg          , Gg          , Gg          , Gg          , Gg          , Gg          , Gg          , Gg          , Gs^Fp       , Gs^Fp       , Gs^Fp       , Gs^Fp       , Gs^Fp       , Gs^Fp       
