
border_size=1
usage=map

Qxu         ,Qxu         , Qxu         , Qxu         , Qxu         , Qxu         , Qxu         , Qxu         , Qxu         , Qxu         , Qxu         , Qxu         , Qxu         , Qxu         , Qxu         , Qxu         , Qxu         , Qxu         , Qxu         , Qxu         , Qxu         , Qxu         , Qxu         , Qxu         , Qxu         , Qxu         , Qxu         , Qxu         , Cud         , Qxu         , Qxu         , Qxu         
Qxu         ,Qxu         , Qxu         , Qxu         , Qxu         , Qxu         , Qxu         , Qxu         , Qxu         , Qxu         , Qxu         , Qxu         , Qxu         , Qxu         , Qxu         , Qxu         , Qxu         , Qxu         , Qxu         , Qxu         , Qxu         , Qxu         , Qxu         , Qxu         , Qxu         , Qxu         , Qxu         , Qxu         , Cud         , Qxu         , Qxu         , Qxu         
Qxu         ,Qxu         , Qxu         , Qxu         , Qxu         , Qxu         , Qxu         , Qxu         , Qxu         , Qxu         , Qxu         , Qxu         , Qxu         , Qxu         , Qxu         , Qxu         , Qxu         , Qxu         , Qxu         , Qxu         , Qxu         , Qxu         , Qxu         , Qxu         , Qxu         , Qxu         , Qxu         , Cud         , 2 Kud       , Cud         , Qxu         , Qxu         
Qxu         ,Qxu         , Qxu         , Qxu         , Qxu         , Qxu         , Hh          , Hh          , Hh          , Hh          , Hh          , Hh          , Hh          , Hh          , Hh          , Hh          , Hh          , Hh          , Hh          , Hh          , Hh          , Hh          , Re          , Hh          , Hh          , Qxu         , Re          , Cud         , Cud         , Cud         , Qxu         , Qxu         
Qxu         ,Qxu         , Qxu         , Qxu         , Hh          , Hh          , Re          , Re          , Ss          , Ss          , Ss          , Ss          , Ss          , Ss          , Ss          , Ss          , Ss          , Ss          , Ss          , Ss          , Ss          , Ss          , Ww^Bw/      , Re          , Re          , Re          , Re          , Re          , Hh          , Qxu         , Qxu         , Qxu         
Qxu         ,Qxu         , Qxu         , Hh          , Re          , Re          , Re          , Re          , Re          , Ss          , Ds          , Ss          , Ss          , Ss          , Ds          , Ds          , Ds          , Ds          , Ss          , Ss          , Ww^Bw/      , Ww^Bw/      , Ss          , Re          , Ss          , Ss          , Ss          , Re          , Hh          , Qxu         , Qxu         , Qxu         
Qxu         ,Qxu         , Qxu         , Hh          , Gg          , Gg          , Gg          , Re          , Re          , Re          , Ds          , Ds          , Ss          , Ss          , Ss          , Ds          , Ss          , Ss          , Ww^Bw/      , Ww^Bw/      , Ss          , Ss          , Ss          , Ss          , Ss          , Ss          , Ss          , Re          , Hh          , Qxu         , Qxu         , Qxu         
Qxu         ,Qxu         , Qxu         , Hh          , Gg          , Gg          , Gg          , Re          , Re          , Re          , Re          , Ss          , Re          , Ss          , Ss          , Ss          , Ww^Bw/      , Ww^Bw/      , Ss          , Ss          , Ss          , Re          , Re          , Ss          , Ss          , Ds          , Ds          , Ss          , Hh          , Qxu         , Qxu         , Qxu         
Qxu         ,Qxu         , Qxu         , Hh          , Gg          , Gg          , Gg          , Gg          , Gg          , Re          , Re          , Re          , Re          , Re          , Re          , Re          , Re          , Ss          , Ss          , Ss          , Ds          , Re          , Ss          , Re          , Ss          , Ds          , Ss          , Ss          , Hh          , Qxu         , Qxu         , Qxu         
Qxu         ,Qxu         , Qxu         , Hh          , Gg          , Gg          , Gs^Fp       , Gg          , Gg          , Gg          , Gg          , Re          , Re          , Re          , Re          , Re          , Re          , Ss          , Ds          , Ds          , Ss          , Ss          , Ss          , Ds          , Ss          , Ds          , Ss          , Ss          , Hh          , Qxu         , Qxu         , Qxu         
Qxu         ,Qxu         , Qxu         , Hh          , Gs^Fp       , Gs^Fp       , Gs^Fp       , Gs^Fp       , Gg          , Gg          , Gg          , Gg          , Gs^Fp       , Gs^Fp       , Re          , Re          , Re          , Re          , Re          , Ds          , Ds          , Ds          , Ss          , Ss          , Ds          , Ds          , Ss          , Ss          , Hh          , Qxu         , Qxu         , Qxu         
Qxu         ,Qxu         , Qxu         , Hh          , Gs^Fp       , Gs^Fp       , Gs^Fp       , Gg          , Gg          , Gg          , Gg          , Gs^Fp       , Gs^Fp       , Gs^Fp       , Re          , Re          , Re          , Re          , Re          , Ss          , Re          , Ds          , Ss          , Ss          , Ss          , Re          , Re          , Ss          , Hh          , Qxu         , Qxu         , Qxu         
Qxu         ,Qxu         , Qxu         , Hh          , Gg          , Gs^Fp       , Gg          , Gg          , Re          , Gg          , Re          , Re          , Re          , Gs^Fp       , Re          , Gg          , Gg          , Re          , Re          , Re          , Re          , Re          , Re          , Ss          , Ss          , Ds          , Re          , Re          , Hh          , Qxu         , Qxu         , Qxu         
Qxu         ,Qxu         , Qxu         , Hh          , Gg          , Gg          , Re          , Re          , Gg          , Re          , Gs^Fp       , Gg          , Gg          , Re          , Gg          , Gg          , Gg          , Gg          , Gg          , Re          , Re          , Re          , Re          , Re          , Re          , Ss          , Re          , Re          , Hh          , Qxu         , Qxu         , Qxu         
Qxu         ,Qxu         , Qxu         , Hh          , Re          , Re          , Gg          , Gg          , Gg          , Gg          , Gs^Fp       , Gs^Fp       , Gs^Fp       , Gg          , Gg          , Gg          , Gg          , Gg          , Gs^Fp       , Gg          , Gs^Fp       , Re          , Gg          , Re          , Re          , Ss          , Re          , Re          , Hh          , Qxu         , Qxu         , Qxu         
Qxu         ,Qxu         , Qxu         , Hh          , Re          , Gg          , Gg          , Gg          , Gg          , Gs^Fp       , Gs^Fp       , Gs^Fp       , Gs^Fp       , Gg          , Gg          , Gg          , Gg          , Gs^Fp       , Gs^Fp       , Gs^Fp       , Gs^Fp       , Gg          , Gg          , Gg          , Re          , Re          , Re          , Re          , Hh          , Qxu         , Qxu         , Qxu         
Qxu         ,Qxu         , Qxu         , Hh          , Gg          , Re          , Gg          , Gg          , Gs^Fp       , Gs^Fp       , Gs^Fp       , Gs^Fp       , Gs^Fp       , Gg          , Gg          , Gg          , Gg          , Gs^Fp       , Gs^Fp       , Gs^Fp       , Gs^Fp       , Gs^Fp       , Gs^Fp       , Gs^Fp       , Gs^Fp       , Re          , Hh          , Hh          , Qxu         , Qxu         , Qxu         , Qxu         
Qxu         ,Qxu         , Qxu         , Hh          , Re          , Re          , Hh          , Gg          , Gg          , Gs^Fp       , Gg          , Gs^Fp       , Gg          , Gg          , Gg          , Gg          , Gg          , Gg          , Gg          , Gs^Fp       , Gs^Fp       , Gs^Fp       , Gs^Fp       , Gs^Fp       , Hh          , Hh          , Qxu         , Qxu         , Qxu         , Qxu         , Qxu         , Qxu         
Qxu         ,Qxu         , Cud         , Cud         , Cud         , Hh          , Qxu         , Hh          , Hh          , Hh          , Hh          , Hh          , Hh          , Hh          , Hh          , Hh          , Hh          , Hh          , Hh          , Hh          , Hh          , Hh          , Hh          , Hh          , Qxu         , Qxu         , Qxu         , Qxu         , Qxu         , Qxu         , Qxu         , Qxu         
Qxu         ,Qxu         , Cud         , 1 Kud       , Cud         , Qxu         , Qxu         , Qxu         , Qxu         , Qxu         , Qxu         , Qxu         , Qxu         , Qxu         , Qxu         , Qxu         , Qxu         , Qxu         , Qxu         , Qxu         , Qxu         , Qxu         , Qxu         , Qxu         , Qxu         , Qxu         , Qxu         , Qxu         , Qxu         , Qxu         , Qxu         , Qxu         
Qxu         ,Qxu         , Qxu         , Cud         , Qxu         , Qxu         , Qxu         , Qxu         , Qxu         , Qxu         , Qxu         , Qxu         , Qxu         , Qxu         , Qxu         , Qxu         , Qxu         , Qxu         , Qxu         , Qxu         , Qxu         , Qxu         , Qxu         , Qxu         , Qxu         , Qxu         , Qxu         , Qxu         , Qxu         , Qxu         , Qxu         , Qxu         
Qxu         ,Qxu         , Qxu         , Cud         , Qxu         , Qxu         , Qxu         , Qxu         , Qxu         , Qxu         , Qxu         , Qxu         , Qxu         , Qxu         , Qxu         , Qxu         , Qxu         , Qxu         , Qxu         , Qxu         , Qxu         , Qxu         , Qxu         , Qxu         , Qxu         , Qxu         , Qxu         , Qxu         , Qxu         , Qxu         , Qxu         , Qxu         
