border_size=1
usage=map

Mm          ,Mm          , Mm          , Hh          , Re          , Re          , Gg          , Re          , Gg          , Ww          , Gs^Fp       , Gg          , Gg          , Hh          , Mm          , Mm          , Mm          , Mm          , Xu          , Xu          , Xu          , Xu          
Mm          ,Mm          , Mm          , Hh          , Re          , Re          , Gg          , Re          , Gg          , Ww          , Gs^Fp       , Gg          , Gg          , Hh          , Mm          , Mm          , Mm          , Mm          , Xu          , Xu          , Xu          , Xu          
Mm          ,Mm          , Re          , Re          , Hh          , Hh          , Gg^Ve       , Gg          , Gg          , Ww          , Gs^Fp       , Gg^Ve       , Gg          , Hh          , Mm          , Mm          , Xu          , Xu          , Cud         , Xu          , Xu          , Xu          
Mm          ,Mm          , Uu          , Mm          , Mm          , Mm          , Hh          , Gg          , Gg          , Ww          , Ww          , Gs^Fp       , Gg          , Hh          , Mm          , Mm          , Uh          , Cud         , 3 Kud       , Cud         , Xu          , Xu          
Xu          ,Xu          , Uu          , Xu          , Mm          , Mm          , Mm          , Hh          , Gg          , Gg          , Gg          , Ww          , Gg          , Hh          , Hh          , Mm          , Uu          , Cud         , Cud         , Cud         , Xu          , Xu          
Xu          ,Xu          , Uu          , Xu          , Xu          , Mm          , Mm          , Hh          , Gg          , Gg          , Ww          , Ww          , Gg          , Gg          , Re          , Re          , Mm          , Uh          , Xu          , Xu          , Xu          , Xu          
Xu          ,Xu          , Uu          , Uu          , Uu          , Mm          , Hh          , Hh          , Gg          , Gg          , Ww          , Gg          , Re          , Re          , Gg          , Hh          , Mm          , Mm          , Mm          , Mm          , Mm          , Mm          
Xu          ,Xu          , Xu          , Xu          , Mm          , Re          , Re          , Gg          , Gg          , Gg          , Ww^Bw/      , Re          , Gg          , Gg          , Hh          , Hh          , Hh          , Mm          , Mm          , Mm          , Mm          , Mm          
Xu          ,Xu          , Mm          , Mm          , Mm          , Hh          , Hh          , Re          , Re          , Re          , Gg          , Ww          , Gg          , Gg^Ve       , Gg          , Hh          , Gg          , Hh          , Mm          , Mm          , Mm          , Mm          
Mm          ,Mm          , Mm          , Mm          , Mm          , Hh          , Gg^Ve       , Gg          , Gg          , Re          , Gg          , Ww          , Gg          , Gg          , Gs^Fp       , Gg          , Gg          , Hh          , Mm          , Mm          , Mm          , Mm          
Mm          ,Mm          , Mm          , Hh          , Hh          , Hh          , Hh          , Gg          , Gg          , Re          , Gg          , Ww          , Ww          , Gg          , Gs^Fp       , Gs^Fp       , Gg          , Hh          , Mm          , Mm          , Mm          , Mm          
Mm          ,Mm          , Mm          , Mm          , Mm          , Mm          , Mm          , Hh          , Gg          , Re          , Re          , Gg          , Ww          , Gg          , Gg          , Gg          , Hh          , Hh          , Mm          , Mm          , Mm          , Mm          
Mm          ,Mm          , Mm          , Mm          , Mm          , Mm          , Hh          , Hh          , Re          , Gg^Ve       , Re          , Gg          , Gg          , Ww          , Gg          , Gg          , Gg          , Hh          , Hh          , Mm          , Mm          , Mm          
Xu          ,Xu          , Xu          , Xu          , Uh          , Mm          , Re          , Re          , Gg          , Re          , Gg          , Re          , Re          , Ww          , Gg          , Gg          , Gg          , Gg^Ve       , Hh          , Mm          , Mm          , Mm          
Xu          ,Xu          , Cud         , Cud         , Cud         , Uu          , Mm          , Gg          , Hh          , Gg          , Gs^Fp       , Gg          , Ww          , Ww^Bw\      , Re          , Gs^Fp       , Gs^Fp       , Hh          , Hh          , Mm          , Mm          , Mm          
Xu          ,Xu          , Cud         , 2 Kud       , Cud         , Uh          , Mm          , Mm          , Hh          , Gg          , Gg          , Gg          , Ww          , Gg          , Gg          , Re          , Gs^Fp       , Gg          , Hh          , Mm          , Mm          , Mm          
Xu          ,Xu          , Xu          , Cud         , Xu          , Xu          , Mm          , Mm          , Hh          , Gg^Ve       , Gg          , Gg          , Ww          , Gg          , Gg          , Re          , Gs^Fp       , Gs^Fp       , Hh          , Mm          , Mm          , Mm          
Xu          ,Xu          , Xu          , Xu          , Mm          , Mm          , Mm          , Mm          , Hh          , Hh          , Gg          , Gg          , Gg          , Ww          , Gg          , Re          , Re          , Gg          , Gg          , Hh          , Gg          , Gg          
Xu          ,Xu          , Xu          , Mm          , Mm          , Mm          , Hh          , Hh          , Gg          , Gg          , Gg          , Gs^Fp       , Gg          , Ww          , Gg^Ve       , Gg          , Ce          , Ce          , Ce          , Gg          , Gs^Fp       , Gs^Fp       
Mm          ,Mm          , Mm          , Mm          , Mm          , Hh          , Gg^Ve       , Gg          , Gg          , Gg          , Hh          , Gg          , Gg          , Ww          , Ww          , Gg          , Ce          , 1 Ke        , Ce          , Gg          , Gg          , Gg          
Mm          ,Mm          , Mm          , Mm          , Mm          , Hh          , Hh          , Hh          , Hh          , Hh          , Gs^Fp       , Gs^Fp       , Gs^Fp       , Gg          , Ww          , Gg          , Gg          , Ce          , Gg          , Re          , Re          , Re          
Mm          ,Mm          , Mm          , Mm          , Mm          , Hh          , Hh          , Hh          , Hh          , Hh          , Gs^Fp       , Gs^Fp       , Gs^Fp       , Gg          , Ww          , Gg          , Gg          , Ce          , Gg          , Re          , Re          , Re          
