
border_size=1
usage=map

Mm          ,Mm          , Mm          , Mm          , Mm          , Mm          , Hh          , Hh          , Gg          , Gg          , Gg          , Gs^Fp       , Gs^Fp       , Gs^Fp       , Gg          , Gg          , Gg          , Gg          , Gg          , Gg          , Gg          , Gg          , Gg          , Re          , Gg          , Gg          
Mm          ,Mm          , Mm          , Mm          , Mm          , Mm          , Hh          , Hh          , Gg          , Gg          , Gg          , Gs^Fp       , Gs^Fp       , Gs^Fp       , Gg          , Gg          , Gg          , Gg          , Gg          , Gg          , Gg          , Gg          , Gg          , Re          , Gg          , Gg          
Mm          ,Mm          , Mm          , Mm          , Hh          , Hh          , Gg          , Gg          , Gg          , Gg          , Gg          , Gs^Fp       , Gs^Fp       , Gs^Fp       , Gg          , Gg          , Gg          , Gg          , Gg          , Gg          , Ce          , 2 Ke        , Ce          , Re          , Gg          , Gg          
Hh          ,Hh          , Hh          , Hh          , Hh          , Hh          , Gg          , Gs^Fp       , Gg          , Gg          , Gg          , Gg          , Gg          , Gg          , Gg          , Gg          , Gg          , Gg          , Gg          , Gg          , Ce          , Ce          , Re          , Re          , Gg          , Gg          
Hh          ,Hh          , Gg^Vh       , Gg          , Gg          , Gg          , Gs^Fp       , Gs^Fp       , Gs^Fp       , Gs^Fp       , Gs^Fp       , Gs^Fp       , Gs^Fp       , Gg          , Gs^Fp       , Gg          , Gg          , Hh          , Gg          , Gg          , Re          , Re          , Gg          , Gg          , Gg          , Gg          
Mm          ,Mm          , Hh          , Gg          , Gg          , Gg          , Gs^Fp       , Gs^Fp       , Gs^Fp       , Gs^Fp       , Gs^Fp       , Gs^Fp       , Gs^Fp       , Gs^Fp       , Gg          , Gg          , Hh          , Hh          , Hh          , Re          , Gs^Fp       , Gs^Fp       , Gg          , Gs^Fp       , Gs^Fp       , Gs^Fp       
Mm          ,Mm          , Hh          , Hh          , Gg          , Gg          , Gg          , Gs^Fp       , Gs^Fp       , Gs^Fp       , Gs^Fp       , Gg          , Gg          , Gg          , Gg          , Hh          , Hh          , Hh          , Hh          , Re          , Gs^Fp       , Gs^Fp       , Gs^Fp       , Gs^Fp       , Gs^Fp       , Gs^Fp       
Mm          ,Mm          , Mm          , Hh          , Hh^Vhh      , Gg          , Gg          , Gg          , Gs^Fp       , Gg^Vh       , Gg          , Gg          , Gg          , Gg          , Gg          , Hh          , Hh          , Hh          , Hh          , Re          , Gs^Fp       , Gs^Fp       , Gs^Fp       , Gs^Fp       , Gs^Fp       , Gs^Fp       
Mm          ,Mm          , Mm          , Mm          , Hh          , Hh          , Gs          , Gg          , Gs^Fp       , Gg          , Gg          , Gg          , Gg          , Mm          , Gg          , Gg          , Hh          , Gg          , Hh          , Re          , Gg^Vh       , Gs^Fp       , Gs^Fp       , Gs^Fp       , Gs^Fp       , Gs^Fp       
Hh          ,Hh          , Mm          , Hh          , Mm          , Hh          , Hh          , Gs          , Gs          , Gg          , Hh          , Hh          , Gg          , Mm          , Gg          , Hh          , Gg          , Hh          , Gg          , Re          , Gg          , Gs^Fp       , Gs^Fp       , Gs^Fp       , Gg          , Gg          
Hh          ,Hh          , Mm          , Hh          , Hh          , Hh^Vhh      , Hh          , Hh          , Gs          , Gg^Vh       , Hh          , Hh          , Mm          , Mm          , Gg          , Gg          , Gg          , Gg          , Gg          , Re          , Gg          , Gg          , Gg          , Gg          , Gg          , Gg          
Gs          ,Gs          , Hh          , Gs          , Hh          , Hh          , Ss          , Gs          , Ss          , Hh          , Hh          , Mm          , Mm          , Mm          , Mm          , Gg          , Gg          , Gg          , Gg          , Re          , Re          , Gg          , Gg          , Gg          , Gg          , Gg          
Gs          ,Gs          , Gs          , Gs          , Ss          , Ss          , Ss          , Ss          , Gs          , Hh          , Mm          , Mm          , Mm          , Mm          , Mm          , Mm          , Gg          , Gg          , Gg          , Gg          , Re          , Gg          , Gg          , Gg          , Gg          , Gg          
Gs          ,Gs          , Gs          , Ss          , Ss          , Ww          , Ss          , Gs          , Hh          , Mm          , Mm          , Mm          , Hh          , Hh          , Mm          , Mm          , Mm          , Gg          , Gg          , Gg          , Re          , Gg^Vh       , Gg          , Gg          , Gg          , Gg          
Gs          ,Gs          , Hh          , Gs          , Ss          , Ss          , Hh          , Hh          , Hh          , Mm          , Mm          , Hh          , Hh          , Hh          , Hh          , Mm          , Mm          , Gg          , Gg          , Gg          , Gg          , Re          , Gg          , Gg          , Gg          , Gg          
Gs          ,Gs          , Hh          , Hh          , Hh          , Hh          , Mm          , Hh          , Mm          , Mm          , Hh          , Hh          , Hh          , Mm          , Hh          , Hh          , Mm          , Mm          , Hh          , Gg          , Gg          , Re          , Gg          , Gg          , Gg^Vh       , Gg       
Gg          ,Gg          , Gg          , Hh          , Hh          , Mm          , Mm          , Mm          , Mm          , Mm          , Hh          , Hh          , Mm          , 3 Mm        , Mm          , Hh          , Hh          , Hh          , Mm          , Gg          , Ss          , Gg          , Re          , Gg          , Gg          , Gg          
Gg          ,Gg          , Gg          , Gg          , Hh          , Hh^Vhh      , Mm          , Mm          , Mm          , Mm          , Hh          , Ww          , Mm          , Mm          , Mm          , Hh          , Mm          , Mm          , Mm          , Hh          , Ss          , Ss          , Re          , Gg          , Ss          , Ss          
Gg          ,Gg          , Gg          , Gg          , Gg          , Gg          , Gg          , Mm          , Mm          , Mm          , Hh          , Hh          , Mm          , Hh          , Hh          , Mm          , Mm          , Hh          , Mm          , Mm          , Hh          , Hh          , Gs          , Re          , Ss          , Ss          
Gg          ,Gg          , Gg          , Gg          , Gg          , Gg          , Gg          , Gg          , Hh          , Mm          , Mm          , Hh          , Hh          , Hh          , Hh          , Mm          , Mm          , Hh          , Mm          , Mm          , Mm          , Mm          , Hh          , Gs          , Ss          , Ss          
Gs^Fp       ,Gs^Fp       , Gg          , Gg          , Gg          , Gg          , Gg          , Gg          , Hh          , Mm          , Mm          , Mm          , Hh          , Hh          , Hh          , Mm          , Gg          , Hh^Vhh      , Hh          , Mm          , Hh          , Hh          , Mm          , Re          , Hh          , Hh          
Gs^Fp       ,Gs^Fp       , Gs^Fp       , Gs^Fp       , Hh          , Hh          , Hh          , Gg          , Gg          , Hh          , Mm          , Mm          , Hh          , Hh          , Mm          , Mm          , Gs          , Gg          , Hh          , Hh          , Hh          , Hh          , Hh          , Hh          , Mm          , Mm          
Gs^Fp       ,Gs^Fp       , Gs^Fp       , Gs^Fp       , Hh          , Hh          , Hh          , Gg          , Gg          , Gg          , Mm          , Mm          , Mm          , Mm          , Mm          , Mm          , Gs          , Gs          , Gs          , Hh          , Gs          , Ss          , Gs          , Re          , Hh          , Hh          
Gs^Fp       ,Gs^Fp       , Gg^Vh       , Gs^Fp       , Gs^Fp       , Hh          , Gg          , Gg          , Gg          , Gs^Fp       , Gs^Fp       , Mm          , Mm          , Mm          , Mm          , Hh          , Gs^Fp       , Gs^Fp       , Ss          , Ss          , Gs          , Hh          , Re          , Gs          , Gs          , Gs          
Gs^Fp       ,Gs^Fp       , Gs^Fp       , Gs^Fp       , Gs^Fp       , Gs^Fp       , Gg          , Gg^Vh       , Gs^Fp       , Gs^Fp       , Hh          , Gs^Fp       , Mm          , Mm          , Hh          , Hh          , Gs^Fp       , Gs^Fp       , Gs^Fp       , Ss          , Gs          , Re          , Gs          , Ss          , Ss          , Ss          
Gs^Fp       ,Gs^Fp       , Gs^Fp       , Gs^Fp       , Gs^Fp       , Gs^Fp       , Gg          , Gs^Fp       , Gs^Fp       , Hh          , Hh          , Gs^Fp       , Gs^Fp       , Mm          , Hh^Vhh      , Gg          , Gs^Fp       , Gs^Fp       , Hh          , Re          , Gs          , Gs          , Hh          , Ss          , Ss          , Ss          
Gs^Fp       ,Gs^Fp       , Gs^Fp       , Gs^Fp       , Gs^Fp       , Gs^Fp       , Gg          , Gs^Fp       , Gs^Fp       , Hh          , Gs^Fp       , Gs^Fp       , Gs^Fp       , Hh          , Gg          , Gg          , Hh          , Hh          , Hh          , Re          , Gs          , Hh          , Hh          , Mm          , Mm          , Mm          
Gs^Fp       ,Gs^Fp       , Gs^Fp       , Gs^Fp       , Gs^Fp       , Gg          , Gg          , Gg          , Gs^Fp       , Gs^Fp       , Gg          , Gs^Fp       , Gs^Fp       , Gg          , Gs          , Gs          , Re          , Hh          , Re          , Gs          , Gs          , Hh          , Hh          , Mm          , Mm          , Mm          
Gs^Fp       ,Gs^Fp       , Gs^Fp       , Gs^Fp       , Gg          , Gg          , Gg          , Gg          , Gg          , Gg          , Gs^Fp       , Gs^Fp       , Gs^Fp       , Hh          , Hh          , Re          , Gs          , Re          , Gs          , Hh          , Gs          , Gs          , Hh          , Mm          , Mm          , Mm          
Gs^Fp       ,Gs^Fp       , Gg^Vh       , Gg          , Gg          , Gg          , Gg          , Gg^Vh       , Gg          , Gg          , Re          , Re          , Re          , Hh          , Re          , Re          , Gs          , Gs          , Hh          , Mm          , Mm          , Gs          , Gs          , Hh          , Mm          , Mm          
Gg          ,Gg          , Gg          , Gg          , Gg          , Gg          , Gg          , Gg          , Gg          , Gg          , Re          , Gs^Fp       , Gs^Fp       , Re          , Gg          , Gg          , Gg          , Hh          , Hh          , Mm          , Mm          , Mm          , Gs          , Gs          , Gg          , Gg          
Gg          ,Gg          , Gg          , Gg          , Gg          , Gg^Vh       , Gg          , Gg          , Gg          , Gg          , Re          , Gs^Fp       , Gs^Fp       , Gs^Fp       , Gg          , Gs          , Hh          , Hh          , Hh^Vhh      , Mm          , Mm          , Mm          , Gs          , Gg          , Gg^Vh       , Gg       
Gg          ,Gg          , Gg          , Gg          , Gg          , Gg          , Gg          , Gg          , Re          , Re          , Gg          , Gs^Fp       , Gg          , Gg          , Gg          , Gg          , Hh          , Hh          , Gg          , Hh          , Mm          , Mm          , Hh          , Gg          , Gg          , Gg          
Gg          ,Gg          , Gg          , Gg          , Gs^Fp       , Gs^Fp       , Gs^Fp       , Re          , Gg          , Re          , Re          , Gg          , Gg          , Gg          , Gg          , Gg          , Gg          , Gg          , Gg          , Gg          , Gg          , Gs          , Hh          , Gg          , Gg          , Gg          
Gg          ,Gg          , Gg          , Gg          , Gg          , Gs^Fp       , Gs^Fp       , Re          , Gg          , Gg          , Gg          , Re          , Re          , Gg          , Gg          , Gg          , Hh          , Hh          , Hh          , Gg          , Gg          , Gg          , Hh          , Hh          , Gg          , Gg          
Gg          ,Gg          , Gg          , Ce          , Gg          , Gg          , Re          , Re          , Gg          , Gg          , Gg          , Gg          , Gg          , Re          , Hh          , Hh          , Hh^Vhh      , Hh          , Gg          , Gg          , Gg          , Gg          , Gg          , Hh          , Hh          , Hh          
Gg          ,Gg          , Gg          , 1 Ke        , Ce          , Re          , Gg          , Gg          , Gg          , Gg          , Gg          , Gg          , Gg          , Re          , Re          , Re          , Gg          , Gg          , Gs^Fp       , Gg          , Gs^Fp       , Gg          , Hh          , Hh          , Hh          , Hh          
Gg          ,Gg          , Gg          , Ce          , Ce          , Re          , Gg          , Gg          , Gg^Vh       , Gg          , Gg          , Gg          , Gg          , Gg          , Gg          , Gs^Fp       , Gs^Fp       , Gs^Fp       , Gs^Fp       , Gs^Fp       , Gs^Fp       , Hh          , Mm          , Mm          , Mm          , Mm          
Gg          ,Gg          , Gg          , Gg          , Re          , Re          , Gg          , Gg          , Gg          , Gg          , Gg          , Gg          , Gg          , Gg          , Gg          , Gs^Fp       , Gs^Fp       , Gs^Fp       , Gs^Fp       , Gs^Fp       , Mm          , Mm          , Mm          , Gg^Vh       , Mm          , Mm          
Gg          ,Gg          , Gg          , Gg          , Re          , Gg          , Gg          , Gg          , Gg          , Gg          , Gg          , Gg^Vh       , Gg          , Gg          , Gg          , Gg          , Gg          , Gg          , Gg          , Gg          , Mm          , Mm          , Mm          , Mm          , Mm          , Mm          
Gg          ,Gg          , Gg          , Gg          , Re          , Gg          , Gg          , Gg          , Gg          , Gg          , Gg          , Gg       , Gg          , Gg          , Gg          , Gg          , Gg          , Gg          , Gg          , Gg          , Mm          , Mm          , Mm          , Mm          , Mm          , Mm          
