WWWWWWWWWWWWWWWWWWWWW
WWWWWWWWWmmmWWWWWWWWW
WWWWWWWrhC1ChwWWWWWWW
WWWWWrrcrRCRRgggWWWWW
WWWrrccRRgEgRRggwhWWW
WddrYwcRtgEggtRRRCmmW
WdEuWwcRggEEggRwRC4mW
WrEWWmRRgvggEgRfRgChW
WrDmRRRCggfmEgRfEEgEW
WrhgRfRgfhhfhvRhEgtEW
WEggRhRvgfihggRfRggrW
WEtEEfRghmhgfCRRRmhrW
WhggEfRgEgfvgRRmRWDrW
WmCCRwRgEEgggRRwWuEdW
Wm3CRRRtggEggRcwWrEdW
WWmhRgRRggEgtRccYrdWW
WWWWwgggRRERRccrrWWWW
WWWWWWgEgCCCrrrWWWWWW
WWWWWWWWhm2mhWWWWWWWW
WWWWWWWWWWmWWWWWWWWWW
WWWWWWWWWWWWWWWWWWWWW
