Gg          , Gg          , Gll^Fp      , Gll         , Gll         , Gg          , Gs          , Gs          , Hh^Fp       , Gg          , Mm          , Ms          , Ms^Xm       , Wo          , Wo          , Ms          , Ms          , Ms          , Mm          , Mm          , Mm          , Mm          , Mm          , Mm          , Mm          , Hh          , Hh          , Hh          , Hh          , Gs          , Gs          , Gs          , Gd          , Gs          , Gd          , Hhd         , Hhd         , Hhd         , Rd          , Rd          , Hhd         , Hhd         , Rd          , Rd          , Hd          , Hhd         , Rd          , Dd          , Hd          , Dd          , Dd          , Hhd         , Dd^Edp      , Dd          , Hd          , Dd          , Hd          , Dd          , Dd          
Gg          , Gll^Fp      , Gs          , Gll^Fp      , Gs          , Gs^Fms      , Gll         , Gg          , Gll^Fp      , Hh^Fp       , Hh          , Mm          , Ms          , Ha          , Wo          , Ms          , Ha          , Ms          , Ms          , Mm          , Mm          , Mm          , Mm          , Hh          , Gg          , Hh          , Gs          , Hh          , Gs          , Gs          , Gs          , Gs          , Gs          , Rd          , Gd          , Rd          , Gd          , Rd          , Hhd         , Hhd         , Hhd         , Hhd         , Rd          , Rd          , Rd^Esd      , Hhd         , Dd^Edpp     , Rd          , Hd          , Rd          , Dd^Vdt      , Rd^Dr       , Dd          , Dd          , Hd          , Hd          , Dd          , Hd          , Hd          
Gg          , Gll         , Gll^Fp      , Gll         , Gs^Fms      , Gs          , Gs          , Gll         , Gs          , Gs          , Gg          , Mm          , Mm          , Ms          , Ms          , Ha          , Ha          , Ha          , Ms          , Mm          , Mm          , Mm          , Mm          , Gg          , Mm          , Gs          , Hh          , Hh          , Hh          , Gs^Es       , Gs          , Gs          , Gs          , Gd          , Hhd         , Hhd         , Hhd^Vhhr    , Gd          , Gd          , Rd          , Gd          , Hhd         , Dd          , Rd^Dr       , Rd          , Dd          , Dd          , Rd          , Rd          , Dd          , Rd          , Hd          , Hd          , Dd          , Hd          , Dd          , Dd          , Dd          , Dd^Dc       
Gg          , Gll^Fp      , Gll^Fp      , Gll^Fp      , Gs          , Gll^Fp      , Gs          , Gs^Fms      , Gs          , Hh^Fp       , Gg          , Hh          , Hh^Fp       , Mm          , Ha          , Ms          , Ms          , Ms          , Ms          , Mm          , Mm          , Hh          , Gg^Efm      , Mm          , Mm          , Mm          , Hh          , Hh          , Gg          , Gg          , Gs          , Gs          , Gd          , Rd          , Hhd         , Hhd         , Gd          , Rd          , Hhd         , Rd          , Rd          , Rd          , Rd          , Dd          , Hd          , Hhd         , Rd          , Dd          , Dd          , Dd          , Rd^Esd      , Hd          , Rd          , Hd          , Dd          , Hd          , Dd          , Dd          , Hd          
Gg          , Gll^Fp      , Gll^Fp      , Gs^Fms      , Gll         , Gs          , Gll^Fp      , Gg          , Gs          , Gs          , Gg          , Gll^Fp      , Gs^Fms      , Hh          , Hh          , Hh          , Hh          , Ms          , Ms          , Mm          , Mm          , Mm          , Mm          , Mm          , Hh          , Hh          , Hh          , Hh          , Gs          , Gs          , Gs          , Gs          , Gs          , Gd          , Gd          , Hhd         , Hhd         , Rd          , Gd          , Gd          , Hhd         , Hhd         , Rd          , Hhd         , Hhd         , Rd          , Hd          , Dd          , Rd          , Rd          , Dd          , Hd          , Dd^Edpp     , Dd          , Rd          , Dd          , Rd          , Dd^Edp      , Hhd         
Gs          , Gs^Fms      , Gs          , Gg          , Gg          , Gs^Vl       , Gll^Fp      , Gs          , Gs^Fms      , Gg          , Gg          , Gll^Fp      , Gg          , Hh^Fp       , Gg          , Hh          , Hh          , Mm          , Mm          , Ms          , Mm          , Hh          , Mm          , Hh          , Mm          , Hh          , Gg          , Gg          , Gg          , Gs          , Gg          , Gs          , Gs          , Gd          , Gs          , Rd          , Hhd         , Gd          , Hhd         , Hhd         , Gd          , Gd          , Hhd         , Gd          , Rd          , Rd          , Dd          , Rd          , Hhd         , Hhd         , Hd          , Rd          , Hhd         , Rd          , Hd          , Hd          , Dd          , Hd          , Hd          
Gll^Fp      , Gs          , Gs          , Gs^Fms      , Gll^Fp      , Gll         , Gs^Fms      , Gg          , Gs          , Gll^Fp      , Gs^Fms      , Gg          , Hh^Fp       , Gs          , Gg          , Hh^Fp       , Gg^Efm      , Hh^Fp       , Hh          , Mm          , Mm          , Mm          , Mm          , Mm          , Mm          , Gg          , Hh          , Hh          , Hh          , Gs          , Gs          , Gs          , Gs          , Gs          , Gd          , Gd          , Hhd         , Hhd         , Hhd         , Gd          , Rd          , Gd          , Rd          , Rd          , Dd          , Rd          , Hhd         , Rd          , Rd          , Rd^Esd      , Dd          , Hhd         , Rd          , Dd          , Rd^Esd      , Hd          , Hhd         , Hhd         , Hhd         
Gg          , Gs          , Gg          , Gll^Fp      , Gs          , Gs          , Gs          , Gs          , Gs          , Gs^Fms      , Gg          , Gs          , Gg          , Gg          , Gs^Fms      , Gg          , Gg          , Hh^Fp       , Hh^Fds      , Hh          , Hh          , Mm          , Mm          , Mm          , Hh          , Hh          , Gg          , Hh          , Hh          , Gs          , Gs          , Gs          , Gs          , Gd          , Gd          , Gd          , Gd          , Gd          , Rd          , Rd          , Rd          , Rd          , Hhd         , Gd          , Gd          , Rd          , Dd          , Rd          , Rd^Esd      , Dd          , Rd          , Rd          , Dd          , Rd^Esd      , Rd          , Hhd         , Dd          , Rd          , Hhd         
Gg          , Gs          , Gs          , Gs^Fms      , Gll^Fp      , Gg          , Gs^Fms      , Gs          , Gs          , Gs^Fds      , Gs          , Gs          , Gs          , Gg          , Gs          , Gg          , Gs          , Hh^Fp       , Gg          , Gg          , Hh          , Mm          , Mm          , Mm          , Mm          , Hh          , Hh          , Gg          , Gs          , Gg          , Gs          , Gs          , Gg          , Gs          , Gd          , Hhd         , Hhd         , Hhd         , Hhd         , Rd          , Gd          , Rd          , Gd          , Hhd         , Gd          , Rd          , Rd          , Hd          , Rd          , Rd          , Dd          , Rd          , Hhd         , Hhd         , Hhd         , Dd          , Dd          , Rd          , Hhd         
Gg          , Gll^Fp      , Gll         , Gg          , Gll^Fp      , Gs          , Gg          , Gll^Fp      , Gs^Fms      , Gg          , Gll^Fp      , Gg          , Gs^Fms      , Gs^Fms      , Gs          , Gs          , Gs^Fms      , Gg          , Gg          , Gg          , Hh^Fp       , Hh          , Hh^Vhh      , Mm          , Hh          , Hh          , Hh          , Gs          , Gg          , Gg          , Hh          , Gg          , Hh          , Hh          , Hh          , Gd          , Gd          , Gd          , Gd          , Hhd         , Hhd         , Gd          , Rd          , Hhd         , Rd          , Rd          , Dd          , Rd          , Rd          , Hhd         , Rd          , Rd          , Md          , Md          , Hhd         , Hhd         , Hhd         , Hhd         , Hh          
Gs^Fms      , Gll         , Gs          , Gs          , Gll^Fp      , Gll         , Gs          , Gs          , Gs          , Gll^Fp      , Gg          , Gs^Fms      , Gg          , Gs^Fms      , Gg          , Gs          , Gs^Fms      , Gg          , Gg          , Gll^Fp      , Gg^Efm      , Hh          , Hh          , Mm          , Mm          , Hh          , Hh          , Hh          , Hh          , Hh          , Hh          , Hh          , Hh          , Hh          , Hh          , Hh          , Gd          , Hh          , Gd          , Gd          , Hhd         , Gd          , Hhd         , Gd          , Gd          , Rd          , Rd          , Rd          , Rd^Dr       , Gd          , Hhd         , Hhd         , Md          , Md          , Hhd         , Hh          , Md          , Md          , Md          
Gll^Fp      , Gg          , Gs^Fms      , Gs          , Gs          , Gs^Fms      , Gll^Fp      , Gs^Fms      , Gs^Fms      , Gs          , Gs          , Gs^Fms      , Gg          , Gs^Fms      , Gll^Fp      , Gg          , Gll^Fp      , Gs^Fms      , Gg          , Gg          , Gs          , Hh^Fds      , Gs          , Hh          , Mm          , Mm          , Mm          , Hh          , Mm          , Mm          , Mm          , Mm          , Mm          , Hh          , Hh          , Gs          , Gs          , Hh          , Hhd         , Gd          , Hhd         , Gd          , Gd          , Rd          , Hhd         , Rd          , Rd          , Gd          , Rd          , Rd          , Hhd         , Md          , Md          , Md          , Md          , Md          , Mm          , Md          , Mm          
Gg          , Gs^Fms      , Gll^Fp      , Gs          , Gs          , Gg          , Gg          , Gs^Fds      , Gs          , Gs          , Gg          , Gs          , Gs          , Gs^Fds      , Gs          , Gs          , Gg          , Gs^Fds      , Gs^Fms      , Gg          , Gll^Fp      , Gg          , Hh          , Hh          , Hh          , Mm          , Mm          , Mm          , Mm          , Mm          , Hh          , Mm          , Hh          , Mm          , Gs          , Gs          , Gs          , Hh          , Hh          , Hh          , Hhd         , Hhd         , Hhd         , Rd          , Hhd         , Gd          , Gd          , Hhd         , Gd^Es       , Gd          , Gd          , Hhd^Vhhr    , Md          , Md          , Md          , Mm          , Mm          , Mm          , Hh          
Gg          , Gll         , Gg          , Gg          , Gg          , Gs          , Gs          , Gs^Fms      , Gs^Fms      , Gs^Fms      , Gll^Fp      , Gg          , Gg          , Gs          , Gs^Fms      , Gg          , Gs          , Gg          , Gg          , Gg          , Gg          , Gs^Fms      , Gg          , Gg          , Hh          , Hh^Fp       , Hh          , Mm          , Hh          , Gg          , Mm          , Hh          , Hh          , Hh          , Gg          , Hh          , Gs          , Hh          , Gs          , Gd          , Hh          , Hhd         , Hhd         , Gd          , Gd          , Rd          , Gd          , Hhd         , Hh          , Hhd         , Hh          , Hhd         , Md          , Md          , Md          , Mm          , Hh          , Hh          , Gg          
Gs^Fms      , Gs^Fms      , Gg          , Gs^Fms      , Gs^Fms      , Gs^Fms      , Gg          , Gll^Fp      , Gs^Fms      , Gg^Efm      , Gs^Fms      , Gs^Fms      , Gs^Fms      , Gs          , Gs          , Gg          , Gll^Fp      , Gs          , Gg          , Gs^Fms      , Gs^Fms      , Gs^Fms      , Gg          , Gg          , Gg          , Gg          , Gg          , Hh          , Gg          , Hh          , Gs          , Gs          , Gs          , Gs          , Gs          , Hh          , Hh          , Hh          , Gs          , Hh          , Gs          , Gd          , Hhd         , Hhd         , Hh          , Gd          , Hh          , Hhd         , Md          , Md          , Md          , Md          , Md          , Md          , Md          , Mm          , Hh          , Hh          , Gg          
Gg          , Gg          , Gs          , Gs^Fms      , Gs          , Gs          , Gs          , Gs          , Gs^Fms      , Gll^Fp      , Gg          , Gg          , Gs          , Gs          , Gll^Fp      , Gg          , Gs^Fms      , Gs^Fms      , Gs^Fms      , Gs          , Gs          , Gs^Fms      , Gg          , Gs^Fms      , Gg          , Gs^Fms      , Gg          , Gg          , Gs          , Gs          , Gg          , Hh          , Md          , Hh^Vhh      , Mm          , Mm          , Mm          , Hh          , Hh          , Hh          , Md          , Hh          , Hh          , Hhd         , Hh          , Md          , Md          , Md          , Md          , Md          , Md          , Md          , Md          , Md          , Mm          , Hh          , Hh          , Hh          , Gg          
Gll         , Gs          , Gs          , Gg          , Gs^Fms      , Gs          , Gs          , Gs^Fms      , Gg          , Gs^Fms      , Gs^Fms      , Gs^Fms      , Gs^Fms      , Gs^Fms      , Gg          , Gs^Fms      , Gg          , Gll^Fp      , Gs^Fms      , Gg          , Gg          , Gs          , Gs          , Gg          , Gs^Fms      , Gs          , Gs          , Gs          , Gg          , Gg          , Hh          , Hh          , Hh          , Md          , Md          , Mm          , Md          , Hh          , Hh          , Gg          , Md          , Hh          , Md          , Hh          , Md          , Md          , Ms          , Md          , Md          , Md          , Hh          , Md          , Hh          , Mm          , Hh          , Mm          , Hh          , Hh          , Gg          
Gll^Fp      , Gs          , Gs          , Gs          , Gg          , Gg          , Gs          , Gg          , Gs^Fms      , Gs          , Gs          , Gg          , Gll^Fp      , Gll         , Gs          , Gs^Fms      , Gs^Fms      , Gs^Fms      , Gs^Fds      , Gs^Fms      , Gg          , Gg          , Gg          , Gs^Fms      , Gs^Fms      , Gs^Fms      , Gg          , Gs          , Gg          , Gs^Fms      , Gg          , Hh          , Hh          , Hh          , Hh          , Md          , Md          , Hh          , Md          , Md          , Md          , Md          , Md          , Md          , Md          , Ms          , Ha          , Ms          , Mm          , Md          , Hh          , Mm          , Hh          , Mm          , Mm          , Mm          , Mm          , Gs          , Gg          
Gll         , Gll         , Gg          , Gs          , Gs^Fms      , Gs^Fms      , Gs^Fms      , Gs          , Gg          , Gg          , Gs^Fms      , Gs          , Gs          , Gs          , Gg          , Gg          , Gs          , Gll^Fp      , Gs^Fms      , Gs^Fms      , Gs^Fms      , Gs          , Gs          , Gs^Fms      , Gs          , Gg          , Gs^Fms      , Gg          , Gs^Fms      , Gg          , Gs^Fms      , Gg          , Gs          , Gs          , Gg          , Hh          , Hh          , Md          , Mm          , Mm          , Mm          , Mm          , Mm          , Md          , Mm          , Mm          , Wo          , Ms          , Mm          , Mm          , Hh^Vhh      , Hh          , Hh          , Gg          , Hh          , Mm          , Hh          , Hh          , Gs          
Gll^Fp      , Gs          , Gs^Fms      , Gs^Fms      , Gs^Vh       , Gs^Fms      , Gg          , Gs          , Gll^Fp      , Gs^Fds      , Gs^Fds      , Gg          , Gs^Fms      , Gs^Fms      , Gg          , Gs^Fms      , Gll^Fp      , Gs^Fms      , Gs          , Gs^Vc       , Gs^Fms      , Gg          , Gs^Fds      , Gg          , Gg          , Gg          , Gg          , Gs^Fms      , Gs^Fms      , Gs^Fms      , Gg          , Gg          , Gs^Fds      , Gll^Fp      , Gg          , Hh          , Gg          , Gg          , Hh          , Hh          , Hh          , Mm          , Hh          , Mm          , Hh          , Hh          , Ww          , Hh          , Hh          , Hh          , Gg          , Hh          , Gs          , Gg          , Hh          , Mm          , Mm          , Gs          , Hh          
Gll^Fp      , Gg          , Gs          , Gs^Fms      , Gs          , Gs^Fms      , Gs          , Gs^Fms      , Gg          , Gg^Efm      , Gg          , Gg          , Gs^Fms      , Gg          , Gg          , Gll^Fp      , Gs^Fms      , Gg^Efm      , Gll^Fp      , Gs^Fds      , Gs^Fms      , Gs^Fms      , Gg          , Gs^Fms      , Gs^Fds      , Gg          , Gs^Fds      , Gg          , Gg          , Gg          , Gg          , Gg          , Gg          , Gg          , Gg          , Gg          , Gg          , Gg          , Gg          , Gg^Efm      , Hh          , Hh          , Hh          , Hh          , Wo          , Ww          , Gg^Efm      , Hh          , Gg          , Gs          , Gg          , Hh          , Hh          , Gs          , Gs          , Hh          , Hh          , Chr         , Rp          
Gs^Fms      , Gg          , Gs          , Gs          , Gg          , Gs          , Gs          , Gs^Fms      , Gs^Fms      , Gs^Fds      , Gs          , Gs          , Gg          , Gs^Fms      , Gs^Fms      , Gs^Fds      , Gs^Fms      , Gs^Fms      , Gg          , Gs          , Gg          , Gg          , Gg          , Gg          , Gs^Fds      , Gg          , Gg          , Gg          , Gs^Fds      , Gs^Fms      , Gg          , Gg          , Gs^Fds      , Gg          , Gg          , Gg          , Ww          , Gg          , Wwf         , Ww          , Ww          , Ww          , Wo          , Ww          , Gg          , Hh          , Gg          , Hh          , Gg          , Gs          , Gg          , Gg          , Gs          , Hh          , Gs          , Gs          , Re          , Rp          , Chr         
Gll^Fp      , Gll         , Gs          , Gs^Fms      , Gll^Fp      , Gs          , Gs          , Gg          , Gs          , Gg          , Gs          , Gg          , Gs^Fms      , Gg          , Gs^Fds      , Gs          , Gs          , Gg          , Gs^Fms      , Gs^Fms      , Gs^Fds      , Gg          , Gs^Fds      , Gs^Fds      , Gg          , Gg          , Gg          , Gg          , Gg          , Gs^Fds      , Gg          , Gg          , Ww          , Gg          , Ww          , Ww          , Gg          , Ww          , Gg          , Gg          , Gg          , Hh          , Hh          , Gg          , Gg          , Gg          , Gg          , Gg          , Gg          , Gg          , Gs          , Gs          , Gg          , Gg          , Rp          , Rp          , Hh          , Hh          , Hh          
Gs^Fms      , Gll^Fp      , Gs^Fms      , Gs^Fms      , Gll         , Gg          , Gg          , Gg          , Gg          , Gs^Fms      , Gg          , Gg          , Gs^Fds      , Gg          , Gg          , Gg          , Gs^Fms      , Gg          , Gg          , Gs^Fms      , Gg          , Gs^Fds      , Wo          , Wo          , Ww          , Gs^Fms      , Ww          , Ww          , Ww          , Gg          , Ww          , Ww          , Gs^Fds      , Ww          , Gg          , Gg          , Gg          , Gg          , Gg          , Gg          , Gg          , Gg          , Gg          , Gg          , Gg          , Gg          , Gg          , Gg          , Gg          , Gs          , Gs          , Gs          , Gg          , Rr          , Gs          , Hh          , Hh          , Hh          , Hh          
Gg          , Gg          , Gs          , Gs          , Gs^Fms      , Gs^Fms      , Gll^Fp      , Gs^Fms      , Gg          , Gs^Fds      , Gg          , Gs^Fds      , Gg          , Gg          , Gs^Fds      , Gg          , Gs^Fms      , Gg          , Gs^Fms      , Gg          , Wo          , Wo          , Gg          , Gg          , Gg          , Ww          , Gs^Fds      , Gg          , Gg          , Ww          , Gg          , Gg          , Rb          , Gg          , Rb          , Gg          , Gg          , Gg          , Gs          , Gg          , Gg          , Gg          , Gg          , Gg          , Gg          , Gs          , Gg          , Gg          , Gs          , Gg          , Gs          , Gg          , Re          , Rp          , Gg          , Hh          , Hh          , Hh          , Gg          
Gg          , Gs^Fds      , Gll^Fp      , Gs          , Gs^Fms      , Gg          , Gs^Fms      , Gll^Fp      , Gs^Fms      , Gs          , Gs^Fms      , Gs^Fms      , Gg          , Gs^Fms      , Gs^Fms      , Gs^Fds      , Gg          , Gs^Fms      , Gs^Fms      , Gg          , Wo          , Gg^Efm      , Gg          , Gs^Fms      , Gg          , Gg          , Gg          , Gg          , Gg          , Gg          , Rb          , Rb          , Gg          , Rb          , Gg          , Rb          , Rb          , Gg          , Gg          , Gg          , Gg          , Gs          , Gg          , Gg          , Gg          , Gs          , Gs          , Gs          , Gg          , Gg          , Gg          , Gg          , Rp          , Gs          , Hh          , Gg          , Gg          , Hh          , Hh          
Gg          , Gs          , Gs          , Gg          , Gg          , Gs          , Gs^Fms      , Gll^Fp      , Gg          , Gs          , Gs          , Gs^Fms      , Gs^Fds      , Gs^Fms      , Gs          , Gg          , Gg          , Gs^Fms      , Gg          , Gg          , Wo          , Gs^Fms      , Gg          , Gg          , Gg          , Gs^Fds      , Gs^Fds      , Gg          , Rb          , Rb          , Gs          , Gg          , Gg          , Gg          , Gg          , Gg          , Gg          , Rb          , Rb          , Gs          , Gg          , Gg          , Gs          , Gg          , Gg          , Gs          , Gs          , Gs          , Gs          , Gs          , Gs          , Gg          , Rp          , Hh          , Hh          , Gs          , Hh          , Hh          , Gg          
Gs^Fms      , Gs          , Gs          , Gs^Fms      , Gs          , Gs          , Gs^Fms      , Gs^Fms      , Gg          , Gs^Fms      , Gg          , Gs^Fms      , Gs          , Gs^Fms      , Gs          , Gg          , Gs^Fms      , Gs^Fms      , Gg          , Gs^Fds      , Ss          , Wo          , Wo          , Gg          , Gg          , Gg          , Rb          , Rb          , Gg          , Gg          , Gg          , Gg          , Gg          , Gg          , Gg          , Gg          , Gg          , Gg          , Gg          , Rb          , Gg          , Gg          , Gs          , Gg          , Gs          , Gg          , Gg          , Gs          , Gs          , Gg          , Gs          , Gs          , Rp          , Gg          , Gs          , Hh          , Gg          , Gs          , Gg          
Gg          , Gs          , Gs^Fds      , Gs^Fds      , Gs          , Gs^Fms      , Gg          , Gs          , Gs^Fds      , Gs^Fms      , Gg          , Gs^Fds      , Gs^Fds      , Gg          , Gg          , Gg          , Gg          , Gg          , Gs^Fms      , Gs^Fds      , Gg          , Gg          , Gs^Fms      , Ww          , Gs^Fds      , Rb          , Gg          , Gg          , Gg          , Gg          , Gg          , Gg          , Gg          , Gg          , Gg          , Gg          , Gs          , Gs          , Gg          , Rb          , Gg          , Gg          , Gg          , Gs          , Gg          , Gs          , Gs          , Gs          , Gs          , Gg          , Gs          , Rp          , Gs          , Gs          , Gg          , Gs          , Gs          , Hh          , Gs          
Gs          , Gs^Fds      , Gs^Fms      , Gg          , Gs          , Gs          , Gs^Fms      , Gs          , Gg          , Gs          , Gs          , Gs^Fms      , Gg          , Gs^Fms      , Gg          , Gs^Fms      , Gs          , Gg          , Gs^Fds      , Gs^Fms      , Gg          , Gg          , Gs^Fds      , Wo          , Gg          , Rb          , Gg          , Gg          , Gg          , Gg          , Gg          , Gg          , Gg          , Gg          , Gg          , Gg          , Gg          , Gs          , Gg          , Rb          , Gg          , Gs          , Gs          , Gs          , Gs          , Gs          , Gs          , Gs          , Gs          , Gs          , Gg          , Rp          , Gg          , Gg          , 1 Gs        , Gs          , Gg          , Gg          , Gg          
Gs          , Gs          , Gs          , Gg          , Gs^Fms      , Gg          , Gs^Fms      , Gll^Fp      , Gs^Fms      , Gs^Vl       , Gs^Fms      , Gs^Fms      , Gs^Fms      , Gg          , Gg          , Gs^Fms      , Gs^Fds      , Gg          , Gg          , Gg          , Gg          , Gg          , Wo          , Ww          , Gg          , Rb          , Gg          , Gg          , Gg          , Gg          , Gs          , Gg          , Gs          , Gg          , Gg          , Gs          , Gg          , Gs          , Gg          , Rb          , Gg          , Gg          , Gs          , Gs          , Gg          , Gs          , Gg          , Gs          , Gs          , Gg          , Gg          , Re          , Gg          , Gs          , Gs          , Gs          , Gs          , Gs          , Gg          
Gs          , Gs^Fms      , Gs^Fds      , Gg          , Gs          , Gg          , Gs^Fms      , Gs^Fms      , Gs          , Gs^Fms      , Gg          , Gs          , Gs          , Gs          , Gg          , Gs^Fds      , Gg          , Gg          , Gg          , Gs^Fds      , Gg          , Gg          , Wo          , Gg          , Gg          , Rb          , Gg          , Gg          , Gg          , Gg          , Gg          , Gs          , Gg          , Gg          , Rb          , Gg          , Rb          , Gg          , Rb          , Rb          , Gg          , Gg          , Gs          , Gg          , Gg          , Gs          , Gs          , Gs          , Gs          , Gs          , Rp          , Rp          , Gg          , Gg          , Gg          , Gg          , Gg          , Gs          , Rb^Eff      
Gg          , Gs^Fds      , Gs^Fds      , Gs          , Gg          , Gg          , Gg          , Gs          , Gs          , Gs^Fms      , Gg          , Gs^Fms      , Gg          , Gg          , Gg          , Gs^Fms      , Gg          , Gg          , Gg          , Gs^Fms      , Wo          , Wo          , Gg^Efm      , Gg          , Gg          , Rb          , Rb          , Gg          , Rb          , Gg          , Rb          , Gg          , Rb          , Rb          , Gg          , Rb          , Gg          , Rb          , Gg          , Gg          , Gg          , Gs          , Gg          , Gs          , Gs          , Gs          , Gs          , Gs          , Gg          , Gs          , Re          , Gs          , Gg          , Gg          , Ww          , Gg          , Rb^Eff      , Rb^Eff      , Rb^Gvs      
Gll         , Gs^Fms      , Gs          , Gs          , Gll^Fp      , Gg          , Gs^Fds      , Gs^Fms      , Gg          , Gs          , Gs^Fds      , Gg          , Gg          , Gs^Fms      , Gs^Fms      , Gs^Fds      , Gs^Fds      , Gg          , Gs^Fds      , Gs^Fds      , Wo          , Gs^Fds      , Gs^Fms      , Gs^Fds      , Gg          , Gg          , Gs^Fds      , Rb          , Gg          , Rb          , Gs          , Rb          , Gs          , Gs          , Gg          , Gs          , Gs          , Gs          , Gs          , Gg          , Gs          , Gs^Vh       , Re          , Gs          , Gg          , Gg          , Gs          , Gg          , Re          , Re          , Gs          , Gs^Vc       , Gg          , Ww          , Rb^Eff      , Rb^Eff      , Rb^Gvs      , Rb^Gvs      , Rb^Gvs      
Gg          , Gll         , Gg          , Gll^Fp      , Gs^Fms      , Gs^Fms      , Gg          , Gg          , Gs^Fms      , Gs^Fms      , Gs^Fms      , Gg          , Gs^Fms      , Gs^Fds      , Gg          , Gg          , Gs^Fms      , Gs^Fds      , Gg          , Gs^Fds      , Wo          , Ss          , Gg          , Gg          , Gg          , Gg          , Gs^Fds      , Gg          , Gg          , Gs          , Gg          , Gg          , Gg          , Gg          , Gg          , Gg          , Gg          , Gg          , Gg          , Gg          , Gg          , Gg          , Gg          , Re          , Re          , Gs          , Gg          , Gg          , Re          , Gg          , Gg          , Gg          , Rb^Eff      , Rb^Eff      , Rb^Gvs      , Rb^Gvs      , Rb^Gvs      , Rb^Gvs      , Rb^Gvs      
